,Scenario,Trial,Inspection,Interval,Time,Defects,Rate
0,122,1,1,6,6,4,60
1,122,1,2,9,15,3,90
2,122,1,3,9,24,2,90
3,122,1,4,6,30,4,60
4,122,1,5,8,38,4,80
5,122,1,6,5,43,0,50
6,122,1,7,5,48,5,50
7,122,1,8,8,56,0,80
8,122,1,9,9,65,0,90
9,122,1,10,8,73,0,80
10,122,1,11,7,80,12,70
11,122,1,12,2,82,1,20
12,122,1,13,5,87,2,50
13,122,1,14,2,89,0,20
14,122,1,15,7,96,0,70
15,122,1,16,8,104,0,80
16,122,1,17,3,107,0,30
17,122,1,18,6,113,0,60
18,122,1,19,7,120,15,70
19,122,1,20,4,124,0,40
20,122,1,21,5,129,0,50
21,122,1,22,8,137,10,80
22,122,1,23,8,145,4,80
23,122,1,24,8,153,0,80
24,122,1,25,6,159,0,60
25,122,1,26,4,163,13,40
26,122,1,27,7,170,0,70
27,122,1,28,5,175,10,50
28,122,1,29,3,178,1,30
29,122,1,30,4,182,0,40
30,122,1,31,2,184,0,20
31,122,1,32,5,189,0,50
32,122,1,33,7,196,10,70
33,122,1,34,3,199,0,30
34,122,1,35,7,206,6,70
35,122,1,36,8,214,7,80
36,122,1,37,3,217,0,30
37,122,1,38,3,220,4,30
38,122,1,39,6,226,5,60
39,122,1,40,7,233,0,70
40,122,1,41,8,241,9,80
41,122,1,42,4,245,0,40
42,122,1,43,6,251,2,60
43,122,1,44,4,255,0,40
44,122,1,45,9,264,7,90
45,122,1,46,7,271,6,70
46,122,1,47,2,273,3,20
47,122,1,48,3,276,3,30
48,122,1,49,4,280,3,40
49,122,1,50,8,288,0,80
50,122,1,51,7,295,9,70
51,122,1,52,7,302,5,70
52,122,1,53,6,308,0,60
53,122,1,54,8,316,0,80
54,122,1,55,3,319,13,30
55,122,1,56,2,321,0,20
56,122,1,57,4,325,3,40
57,122,1,58,9,334,0,90
58,122,1,59,5,339,8,50
59,122,1,60,7,346,0,70
60,122,1,61,8,354,6,80
61,122,1,62,2,356,1,20
62,122,1,63,4,360,3,40
63,122,1,64,5,365,4,50
64,122,1,65,5,370,4,50
65,122,1,66,4,374,0,40
66,122,1,67,6,380,2,60
67,122,1,68,6,386,0,60
68,122,1,69,4,390,0,40
69,122,1,70,2,392,2,20
70,122,1,71,5,397,0,50
71,122,1,72,9,406,8,90
72,122,1,73,7,413,3,70
73,122,1,74,5,418,3,50
74,122,1,75,9,427,9,90
75,122,1,76,8,435,0,80
76,122,1,77,8,443,6,80
77,122,1,78,7,450,5,70
78,122,1,79,3,453,3,30
79,122,1,80,4,457,2,40
80,122,1,81,6,463,3,60
81,122,1,82,4,467,1,40
82,122,1,83,9,476,4,90
83,122,1,84,2,478,0,20
84,122,1,85,7,485,3,70
85,122,1,86,9,494,5,90
86,122,1,87,6,500,4,60
87,122,1,88,6,506,4,60
88,122,1,89,2,508,2,20
89,122,1,90,2,510,0,20
90,122,1,91,8,518,0,80
91,122,1,92,7,525,5,70
92,122,1,93,7,532,0,70
93,122,1,94,2,534,0,20
94,122,1,95,9,543,0,90
95,122,1,96,6,549,7,60
96,122,1,97,3,552,0,30
97,122,1,98,5,557,0,50
98,122,1,99,2,559,0,20
99,122,1,100,6,565,9,60
100,122,1,101,8,573,1,80
101,122,1,102,6,579,3,60
102,122,1,103,2,581,0,20
103,122,1,104,4,585,1,40
104,122,1,105,4,589,1,40
105,122,1,106,4,593,2,40
106,122,1,107,5,598,0,50
107,122,1,108,7,605,0,70
108,122,1,109,7,612,0,70
109,122,1,110,7,619,16,70
110,122,1,111,9,628,4,90
111,122,1,112,2,630,0,20
112,122,1,113,8,638,2,80
113,122,1,114,8,646,0,80
114,122,1,115,2,648,6,20
115,122,1,116,8,656,0,80
116,122,1,117,6,662,6,60
117,122,1,118,7,669,0,70
118,122,1,119,4,673,0,40
119,122,1,120,3,676,3,30
120,122,1,121,4,680,0,40
121,122,1,122,8,688,4,80
122,122,1,123,4,692,4,40
123,122,1,124,7,699,3,70
124,122,1,125,8,707,0,80
125,122,1,126,3,710,9,30
126,122,1,127,8,718,9,80
127,122,1,128,2,720,0,20
128,122,1,129,8,728,7,80
129,122,1,130,7,735,5,70
130,122,1,131,2,737,1,20
131,122,1,132,6,743,0,60
132,122,1,133,8,751,9,80
133,122,1,134,8,759,1,80
134,122,1,135,8,767,0,80
135,122,1,136,7,774,10,70
136,122,1,137,6,780,0,60
137,122,1,138,7,787,10,70
138,122,1,139,8,795,5,80
139,122,1,140,9,804,3,90
140,122,1,141,7,811,0,70
141,122,1,142,9,820,6,90
142,122,1,143,2,822,0,20
143,122,1,144,2,824,1,20
144,122,1,145,2,826,1,20
145,122,1,146,6,832,1,60
146,122,1,147,8,840,0,80
147,122,1,148,6,846,3,60
148,122,1,149,7,853,0,70
149,122,1,150,4,857,3,40
150,122,1,151,4,861,0,40
151,122,1,152,7,868,2,70
152,122,1,153,4,872,0,40
153,122,1,154,5,877,2,50
154,122,1,155,6,883,0,60
155,122,1,156,3,886,3,30
156,122,1,157,5,891,2,50
157,122,1,158,9,900,0,90
158,122,1,159,5,905,5,50
159,122,1,160,2,907,1,20
160,122,1,161,8,915,0,80
161,122,1,162,7,922,0,70
162,122,1,163,3,925,11,30
163,122,1,164,7,932,0,70
164,122,1,165,2,934,2,20
165,122,1,166,3,937,2,30
166,122,1,167,5,942,1,50
167,122,1,168,6,948,5,60
168,122,1,169,4,952,2,40
169,122,1,170,2,954,1,20
170,122,1,171,5,959,0,50
171,122,1,172,6,965,0,60
172,122,1,173,9,974,5,90
173,122,1,174,2,976,0,20
174,122,1,175,9,985,9,90
175,122,1,176,5,990,0,50
176,122,1,177,2,992,0,20
177,122,1,178,9,1001,10,90
178,122,1,179,3,1004,0,30
179,122,1,180,2,1006,4,20
180,122,1,181,9,1015,6,90
181,122,1,182,2,1017,0,20
182,122,1,183,4,1021,1,40
183,122,1,184,5,1026,1,50
184,122,1,185,8,1034,4,80
185,122,1,186,5,1039,3,50
186,122,1,187,4,1043,0,40
187,122,1,188,9,1052,5,90
188,122,1,189,9,1061,6,90
189,122,1,190,2,1063,1,20
190,122,1,191,7,1070,0,70
191,122,1,192,6,1076,0,60
192,122,1,193,7,1083,16,70
193,122,1,194,7,1090,0,70
194,122,1,195,4,1094,6,40
195,122,1,196,8,1102,3,80
196,122,1,197,6,1108,1,60
197,122,1,198,5,1113,5,50
198,122,1,199,3,1116,0,30
199,122,1,200,2,1118,0,20
200,122,1,201,8,1126,7,80
201,122,1,202,9,1135,0,90
202,122,1,203,7,1142,8,70
203,122,1,204,9,1151,4,90
204,122,1,205,7,1158,0,70
205,122,1,206,6,1164,0,60
206,122,1,207,8,1172,15,80
207,122,1,208,5,1177,0,50
208,122,1,209,9,1186,0,90
209,122,1,210,9,1195,14,90
210,122,1,211,7,1202,3,70
211,122,1,212,5,1207,0,50
212,122,1,213,8,1215,0,80
213,122,1,214,9,1224,9,90
214,122,1,215,7,1231,3,70
215,122,1,216,8,1239,0,80
216,122,1,217,6,1245,0,60
217,122,1,218,8,1253,8,80
218,122,1,219,6,1259,0,60
219,122,1,220,4,1263,2,40
220,122,1,221,8,1271,6,80
221,122,1,222,2,1273,0,20
222,122,1,223,4,1277,3,40
223,122,1,224,9,1286,0,90
224,122,1,225,2,1288,0,20
225,122,1,226,7,1295,6,70
226,122,1,227,3,1298,2,30
227,122,1,228,6,1304,5,60
228,122,1,229,9,1313,2,90
229,122,1,230,2,1315,0,20
230,122,1,231,7,1322,2,70
231,122,1,232,3,1325,0,30
232,122,1,233,4,1329,0,40
233,122,1,234,2,1331,4,20
234,122,1,235,5,1336,3,50
235,122,1,236,4,1340,0,40
236,122,1,237,5,1345,6,50
237,122,1,238,9,1354,0,90
238,122,1,239,8,1362,0,80
239,122,1,240,3,1365,0,30
240,122,1,241,9,1374,14,90
241,122,1,242,5,1379,4,50
242,122,1,243,3,1382,0,30
243,122,1,244,4,1386,4,40
244,122,1,245,9,1395,6,90
245,122,1,246,8,1403,0,80
246,122,1,247,5,1408,0,50
247,122,1,248,2,1410,0,20
248,122,1,249,9,1419,10,90
249,122,1,250,6,1425,4,60
250,122,1,251,7,1432,3,70
251,122,1,252,5,1437,1,50
252,122,1,253,8,1445,0,80
253,122,1,254,5,1450,9,50
254,122,1,255,9,1459,6,90
255,122,1,256,2,1461,1,20
256,122,1,257,3,1464,1,30
257,122,1,258,7,1471,0,70
258,122,1,259,5,1476,6,50
259,122,1,260,4,1480,4,40
260,122,1,261,4,1484,0,40
261,122,1,262,6,1490,7,60
262,122,1,263,6,1496,4,60
263,122,1,264,9,1505,0,90
264,122,1,265,8,1513,0,80
265,122,1,266,9,1522,13,90
266,122,1,267,4,1526,3,40
267,122,1,268,8,1534,0,80
268,122,1,269,2,1536,0,20
269,122,1,270,2,1538,4,20
270,122,1,271,9,1547,0,90
271,122,1,272,4,1551,0,40
272,122,1,273,6,1557,4,60
273,122,1,274,2,1559,1,20
274,122,1,275,9,1568,0,90
275,122,1,276,8,1576,12,80
276,122,1,277,3,1579,2,30
277,122,1,278,2,1581,1,20
278,122,1,279,9,1590,0,90
279,122,1,280,6,1596,7,60
280,122,1,281,7,1603,8,70
281,122,1,282,5,1608,5,50
282,122,1,283,7,1615,3,70
283,122,1,284,9,1624,4,90
284,122,1,285,9,1633,0,90
285,122,1,286,8,1641,10,80
286,122,1,287,9,1650,4,90
287,122,1,288,7,1657,0,70
288,122,1,289,7,1664,0,70
289,122,1,290,3,1667,8,30
290,122,1,291,7,1674,4,70
291,122,1,292,9,1683,0,90
292,122,1,293,8,1691,0,80
293,122,1,294,4,1695,10,40
294,122,1,295,6,1701,0,60
295,122,1,296,4,1705,0,40
296,122,1,297,2,1707,4,20
297,122,1,298,6,1713,0,60
298,122,1,299,5,1718,4,50
299,122,1,300,8,1726,3,80
300,122,1,301,8,1734,5,80
301,122,1,302,7,1741,2,70
302,122,1,303,2,1743,0,20
303,122,1,304,9,1752,0,90
304,122,1,305,5,1757,0,50
305,122,1,306,6,1763,5,60
306,122,1,307,5,1768,0,50
307,122,1,308,5,1773,6,50
308,122,1,309,7,1780,0,70
309,122,1,310,3,1783,4,30
310,122,1,311,5,1788,0,50
311,122,1,312,8,1796,4,80
312,122,1,313,5,1801,3,50
313,122,1,314,2,1803,0,20
314,122,1,315,8,1811,5,80
315,122,1,316,6,1817,7,60
316,122,1,317,7,1824,0,70
317,122,1,318,5,1829,8,50
318,122,1,319,2,1831,0,20
319,122,1,320,3,1834,0,30
320,122,1,321,5,1839,0,50
321,122,1,322,6,1845,11,60
322,122,1,323,3,1848,0,30
323,122,1,324,4,1852,3,40
324,122,1,325,9,1861,5,90
325,122,1,326,3,1864,1,30
326,122,1,327,2,1866,0,20
327,122,1,328,4,1870,0,40
328,122,1,329,5,1875,5,50
329,122,1,330,9,1884,6,90
330,122,1,331,3,1887,2,30
331,122,1,332,9,1896,0,90
332,122,1,333,4,1900,0,40
333,122,1,334,8,1908,16,80
334,122,1,335,7,1915,6,70
335,122,1,336,8,1923,5,80
336,122,1,337,6,1929,0,60
337,122,1,338,9,1938,8,90
338,122,1,339,9,1947,0,90
339,122,1,340,2,1949,0,20
340,122,1,341,6,1955,7,60
341,122,1,342,4,1959,0,40
342,122,1,343,7,1966,5,70
343,122,1,344,9,1975,3,90
344,122,1,345,9,1984,2,90
345,122,1,346,9,1993,0,90
346,122,1,347,6,1999,6,60
347,122,1,348,6,2005,2,60
348,122,1,349,7,2012,0,70
349,122,1,350,6,2018,2,60
350,122,1,351,4,2022,3,40
351,122,1,352,6,2028,0,60
352,122,1,353,3,2031,5,30
353,122,1,354,3,2034,0,30
354,122,1,355,3,2037,4,30
355,122,1,356,4,2041,0,40
356,122,1,357,7,2048,0,70
357,122,1,358,4,2052,8,40
358,122,1,359,9,2061,0,90
359,122,1,360,7,2068,0,70
360,122,1,361,8,2076,11,80
361,122,1,362,5,2081,0,50
362,122,1,363,9,2090,7,90
363,122,1,364,7,2097,3,70
364,122,1,365,6,2103,0,60
365,122,1,366,4,2107,10,40
366,122,1,367,4,2111,3,40
367,122,1,368,3,2114,0,30
368,122,1,369,9,2123,0,90
369,122,1,370,2,2125,6,20
370,122,1,371,4,2129,1,40
371,122,1,372,8,2137,0,80
372,122,1,373,7,2144,0,70
373,122,1,374,9,2153,11,90
374,122,1,375,3,2156,1,30
375,122,1,376,9,2165,3,90
376,122,1,377,8,2173,0,80
377,122,1,378,6,2179,6,60
378,122,1,379,3,2182,4,30
379,122,1,380,8,2190,2,80
380,122,1,381,9,2199,4,90
381,122,1,382,8,2207,0,80
382,122,1,383,9,2216,5,90
383,122,1,384,7,2223,1,70
384,122,1,385,8,2231,8,80
385,122,1,386,6,2237,0,60
386,122,1,387,5,2242,8,50
387,122,1,388,7,2249,4,70
388,122,1,389,5,2254,1,50
389,122,1,390,4,2258,0,40
390,122,1,391,3,2261,1,30
391,122,1,392,6,2267,3,60
392,122,1,393,8,2275,0,80
393,122,1,394,2,2277,0,20
394,122,1,395,4,2281,4,40
395,122,1,396,7,2288,3,70
396,122,1,397,5,2293,0,50
397,122,1,398,9,2302,0,90
398,122,1,399,3,2305,9,30
399,122,1,400,6,2311,3,60
400,122,1,401,6,2317,6,60
401,122,1,402,3,2320,1,30
402,122,1,403,7,2327,0,70
403,122,1,404,9,2336,0,90
404,122,1,405,8,2344,0,80
405,122,1,406,8,2352,16,80
406,122,1,407,8,2360,0,80
407,122,1,408,6,2366,4,60
408,122,1,409,8,2374,0,80
409,122,1,410,5,2379,0,50
410,122,1,411,8,2387,10,80
411,122,1,412,5,2392,0,50
412,122,1,413,9,2401,8,90
413,122,1,414,6,2407,1,60
414,122,1,415,4,2411,1,40
415,122,1,416,8,2419,6,80
416,122,1,417,3,2422,3,30
417,122,1,418,9,2431,2,90
418,122,1,419,6,2437,4,60
419,122,1,420,4,2441,0,40
420,122,1,421,5,2446,0,50
421,122,1,422,6,2452,0,60
422,122,1,423,6,2458,0,60
423,122,1,424,2,2460,0,20
424,122,1,425,8,2468,11,80
425,122,1,426,3,2471,0,30
426,122,1,427,4,2475,0,40
427,122,1,428,7,2482,0,70
428,122,1,429,6,2488,11,60
429,122,1,430,8,2496,0,80
430,122,1,431,9,2505,0,90
431,122,1,432,4,2509,9,40
432,122,1,433,4,2513,0,40
433,122,1,434,5,2518,2,50
434,122,1,435,2,2520,1,20
435,122,1,436,6,2526,6,60
436,122,1,437,9,2535,5,90
437,122,1,438,9,2544,4,90
438,122,1,439,4,2548,0,40
439,122,1,440,3,2551,1,30
440,122,1,441,3,2554,0,30
441,122,1,442,4,2558,6,40
442,122,1,443,8,2566,4,80
443,122,1,444,9,2575,0,90
444,122,1,445,4,2579,4,40
445,122,1,446,9,2588,0,90
446,122,1,447,9,2597,6,90
447,122,1,448,7,2604,0,70
448,122,1,449,7,2611,0,70
449,122,1,450,7,2618,10,70
450,122,1,451,6,2624,1,60
451,122,1,452,4,2628,0,40
452,122,1,453,9,2637,5,90
453,122,1,454,3,2640,0,30
454,122,1,455,3,2643,0,30
455,122,1,456,2,2645,2,20
456,122,1,457,3,2648,3,30
457,122,1,458,9,2657,0,90
458,122,1,459,6,2663,7,60
459,122,1,460,3,2666,1,30
460,122,1,461,4,2670,0,40
461,122,1,462,6,2676,4,60
462,122,1,463,3,2679,0,30
463,122,1,464,3,2682,2,30
464,122,1,465,8,2690,1,80
465,122,1,466,8,2698,7,80
466,122,1,467,9,2707,0,90
467,122,1,468,5,2712,4,50
468,122,1,469,2,2714,0,20
469,122,1,470,3,2717,3,30
470,122,1,471,2,2719,1,20
471,122,1,472,4,2723,3,40
472,122,1,473,3,2726,0,30
473,122,1,474,8,2734,4,80
474,122,1,475,4,2738,1,40
475,122,1,476,5,2743,2,50
476,122,1,477,2,2745,0,20
477,122,1,478,2,2747,2,20
478,122,1,479,7,2754,0,70
479,122,1,480,7,2761,6,70
480,122,1,481,5,2766,3,50
481,122,1,482,9,2775,0,90
482,122,1,483,4,2779,5,40
483,122,1,484,4,2783,0,40
484,122,1,485,8,2791,3,80
485,122,1,486,6,2797,3,60
486,122,1,487,8,2805,5,80
487,122,1,488,7,2812,0,70
488,122,1,489,9,2821,0,90
489,122,1,490,5,2826,12,50
490,122,1,491,5,2831,2,50
491,122,1,492,5,2836,0,50
492,122,1,493,8,2844,4,80
493,122,1,494,2,2846,0,20
494,122,1,495,7,2853,6,70
495,122,1,496,6,2859,0,60
496,122,1,497,3,2862,0,30
497,122,1,498,2,2864,0,20
498,122,1,499,4,2868,6,40
499,122,1,500,7,2875,0,70
500,122,1,501,6,2881,0,60
501,122,1,502,9,2890,14,90
502,122,1,503,9,2899,0,90
503,122,1,504,8,2907,0,80
504,122,1,505,7,2914,11,70
505,122,1,506,8,2922,4,80
506,122,1,507,3,2925,2,30
507,122,1,508,2,2927,1,20
508,122,1,509,5,2932,2,50
509,122,1,510,2,2934,1,20
510,122,1,511,4,2938,0,40
511,122,1,512,3,2941,0,30
512,122,1,513,6,2947,5,60
513,122,1,514,2,2949,1,20
514,122,1,515,6,2955,2,60
515,122,1,516,8,2963,3,80
516,122,1,517,9,2972,2,90
517,122,1,518,5,2977,4,50
518,122,1,519,6,2983,0,60
519,122,1,520,3,2986,6,30
520,122,1,521,3,2989,2,30
521,122,1,522,7,2996,2,70
522,122,1,523,7,3003,0,70
523,122,1,524,2,3005,0,20
524,122,1,525,7,3012,4,70
525,122,1,526,2,3014,0,20
526,122,1,527,2,3016,1,20
527,122,1,528,8,3024,0,80
528,122,1,529,8,3032,8,80
529,122,1,530,3,3035,2,30
530,122,1,531,3,3038,1,30
531,122,1,532,5,3043,3,50
532,122,1,533,3,3046,1,30
533,122,1,534,8,3054,5,80
534,122,1,535,6,3060,0,60
535,122,1,536,2,3062,4,20
536,122,1,537,6,3068,1,60
537,122,1,538,5,3073,3,50
538,122,1,539,4,3077,2,40
539,122,1,540,9,3086,0,90
540,122,1,541,7,3093,10,70
541,122,1,542,4,3097,2,40
542,122,1,543,8,3105,0,80
543,122,1,544,5,3110,8,50
544,122,1,545,7,3117,1,70
545,122,1,546,8,3125,0,80
546,122,1,547,2,3127,5,20
547,122,1,548,6,3133,4,60
548,122,1,549,6,3139,0,60
549,122,1,550,3,3142,5,30
550,122,1,551,2,3144,0,20
551,122,1,552,7,3151,7,70
552,122,1,553,5,3156,1,50
553,122,1,554,8,3164,5,80
554,122,1,555,5,3169,1,50
555,122,1,556,4,3173,1,40
556,122,1,557,8,3181,0,80
557,122,1,558,2,3183,7,20
558,122,1,559,9,3192,2,90
559,122,1,560,2,3194,0,20
560,122,1,561,8,3202,0,80
561,122,1,562,4,3206,4,40
562,122,1,563,4,3210,0,40
563,122,1,564,2,3212,0,20
564,122,1,565,3,3215,5,30
565,122,1,566,4,3219,0,40
566,122,1,567,3,3222,0,30
567,122,1,568,7,3229,6,70
568,122,1,569,9,3238,0,90
569,122,1,570,9,3247,14,90
570,122,1,571,7,3254,5,70
571,122,1,572,2,3256,0,20
572,122,1,573,7,3263,4,70
573,122,1,574,5,3268,1,50
574,122,1,575,4,3272,0,40
575,122,1,576,5,3277,1,50
576,122,1,577,8,3285,0,80
577,122,1,578,8,3293,10,80
578,122,1,579,9,3302,1,90
579,122,1,580,7,3309,7,70
580,122,1,581,2,3311,0,20
581,122,1,582,9,3320,5,90
582,122,1,583,4,3324,1,40
583,122,1,584,9,3333,4,90
584,122,1,585,4,3337,3,40
585,122,1,586,6,3343,0,60
586,122,1,587,6,3349,6,60
587,122,1,588,3,3352,0,30
588,122,1,589,4,3356,0,40
589,122,1,590,6,3362,0,60
590,122,1,591,9,3371,9,90
591,122,1,592,6,3377,0,60
592,122,1,593,2,3379,0,20
593,122,1,594,7,3386,2,70
594,122,1,595,3,3389,0,30
595,122,1,596,9,3398,0,90
596,122,1,597,7,3405,9,70
597,122,1,598,7,3412,4,70
598,122,1,599,7,3419,4,70
599,122,1,600,8,3427,0,80
600,122,1,601,3,3430,0,30
601,122,1,602,8,3438,0,80
602,122,1,603,9,3447,12,90
603,122,1,604,7,3454,0,70
604,122,1,605,6,3460,8,60
605,122,1,606,2,3462,1,20
606,122,1,607,2,3464,0,20
607,122,1,608,9,3473,13,90
608,122,1,609,9,3482,0,90
609,122,1,610,8,3490,5,80
610,122,1,611,8,3498,0,80
611,122,1,612,6,3504,8,60
612,122,1,613,3,3507,0,30
613,122,1,614,9,3516,5,90
614,122,1,615,6,3522,3,60
615,122,1,616,8,3530,0,80
616,122,1,617,7,3537,0,70
617,122,1,618,7,3544,10,70
618,122,1,619,7,3551,4,70
619,122,1,620,5,3556,7,50
620,122,1,621,2,3558,1,20
621,122,1,622,8,3566,5,80
622,122,1,623,7,3573,2,70
623,122,1,624,5,3578,3,50
624,122,1,625,7,3585,4,70
625,122,1,626,7,3592,4,70
626,122,1,627,5,3597,1,50
627,122,1,628,2,3599,0,20
628,122,1,629,2,3601,2,20
629,122,1,630,8,3609,3,80
630,122,1,631,9,3618,0,90
631,122,1,632,8,3626,7,80
632,122,1,633,7,3633,1,70
633,122,1,634,5,3638,6,50
634,122,1,635,4,3642,0,40
635,122,1,636,9,3651,0,90
636,122,1,637,7,3658,15,70
637,122,1,638,5,3663,3,50
638,122,1,639,9,3672,2,90
639,122,1,640,8,3680,4,80
640,122,1,641,4,3684,2,40
641,122,1,642,9,3693,6,90
642,122,1,643,6,3699,0,60
643,122,1,644,5,3704,7,50
644,122,1,645,4,3708,1,40
645,122,1,646,6,3714,0,60
646,122,1,647,8,3722,10,80
647,122,1,648,3,3725,0,30
648,122,1,649,9,3734,9,90
649,122,1,650,3,3737,0,30
650,122,1,651,3,3740,0,30
651,122,1,652,3,3743,6,30
652,122,1,653,6,3749,2,60
653,122,1,654,6,3755,4,60
654,122,1,655,2,3757,1,20
655,122,1,656,6,3763,3,60
656,122,1,657,2,3765,0,20
657,122,1,658,8,3773,0,80
658,122,1,659,7,3780,11,70
659,122,1,660,4,3784,2,40
660,122,1,661,4,3788,4,40
661,122,1,662,5,3793,1,50
662,122,1,663,9,3802,5,90
663,122,1,664,4,3806,0,40
664,122,1,665,2,3808,0,20
665,122,1,666,5,3813,0,50
666,122,1,667,9,3822,17,90
667,122,1,668,9,3831,6,90
668,122,1,669,4,3835,0,40
669,122,1,670,5,3840,3,50
670,122,1,671,8,3848,1,80
671,122,1,672,2,3850,1,20
672,122,1,673,4,3854,1,40
673,122,1,674,8,3862,4,80
674,122,1,675,2,3864,1,20
675,122,1,676,7,3871,0,70
676,122,1,677,8,3879,5,80
677,122,1,678,3,3882,2,30
678,122,1,679,6,3888,8,60
679,122,1,680,7,3895,3,70
680,122,1,681,7,3902,0,70
681,122,1,682,3,3905,1,30
682,122,1,683,3,3908,0,30
683,122,1,684,7,3915,4,70
684,122,1,685,4,3919,2,40
685,122,1,686,6,3925,6,60
686,122,1,687,7,3932,0,70
687,122,1,688,3,3935,0,30
688,122,1,689,3,3938,0,30
689,122,1,690,9,3947,15,90
690,122,1,691,2,3949,2,20
691,122,1,692,7,3956,5,70
692,122,1,693,5,3961,0,50
693,122,1,694,7,3968,0,70
694,122,1,695,6,3974,13,60
695,122,1,696,9,3983,4,90
696,122,1,697,7,3990,0,70
697,122,1,698,7,3997,6,70
698,122,1,699,2,3999,2,20
699,122,1,700,5,4004,3,50
700,122,1,701,8,4012,0,80
701,122,1,702,6,4018,6,60
702,122,1,703,2,4020,0,20
703,122,1,704,8,4028,5,80
704,122,1,705,2,4030,0,20
705,122,1,706,6,4036,2,60
706,122,1,707,8,4044,3,80
707,122,1,708,2,4046,2,20
708,122,1,709,4,4050,1,40
709,122,1,710,7,4057,0,70
710,122,1,711,3,4060,2,30
711,122,1,712,9,4069,3,90
712,122,1,713,5,4074,0,50
713,122,1,714,8,4082,0,80
714,122,1,715,3,4085,12,30
715,122,1,716,6,4091,4,60
716,122,1,717,7,4098,4,70
717,122,1,718,7,4105,0,70
718,122,1,719,6,4111,0,60
719,122,1,720,8,4119,0,80
720,122,1,721,7,4126,14,70
721,122,1,722,5,4131,3,50
722,122,1,723,6,4137,1,60
723,122,1,724,8,4145,4,80
724,122,1,725,5,4150,0,50
725,122,1,726,6,4156,3,60
726,122,1,727,7,4163,5,70
727,122,1,728,2,4165,0,20
728,122,1,729,6,4171,4,60
729,122,1,730,9,4180,0,90
730,122,1,731,5,4185,0,50
731,122,1,732,7,4192,14,70
732,122,1,733,3,4195,0,30
733,122,1,734,4,4199,0,40
734,122,1,735,6,4205,7,60
735,122,1,736,3,4208,0,30
736,122,1,737,3,4211,1,30
737,122,1,738,4,4215,1,40
738,122,1,739,4,4219,0,40
739,122,1,740,2,4221,0,20
740,122,1,741,4,4225,11,40
741,122,1,742,3,4228,1,30
742,122,1,743,6,4234,4,60
743,122,1,744,8,4242,10,80
744,122,1,745,4,4246,0,40
745,122,1,746,3,4249,1,30
746,122,1,747,4,4253,1,40
747,122,1,748,8,4261,0,80
748,122,1,749,2,4263,6,20
749,122,1,750,4,4267,3,40
750,122,1,751,5,4272,0,50
751,122,1,752,7,4279,0,70
752,122,1,753,5,4284,0,50
753,122,1,754,4,4288,9,40
754,122,1,755,5,4293,1,50
755,122,1,756,5,4298,2,50
756,122,1,757,6,4304,0,60
757,122,1,758,6,4310,0,60
758,122,1,759,9,4319,8,90
759,122,1,760,2,4321,1,20
760,122,1,761,5,4326,0,50
761,122,1,762,2,4328,0,20
762,122,1,763,6,4334,7,60
763,122,1,764,5,4339,0,50
764,122,1,765,2,4341,2,20
765,122,1,766,5,4346,0,50
766,122,1,767,7,4353,0,70
767,122,1,768,4,4357,5,40
768,122,1,769,4,4361,1,40
769,122,1,770,9,4370,4,90
770,122,1,771,9,4379,3,90
771,122,1,772,7,4386,0,70
772,122,1,773,7,4393,9,70
773,122,1,774,6,4399,3,60
774,122,1,775,5,4404,4,50
775,122,1,776,4,4408,0,40
776,122,1,777,8,4416,0,80
777,122,1,778,2,4418,2,20
778,122,1,779,7,4425,5,70
779,122,1,780,7,4432,7,70
780,122,1,781,5,4437,0,50
781,122,1,782,6,4443,0,60
782,122,1,783,5,4448,9,50
783,122,1,784,9,4457,1,90
784,122,1,785,4,4461,0,40
785,122,1,786,3,4464,4,30
786,122,1,787,5,4469,0,50
787,122,1,788,5,4474,6,50
788,122,1,789,3,4477,1,30
789,122,1,790,6,4483,6,60
790,122,1,791,9,4492,0,90
791,122,1,792,6,4498,7,60
792,122,1,793,3,4501,0,30
793,122,1,794,4,4505,1,40
794,122,1,795,7,4512,5,70
795,122,1,796,2,4514,1,20
796,122,1,797,2,4516,2,20
797,122,1,798,6,4522,0,60
798,122,1,799,3,4525,2,30
799,122,1,800,5,4530,7,50
800,122,1,801,6,4536,7,60
801,122,1,802,7,4543,0,70
802,122,1,803,3,4546,5,30
803,122,1,804,9,4555,4,90
804,122,1,805,2,4557,0,20
805,122,1,806,2,4559,1,20
806,122,1,807,3,4562,0,30
807,122,1,808,6,4568,0,60
808,122,1,809,4,4572,0,40
809,122,1,810,5,4577,15,50
810,122,1,811,9,4586,7,90
811,122,1,812,2,4588,0,20
812,122,1,813,8,4596,0,80
813,122,1,814,5,4601,0,50
814,122,1,815,6,4607,5,60
815,122,1,816,7,4614,1,70
816,122,1,817,2,4616,1,20
817,122,1,818,5,4621,0,50
818,122,1,819,8,4629,8,80
819,122,1,820,2,4631,1,20
820,122,1,821,9,4640,8,90
821,122,1,822,6,4646,0,60
822,122,1,823,5,4651,5,50
823,122,1,824,9,4660,3,90
824,122,1,825,5,4665,3,50
825,122,1,826,7,4672,6,70
826,122,1,827,2,4674,1,20
827,122,1,828,5,4679,0,50
828,122,1,829,3,4682,0,30
829,122,1,830,5,4687,11,50
830,122,1,831,8,4695,0,80
831,122,1,832,8,4703,0,80
832,122,1,833,8,4711,13,80
833,122,1,834,9,4720,7,90
834,122,1,835,3,4723,0,30
835,122,1,836,6,4729,1,60
836,122,1,837,3,4732,0,30
837,122,1,838,6,4738,2,60
838,122,1,839,5,4743,3,50
839,122,1,840,7,4750,4,70
840,122,1,841,8,4758,0,80
841,122,1,842,5,4763,3,50
842,122,1,843,3,4766,0,30
843,122,1,844,7,4773,6,70
844,122,1,845,9,4782,0,90
845,122,1,846,7,4789,0,70
846,122,1,847,2,4791,10,20
847,122,1,848,2,4793,0,20
848,122,1,849,2,4795,0,20
849,122,1,850,2,4797,0,20
850,122,1,851,8,4805,3,80
851,122,1,852,3,4808,1,30
852,122,1,853,5,4813,2,50
853,122,1,854,4,4817,0,40
854,122,1,855,8,4825,4,80
855,122,1,856,2,4827,0,20
856,122,1,857,6,4833,2,60
857,122,1,858,5,4838,3,50
858,122,1,859,3,4841,2,30
859,122,1,860,5,4846,0,50
860,122,1,861,4,4850,0,40
861,122,1,862,6,4856,5,60
862,122,1,863,8,4864,5,80
863,122,1,864,2,4866,0,20
864,122,1,865,2,4868,0,20
865,122,1,866,3,4871,0,30
866,122,1,867,3,4874,0,30
867,122,1,868,9,4883,7,90
868,122,1,869,8,4891,6,80
869,122,1,870,9,4900,3,90
870,122,1,871,7,4907,3,70
871,122,1,872,5,4912,3,50
872,122,1,873,3,4915,1,30
873,122,1,874,2,4917,0,20
874,122,1,875,5,4922,1,50
875,122,1,876,7,4929,3,70
876,122,1,877,4,4933,0,40
877,122,1,878,7,4940,8,70
878,122,1,879,3,4943,2,30
879,122,1,880,9,4952,7,90
880,122,1,881,4,4956,0,40
881,122,1,882,5,4961,0,50
882,122,1,883,2,4963,2,20
883,122,1,884,3,4966,1,30
884,122,1,885,5,4971,3,50
885,122,1,886,8,4979,4,80
886,122,1,887,2,4981,0,20
887,122,1,888,7,4988,3,70
888,122,1,889,4,4992,2,40
889,122,1,890,7,4999,7,70
890,122,2,1,9,9,0,90
891,122,2,2,2,11,4,20
892,122,2,3,7,18,5,70
893,122,2,4,5,23,1,50
894,122,2,5,3,26,1,30
895,122,2,6,4,30,0,40
896,122,2,7,3,33,2,30
897,122,2,8,7,40,3,70
898,122,2,9,4,44,0,40
899,122,2,10,8,52,0,80
900,122,2,11,9,61,6,90
901,122,2,12,2,63,0,20
902,122,2,13,3,66,1,30
903,122,2,14,8,74,8,80
904,122,2,15,3,77,0,30
905,122,2,16,5,82,5,50
906,122,2,17,6,88,7,60
907,122,2,18,7,95,4,70
908,122,2,19,8,103,3,80
909,122,2,20,9,112,4,90
910,122,2,21,2,114,2,20
911,122,2,22,9,123,4,90
912,122,2,23,3,126,0,30
913,122,2,24,4,130,0,40
914,122,2,25,6,136,6,60
915,122,2,26,9,145,0,90
916,122,2,27,6,151,6,60
917,122,2,28,2,153,0,20
918,122,2,29,5,158,7,50
919,122,2,30,8,166,9,80
920,122,2,31,5,171,3,50
921,122,2,32,9,180,7,90
922,122,2,33,4,184,2,40
923,122,2,34,4,188,0,40
924,122,2,35,3,191,3,30
925,122,2,36,8,199,4,80
926,122,2,37,9,208,8,90
927,122,2,38,2,210,0,20
928,122,2,39,4,214,0,40
929,122,2,40,6,220,0,60
930,122,2,41,2,222,2,20
931,122,2,42,5,227,0,50
932,122,2,43,7,234,0,70
933,122,2,44,9,243,0,90
934,122,2,45,4,247,0,40
935,122,2,46,5,252,9,50
936,122,2,47,5,257,0,50
937,122,2,48,7,264,0,70
938,122,2,49,4,268,0,40
939,122,2,50,3,271,0,30
940,122,2,51,9,280,0,90
941,122,2,52,3,283,0,30
942,122,2,53,6,289,17,60
943,122,2,54,5,294,2,50
944,122,2,55,9,303,0,90
945,122,2,56,7,310,9,70
946,122,2,57,5,315,0,50
947,122,2,58,4,319,0,40
948,122,2,59,8,327,0,80
949,122,2,60,2,329,0,20
950,122,2,61,5,334,11,50
951,122,2,62,9,343,0,90
952,122,2,63,4,347,0,40
953,122,2,64,8,355,16,80
954,122,2,65,6,361,0,60
955,122,2,66,6,367,11,60
956,122,2,67,8,375,5,80
957,122,2,68,2,377,0,20
958,122,2,69,9,386,7,90
959,122,2,70,6,392,3,60
960,122,2,71,2,394,0,20
961,122,2,72,7,401,0,70
962,122,2,73,4,405,0,40
963,122,2,74,5,410,10,50
964,122,2,75,6,416,0,60
965,122,2,76,8,424,0,80
966,122,2,77,7,431,10,70
967,122,2,78,3,434,0,30
968,122,2,79,9,443,4,90
969,122,2,80,3,446,0,30
970,122,2,81,8,454,2,80
971,122,2,82,3,457,2,30
972,122,2,83,3,460,0,30
973,122,2,84,5,465,1,50
974,122,2,85,7,472,2,70
975,122,2,86,3,475,0,30
976,122,2,87,2,477,1,20
977,122,2,88,7,484,0,70
978,122,2,89,8,492,8,80
979,122,2,90,6,498,0,60
980,122,2,91,5,503,0,50
981,122,2,92,9,512,8,90
982,122,2,93,5,517,1,50
983,122,2,94,7,524,3,70
984,122,2,95,4,528,0,40
985,122,2,96,8,536,2,80
986,122,2,97,4,540,0,40
987,122,2,98,6,546,6,60
988,122,2,99,2,548,0,20
989,122,2,100,5,553,2,50
990,122,2,101,7,560,3,70
991,122,2,102,8,568,3,80
992,122,2,103,2,570,1,20
993,122,2,104,4,574,0,40
994,122,2,105,9,583,2,90
995,122,2,106,7,590,3,70
996,122,2,107,5,595,0,50
997,122,2,108,9,604,2,90
998,122,2,109,9,613,4,90
999,122,2,110,7,620,3,70
1000,122,2,111,9,629,0,90
1001,122,2,112,9,638,11,90
1002,122,2,113,7,645,0,70
1003,122,2,114,8,653,10,80
1004,122,2,115,6,659,0,60
1005,122,2,116,2,661,2,20
1006,122,2,117,6,667,2,60
1007,122,2,118,7,674,7,70
1008,122,2,119,4,678,5,40
1009,122,2,120,5,683,0,50
1010,122,2,121,5,688,6,50
1011,122,2,122,4,692,0,40
1012,122,2,123,3,695,1,30
1013,122,2,124,2,697,1,20
1014,122,2,125,3,700,0,30
1015,122,2,126,5,705,2,50
1016,122,2,127,5,710,3,50
1017,122,2,128,7,717,3,70
1018,122,2,129,8,725,5,80
1019,122,2,130,7,732,8,70
1020,122,2,131,9,741,0,90
1021,122,2,132,4,745,9,40
1022,122,2,133,6,751,0,60
1023,122,2,134,2,753,1,20
1024,122,2,135,5,758,2,50
1025,122,2,136,9,767,0,90
1026,122,2,137,9,776,6,90
1027,122,2,138,8,784,4,80
1028,122,2,139,6,790,1,60
1029,122,2,140,9,799,3,90
1030,122,2,141,7,806,0,70
1031,122,2,142,9,815,4,90
1032,122,2,143,7,822,0,70
1033,122,2,144,5,827,0,50
1034,122,2,145,6,833,6,60
1035,122,2,146,8,841,3,80
1036,122,2,147,7,848,7,70
1037,122,2,148,3,851,3,30
1038,122,2,149,9,860,0,90
1039,122,2,150,4,864,0,40
1040,122,2,151,5,869,0,50
1041,122,2,152,4,873,0,40
1042,122,2,153,5,878,0,50
1043,122,2,154,4,882,0,40
1044,122,2,155,2,884,22,20
1045,122,2,156,3,887,0,30
1046,122,2,157,5,892,5,50
1047,122,2,158,6,898,2,60
1048,122,2,159,5,903,0,50
1049,122,2,160,5,908,5,50
1050,122,2,161,8,916,4,80
1051,122,2,162,9,925,2,90
1052,122,2,163,6,931,0,60
1053,122,2,164,5,936,4,50
1054,122,2,165,6,942,3,60
1055,122,2,166,4,946,2,40
1056,122,2,167,3,949,2,30
1057,122,2,168,9,958,2,90
1058,122,2,169,4,962,0,40
1059,122,2,170,8,970,3,80
1060,122,2,171,8,978,0,80
1061,122,2,172,5,983,4,50
1062,122,2,173,3,986,0,30
1063,122,2,174,6,992,2,60
1064,122,2,175,6,998,0,60
1065,122,2,176,8,1006,5,80
1066,122,2,177,5,1011,1,50
1067,122,2,178,7,1018,8,70
1068,122,2,179,2,1020,0,20
1069,122,2,180,6,1026,5,60
1070,122,2,181,5,1031,0,50
1071,122,2,182,9,1040,9,90
1072,122,2,183,7,1047,0,70
1073,122,2,184,4,1051,9,40
1074,122,2,185,8,1059,3,80
1075,122,2,186,3,1062,2,30
1076,122,2,187,8,1070,0,80
1077,122,2,188,7,1077,4,70
1078,122,2,189,4,1081,2,40
1079,122,2,190,3,1084,2,30
1080,122,2,191,9,1093,10,90
1081,122,2,192,9,1102,4,90
1082,122,2,193,7,1109,2,70
1083,122,2,194,6,1115,1,60
1084,122,2,195,5,1120,1,50
1085,122,2,196,6,1126,0,60
1086,122,2,197,6,1132,5,60
1087,122,2,198,7,1139,0,70
1088,122,2,199,8,1147,8,80
1089,122,2,200,2,1149,2,20
1090,122,2,201,4,1153,0,40
1091,122,2,202,7,1160,4,70
1092,122,2,203,4,1164,2,40
1093,122,2,204,7,1171,7,70
1094,122,2,205,8,1179,3,80
1095,122,2,206,8,1187,3,80
1096,122,2,207,9,1196,0,90
1097,122,2,208,5,1201,0,50
1098,122,2,209,6,1207,0,60
1099,122,2,210,2,1209,0,20
1100,122,2,211,8,1217,13,80
1101,122,2,212,9,1226,2,90
1102,122,2,213,8,1234,10,80
1103,122,2,214,4,1238,2,40
1104,122,2,215,7,1245,2,70
1105,122,2,216,9,1254,9,90
1106,122,2,217,7,1261,1,70
1107,122,2,218,7,1268,0,70
1108,122,2,219,3,1271,0,30
1109,122,2,220,6,1277,0,60
1110,122,2,221,8,1285,12,80
1111,122,2,222,8,1293,0,80
1112,122,2,223,6,1299,4,60
1113,122,2,224,6,1305,0,60
1114,122,2,225,4,1309,6,40
1115,122,2,226,7,1316,1,70
1116,122,2,227,7,1323,0,70
1117,122,2,228,8,1331,1,80
1118,122,2,229,3,1334,4,30
1119,122,2,230,2,1336,0,20
1120,122,2,231,5,1341,2,50
1121,122,2,232,8,1349,3,80
1122,122,2,233,5,1354,3,50
1123,122,2,234,6,1360,2,60
1124,122,2,235,9,1369,2,90
1125,122,2,236,9,1378,7,90
1126,122,2,237,2,1380,0,20
1127,122,2,238,5,1385,2,50
1128,122,2,239,2,1387,0,20
1129,122,2,240,7,1394,0,70
1130,122,2,241,5,1399,13,50
1131,122,2,242,3,1402,0,30
1132,122,2,243,8,1410,7,80
1133,122,2,244,4,1414,2,40
1134,122,2,245,2,1416,0,20
1135,122,2,246,8,1424,4,80
1136,122,2,247,5,1429,0,50
1137,122,2,248,6,1435,0,60
1138,122,2,249,6,1441,0,60
1139,122,2,250,8,1449,17,80
1140,122,2,251,7,1456,2,70
1141,122,2,252,6,1462,2,60
1142,122,2,253,9,1471,6,90
1143,122,2,254,5,1476,0,50
1144,122,2,255,2,1478,2,20
1145,122,2,256,3,1481,0,30
1146,122,2,257,5,1486,0,50
1147,122,2,258,3,1489,4,30
1148,122,2,259,3,1492,0,30
1149,122,2,260,6,1498,0,60
1150,122,2,261,4,1502,0,40
1151,122,2,262,4,1506,16,40
1152,122,2,263,2,1508,0,20
1153,122,2,264,4,1512,7,40
1154,122,2,265,9,1521,8,90
1155,122,2,266,8,1529,2,80
1156,122,2,267,3,1532,0,30
1157,122,2,268,3,1535,3,30
1158,122,2,269,5,1540,3,50
1159,122,2,270,9,1549,2,90
1160,122,2,271,3,1552,3,30
1161,122,2,272,3,1555,0,30
1162,122,2,273,4,1559,1,40
1163,122,2,274,8,1567,5,80
1164,122,2,275,5,1572,0,50
1165,122,2,276,5,1577,5,50
1166,122,2,277,9,1586,0,90
1167,122,2,278,5,1591,6,50
1168,122,2,279,5,1596,1,50
1169,122,2,280,6,1602,0,60
1170,122,2,281,3,1605,0,30
1171,122,2,282,5,1610,10,50
1172,122,2,283,3,1613,0,30
1173,122,2,284,8,1621,4,80
1174,122,2,285,6,1627,3,60
1175,122,2,286,3,1630,1,30
1176,122,2,287,7,1637,0,70
1177,122,2,288,8,1645,0,80
1178,122,2,289,9,1654,0,90
1179,122,2,290,5,1659,20,50
1180,122,2,291,8,1667,2,80
1181,122,2,292,5,1672,4,50
1182,122,2,293,2,1674,2,20
1183,122,2,294,8,1682,0,80
1184,122,2,295,7,1689,9,70
1185,122,2,296,8,1697,2,80
1186,122,2,297,9,1706,2,90
1187,122,2,298,9,1715,5,90
1188,122,2,299,7,1722,5,70
1189,122,2,300,5,1727,0,50
1190,122,2,301,7,1734,0,70
1191,122,2,302,2,1736,0,20
1192,122,2,303,4,1740,2,40
1193,122,2,304,8,1748,2,80
1194,122,2,305,6,1754,0,60
1195,122,2,306,3,1757,4,30
1196,122,2,307,6,1763,5,60
1197,122,2,308,3,1766,0,30
1198,122,2,309,4,1770,0,40
1199,122,2,310,5,1775,2,50
1200,122,2,311,7,1782,0,70
1201,122,2,312,7,1789,9,70
1202,122,2,313,3,1792,1,30
1203,122,2,314,6,1798,0,60
1204,122,2,315,9,1807,4,90
1205,122,2,316,5,1812,0,50
1206,122,2,317,9,1821,7,90
1207,122,2,318,3,1824,0,30
1208,122,2,319,2,1826,2,20
1209,122,2,320,4,1830,0,40
1210,122,2,321,3,1833,7,30
1211,122,2,322,3,1836,0,30
1212,122,2,323,6,1842,0,60
1213,122,2,324,9,1851,6,90
1214,122,2,325,5,1856,0,50
1215,122,2,326,4,1860,3,40
1216,122,2,327,4,1864,0,40
1217,122,2,328,6,1870,4,60
1218,122,2,329,6,1876,4,60
1219,122,2,330,7,1883,4,70
1220,122,2,331,4,1887,0,40
1221,122,2,332,5,1892,4,50
1222,122,2,333,9,1901,6,90
1223,122,2,334,9,1910,0,90
1224,122,2,335,5,1915,0,50
1225,122,2,336,2,1917,6,20
1226,122,2,337,6,1923,2,60
1227,122,2,338,7,1930,5,70
1228,122,2,339,8,1938,8,80
1229,122,2,340,3,1941,3,30
1230,122,2,341,3,1944,0,30
1231,122,2,342,5,1949,0,50
1232,122,2,343,2,1951,0,20
1233,122,2,344,2,1953,4,20
1234,122,2,345,2,1955,0,20
1235,122,2,346,8,1963,6,80
1236,122,2,347,2,1965,0,20
1237,122,2,348,3,1968,2,30
1238,122,2,349,2,1970,0,20
1239,122,2,350,3,1973,4,30
1240,122,2,351,9,1982,3,90
1241,122,2,352,6,1988,0,60
1242,122,2,353,9,1997,12,90
1243,122,2,354,3,2000,1,30
1244,122,2,355,6,2006,4,60
1245,122,2,356,2,2008,0,20
1246,122,2,357,2,2010,0,20
1247,122,2,358,7,2017,8,70
1248,122,2,359,3,2020,2,30
1249,122,2,360,9,2029,4,90
1250,122,2,361,2,2031,0,20
1251,122,2,362,7,2038,5,70
1252,122,2,363,3,2041,0,30
1253,122,2,364,9,2050,2,90
1254,122,2,365,5,2055,0,50
1255,122,2,366,4,2059,0,40
1256,122,2,367,9,2068,0,90
1257,122,2,368,7,2075,0,70
1258,122,2,369,2,2077,10,20
1259,122,2,370,2,2079,0,20
1260,122,2,371,9,2088,0,90
1261,122,2,372,7,2095,0,70
1262,122,2,373,3,2098,13,30
1263,122,2,374,2,2100,0,20
1264,122,2,375,7,2107,5,70
1265,122,2,376,5,2112,1,50
1266,122,2,377,5,2117,4,50
1267,122,2,378,5,2122,2,50
1268,122,2,379,8,2130,3,80
1269,122,2,380,3,2133,0,30
1270,122,2,381,4,2137,0,40
1271,122,2,382,4,2141,4,40
1272,122,2,383,8,2149,2,80
1273,122,2,384,2,2151,2,20
1274,122,2,385,7,2158,3,70
1275,122,2,386,8,2166,0,80
1276,122,2,387,2,2168,3,20
1277,122,2,388,5,2173,2,50
1278,122,2,389,2,2175,0,20
1279,122,2,390,8,2183,4,80
1280,122,2,391,9,2192,2,90
1281,122,2,392,4,2196,2,40
1282,122,2,393,7,2203,0,70
1283,122,2,394,8,2211,0,80
1284,122,2,395,5,2216,10,50
1285,122,2,396,9,2225,4,90
1286,122,2,397,7,2232,6,70
1287,122,2,398,8,2240,0,80
1288,122,2,399,5,2245,9,50
1289,122,2,400,6,2251,3,60
1290,122,2,401,5,2256,0,50
1291,122,2,402,5,2261,3,50
1292,122,2,403,2,2263,1,20
1293,122,2,404,6,2269,0,60
1294,122,2,405,4,2273,0,40
1295,122,2,406,7,2280,4,70
1296,122,2,407,3,2283,2,30
1297,122,2,408,6,2289,1,60
1298,122,2,409,4,2293,0,40
1299,122,2,410,5,2298,2,50
1300,122,2,411,9,2307,5,90
1301,122,2,412,4,2311,2,40
1302,122,2,413,5,2316,5,50
1303,122,2,414,7,2323,5,70
1304,122,2,415,8,2331,0,80
1305,122,2,416,8,2339,7,80
1306,122,2,417,6,2345,0,60
1307,122,2,418,4,2349,0,40
1308,122,2,419,7,2356,5,70
1309,122,2,420,5,2361,3,50
1310,122,2,421,4,2365,2,40
1311,122,2,422,9,2374,0,90
1312,122,2,423,7,2381,0,70
1313,122,2,424,9,2390,0,90
1314,122,2,425,8,2398,0,80
1315,122,2,426,5,2403,17,50
1316,122,2,427,5,2408,0,50
1317,122,2,428,6,2414,9,60
1318,122,2,429,2,2416,1,20
1319,122,2,430,5,2421,0,50
1320,122,2,431,5,2426,2,50
1321,122,2,432,3,2429,0,30
1322,122,2,433,5,2434,6,50
1323,122,2,434,5,2439,0,50
1324,122,2,435,6,2445,0,60
1325,122,2,436,4,2449,7,40
1326,122,2,437,7,2456,0,70
1327,122,2,438,4,2460,0,40
1328,122,2,439,4,2464,7,40
1329,122,2,440,5,2469,0,50
1330,122,2,441,4,2473,1,40
1331,122,2,442,4,2477,1,40
1332,122,2,443,9,2486,4,90
1333,122,2,444,6,2492,2,60
1334,122,2,445,3,2495,1,30
1335,122,2,446,4,2499,2,40
1336,122,2,447,5,2504,3,50
1337,122,2,448,2,2506,1,20
1338,122,2,449,6,2512,0,60
1339,122,2,450,5,2517,8,50
1340,122,2,451,4,2521,3,40
1341,122,2,452,3,2524,1,30
1342,122,2,453,8,2532,0,80
1343,122,2,454,5,2537,0,50
1344,122,2,455,2,2539,3,20
1345,122,2,456,2,2541,0,20
1346,122,2,457,5,2546,2,50
1347,122,2,458,5,2551,2,50
1348,122,2,459,4,2555,1,40
1349,122,2,460,2,2557,0,20
1350,122,2,461,6,2563,1,60
1351,122,2,462,3,2566,2,30
1352,122,2,463,3,2569,0,30
1353,122,2,464,8,2577,0,80
1354,122,2,465,5,2582,8,50
1355,122,2,466,8,2590,5,80
1356,122,2,467,8,2598,6,80
1357,122,2,468,6,2604,0,60
1358,122,2,469,9,2613,0,90
1359,122,2,470,8,2621,0,80
1360,122,2,471,3,2624,9,30
1361,122,2,472,9,2633,0,90
1362,122,2,473,2,2635,5,20
1363,122,2,474,5,2640,7,50
1364,122,2,475,4,2644,0,40
1365,122,2,476,8,2652,0,80
1366,122,2,477,6,2658,0,60
1367,122,2,478,5,2663,9,50
1368,122,2,479,6,2669,2,60
1369,122,2,480,9,2678,8,90
1370,122,2,481,9,2687,4,90
1371,122,2,482,9,2696,2,90
1372,122,2,483,6,2702,6,60
1373,122,2,484,7,2709,4,70
1374,122,2,485,9,2718,3,90
1375,122,2,486,3,2721,0,30
1376,122,2,487,5,2726,0,50
1377,122,2,488,7,2733,7,70
1378,122,2,489,5,2738,0,50
1379,122,2,490,3,2741,2,30
1380,122,2,491,5,2746,1,50
1381,122,2,492,9,2755,3,90
1382,122,2,493,7,2762,5,70
1383,122,2,494,3,2765,1,30
1384,122,2,495,5,2770,3,50
1385,122,2,496,2,2772,0,20
1386,122,2,497,2,2774,0,20
1387,122,2,498,2,2776,0,20
1388,122,2,499,2,2778,4,20
1389,122,2,500,9,2787,1,90
1390,122,2,501,3,2790,3,30
1391,122,2,502,9,2799,1,90
1392,122,2,503,9,2808,5,90
1393,122,2,504,7,2815,0,70
1394,122,2,505,5,2820,4,50
1395,122,2,506,9,2829,4,90
1396,122,2,507,8,2837,0,80
1397,122,2,508,6,2843,14,60
1398,122,2,509,8,2851,5,80
1399,122,2,510,8,2859,4,80
1400,122,2,511,6,2865,3,60
1401,122,2,512,2,2867,2,20
1402,122,2,513,5,2872,2,50
1403,122,2,514,3,2875,0,30
1404,122,2,515,3,2878,3,30
1405,122,2,516,2,2880,0,20
1406,122,2,517,6,2886,0,60
1407,122,2,518,6,2892,0,60
1408,122,2,519,2,2894,0,20
1409,122,2,520,2,2896,10,20
1410,122,2,521,7,2903,2,70
1411,122,2,522,6,2909,4,60
1412,122,2,523,5,2914,0,50
1413,122,2,524,3,2917,4,30
1414,122,2,525,3,2920,0,30
1415,122,2,526,7,2927,4,70
1416,122,2,527,5,2932,3,50
1417,122,2,528,9,2941,3,90
1418,122,2,529,3,2944,2,30
1419,122,2,530,4,2948,0,40
1420,122,2,531,7,2955,0,70
1421,122,2,532,2,2957,6,20
1422,122,2,533,4,2961,0,40
1423,122,2,534,2,2963,2,20
1424,122,2,535,3,2966,0,30
1425,122,2,536,5,2971,0,50
1426,122,2,537,2,2973,6,20
1427,122,2,538,7,2980,0,70
1428,122,2,539,8,2988,11,80
1429,122,2,540,3,2991,3,30
1430,122,2,541,7,2998,0,70
1431,122,2,542,7,3005,3,70
1432,122,2,543,9,3014,0,90
1433,122,2,544,8,3022,0,80
1434,122,2,545,9,3031,12,90
1435,122,2,546,7,3038,3,70
1436,122,2,547,7,3045,4,70
1437,122,2,548,3,3048,0,30
1438,122,2,549,9,3057,0,90
1439,122,2,550,7,3064,0,70
1440,122,2,551,6,3070,0,60
1441,122,2,552,3,3073,0,30
1442,122,2,553,8,3081,18,80
1443,122,2,554,6,3087,0,60
1444,122,2,555,3,3090,6,30
1445,122,2,556,7,3097,0,70
1446,122,2,557,9,3106,7,90
1447,122,2,558,8,3114,0,80
1448,122,2,559,5,3119,5,50
1449,122,2,560,6,3125,5,60
1450,122,2,561,5,3130,2,50
1451,122,2,562,3,3133,1,30
1452,122,2,563,6,3139,2,60
1453,122,2,564,6,3145,0,60
1454,122,2,565,8,3153,10,80
1455,122,2,566,8,3161,4,80
1456,122,2,567,3,3164,1,30
1457,122,2,568,3,3167,2,30
1458,122,2,569,6,3173,7,60
1459,122,2,570,8,3181,3,80
1460,122,2,571,3,3184,0,30
1461,122,2,572,2,3186,4,20
1462,122,2,573,4,3190,0,40
1463,122,2,574,7,3197,5,70
1464,122,2,575,2,3199,1,20
1465,122,2,576,9,3208,5,90
1466,122,2,577,5,3213,2,50
1467,122,2,578,7,3220,0,70
1468,122,2,579,8,3228,0,80
1469,122,2,580,4,3232,0,40
1470,122,2,581,9,3241,15,90
1471,122,2,582,4,3245,0,40
1472,122,2,583,7,3252,7,70
1473,122,2,584,7,3259,0,70
1474,122,2,585,2,3261,0,20
1475,122,2,586,8,3269,8,80
1476,122,2,587,6,3275,4,60
1477,122,2,588,5,3280,0,50
1478,122,2,589,6,3286,5,60
1479,122,2,590,3,3289,0,30
1480,122,2,591,4,3293,3,40
1481,122,2,592,2,3295,0,20
1482,122,2,593,9,3304,0,90
1483,122,2,594,9,3313,0,90
1484,122,2,595,6,3319,0,60
1485,122,2,596,4,3323,0,40
1486,122,2,597,9,3332,21,90
1487,122,2,598,5,3337,2,50
1488,122,2,599,3,3340,1,30
1489,122,2,600,4,3344,3,40
1490,122,2,601,6,3350,2,60
1491,122,2,602,3,3353,2,30
1492,122,2,603,8,3361,2,80
1493,122,2,604,3,3364,0,30
1494,122,2,605,3,3367,2,30
1495,122,2,606,3,3370,4,30
1496,122,2,607,2,3372,0,20
1497,122,2,608,8,3380,4,80
1498,122,2,609,4,3384,2,40
1499,122,2,610,5,3389,2,50
1500,122,2,611,4,3393,0,40
1501,122,2,612,8,3401,0,80
1502,122,2,613,3,3404,7,30
1503,122,2,614,5,3409,2,50
1504,122,2,615,5,3414,0,50
1505,122,2,616,6,3420,0,60
1506,122,2,617,3,3423,13,30
1507,122,2,618,8,3431,3,80
1508,122,2,619,7,3438,1,70
1509,122,2,620,5,3443,2,50
1510,122,2,621,8,3451,12,80
1511,122,2,622,7,3458,8,70
1512,122,2,623,5,3463,2,50
1513,122,2,624,3,3466,0,30
1514,122,2,625,9,3475,4,90
1515,122,2,626,7,3482,4,70
1516,122,2,627,6,3488,2,60
1517,122,2,628,9,3497,6,90
1518,122,2,629,9,3506,3,90
1519,122,2,630,4,3510,2,40
1520,122,2,631,5,3515,1,50
1521,122,2,632,5,3520,5,50
1522,122,2,633,9,3529,2,90
1523,122,2,634,8,3537,6,80
1524,122,2,635,9,3546,7,90
1525,122,2,636,4,3550,3,40
1526,122,2,637,9,3559,0,90
1527,122,2,638,8,3567,7,80
1528,122,2,639,5,3572,5,50
1529,122,2,640,2,3574,1,20
1530,122,2,641,2,3576,0,20
1531,122,2,642,2,3578,1,20
1532,122,2,643,4,3582,0,40
1533,122,2,644,6,3588,5,60
1534,122,2,645,2,3590,1,20
1535,122,2,646,9,3599,0,90
1536,122,2,647,5,3604,0,50
1537,122,2,648,3,3607,14,30
1538,122,2,649,3,3610,2,30
1539,122,2,650,6,3616,2,60
1540,122,2,651,9,3625,6,90
1541,122,2,652,2,3627,0,20
1542,122,2,653,7,3634,2,70
1543,122,2,654,7,3641,0,70
1544,122,2,655,2,3643,1,20
1545,122,2,656,5,3648,0,50
1546,122,2,657,7,3655,0,70
1547,122,2,658,9,3664,7,90
1548,122,2,659,3,3667,2,30
1549,122,2,660,6,3673,2,60
1550,122,2,661,7,3680,5,70
1551,122,2,662,7,3687,3,70
1552,122,2,663,7,3694,0,70
1553,122,2,664,4,3698,0,40
1554,122,2,665,7,3705,15,70
1555,122,2,666,5,3710,0,50
1556,122,2,667,6,3716,4,60
1557,122,2,668,5,3721,3,50
1558,122,2,669,7,3728,4,70
1559,122,2,670,6,3734,5,60
1560,122,2,671,6,3740,3,60
1561,122,2,672,2,3742,0,20
1562,122,2,673,8,3750,0,80
1563,122,2,674,6,3756,10,60
1564,122,2,675,4,3760,1,40
1565,122,2,676,9,3769,10,90
1566,122,2,677,7,3776,0,70
1567,122,2,678,4,3780,6,40
1568,122,2,679,8,3788,2,80
1569,122,2,680,9,3797,0,90
1570,122,2,681,2,3799,0,20
1571,122,2,682,3,3802,7,30
1572,122,2,683,7,3809,6,70
1573,122,2,684,8,3817,0,80
1574,122,2,685,9,3826,9,90
1575,122,2,686,7,3833,0,70
1576,122,2,687,3,3836,0,30
1577,122,2,688,3,3839,6,30
1578,122,2,689,5,3844,0,50
1579,122,2,690,6,3850,2,60
1580,122,2,691,8,3858,2,80
1581,122,2,692,9,3867,3,90
1582,122,2,693,4,3871,2,40
1583,122,2,694,2,3873,0,20
1584,122,2,695,6,3879,5,60
1585,122,2,696,7,3886,4,70
1586,122,2,697,8,3894,3,80
1587,122,2,698,2,3896,0,20
1588,122,2,699,3,3899,4,30
1589,122,2,700,2,3901,0,20
1590,122,2,701,6,3907,6,60
1591,122,2,702,5,3912,6,50
1592,122,2,703,2,3914,1,20
1593,122,2,704,4,3918,1,40
1594,122,2,705,5,3923,0,50
1595,122,2,706,5,3928,0,50
1596,122,2,707,9,3937,3,90
1597,122,2,708,6,3943,0,60
1598,122,2,709,2,3945,2,20
1599,122,2,710,7,3952,0,70
1600,122,2,711,9,3961,0,90
1601,122,2,712,6,3967,10,60
1602,122,2,713,7,3974,1,70
1603,122,2,714,3,3977,3,30
1604,122,2,715,2,3979,0,20
1605,122,2,716,2,3981,0,20
1606,122,2,717,7,3988,5,70
1607,122,2,718,4,3992,1,40
1608,122,2,719,8,4000,0,80
1609,122,2,720,6,4006,5,60
1610,122,2,721,6,4012,4,60
1611,122,2,722,4,4016,2,40
1612,122,2,723,6,4022,4,60
1613,122,2,724,5,4027,5,50
1614,122,2,725,4,4031,0,40
1615,122,2,726,5,4036,0,50
1616,122,2,727,3,4039,0,30
1617,122,2,728,5,4044,11,50
1618,122,2,729,6,4050,0,60
1619,122,2,730,5,4055,6,50
1620,122,2,731,5,4060,2,50
1621,122,2,732,6,4066,5,60
1622,122,2,733,6,4072,0,60
1623,122,2,734,6,4078,0,60
1624,122,2,735,9,4087,13,90
1625,122,2,736,4,4091,0,40
1626,122,2,737,6,4097,2,60
1627,122,2,738,3,4100,1,30
1628,122,2,739,7,4107,1,70
1629,122,2,740,2,4109,0,20
1630,122,2,741,4,4113,0,40
1631,122,2,742,2,4115,4,20
1632,122,2,743,3,4118,2,30
1633,122,2,744,2,4120,2,20
1634,122,2,745,3,4123,2,30
1635,122,2,746,5,4128,0,50
1636,122,2,747,6,4134,3,60
1637,122,2,748,7,4141,4,70
1638,122,2,749,7,4148,7,70
1639,122,2,750,6,4154,3,60
1640,122,2,751,2,4156,0,20
1641,122,2,752,9,4165,6,90
1642,122,2,753,2,4167,0,20
1643,122,2,754,7,4174,0,70
1644,122,2,755,8,4182,0,80
1645,122,2,756,5,4187,0,50
1646,122,2,757,3,4190,0,30
1647,122,2,758,7,4197,13,70
1648,122,2,759,3,4200,0,30
1649,122,2,760,8,4208,4,80
1650,122,2,761,6,4214,2,60
1651,122,2,762,7,4221,0,70
1652,122,2,763,2,4223,1,20
1653,122,2,764,9,4232,5,90
1654,122,2,765,9,4241,7,90
1655,122,2,766,4,4245,1,40
1656,122,2,767,7,4252,3,70
1657,122,2,768,9,4261,5,90
1658,122,2,769,3,4264,0,30
1659,122,2,770,9,4273,5,90
1660,122,2,771,5,4278,0,50
1661,122,2,772,4,4282,1,40
1662,122,2,773,5,4287,0,50
1663,122,2,774,8,4295,0,80
1664,122,2,775,6,4301,11,60
1665,122,2,776,9,4310,11,90
1666,122,2,777,6,4316,5,60
1667,122,2,778,9,4325,2,90
1668,122,2,779,2,4327,2,20
1669,122,2,780,5,4332,6,50
1670,122,2,781,9,4341,5,90
1671,122,2,782,6,4347,4,60
1672,122,2,783,4,4351,1,40
1673,122,2,784,5,4356,0,50
1674,122,2,785,3,4359,5,30
1675,122,2,786,3,4362,1,30
1676,122,2,787,6,4368,4,60
1677,122,2,788,3,4371,3,30
1678,122,2,789,7,4378,0,70
1679,122,2,790,4,4382,3,40
1680,122,2,791,9,4391,3,90
1681,122,2,792,3,4394,3,30
1682,122,2,793,5,4399,1,50
1683,122,2,794,9,4408,3,90
1684,122,2,795,2,4410,0,20
1685,122,2,796,2,4412,2,20
1686,122,2,797,5,4417,4,50
1687,122,2,798,8,4425,2,80
1688,122,2,799,9,4434,7,90
1689,122,2,800,6,4440,5,60
1690,122,2,801,9,4449,2,90
1691,122,2,802,8,4457,0,80
1692,122,2,803,3,4460,7,30
1693,122,2,804,2,4462,0,20
1694,122,2,805,8,4470,0,80
1695,122,2,806,7,4477,0,70
1696,122,2,807,4,4481,10,40
1697,122,2,808,4,4485,3,40
1698,122,2,809,9,4494,0,90
1699,122,2,810,6,4500,6,60
1700,122,2,811,9,4509,2,90
1701,122,2,812,6,4515,2,60
1702,122,2,813,2,4517,1,20
1703,122,2,814,8,4525,0,80
1704,122,2,815,6,4531,10,60
1705,122,2,816,7,4538,4,70
1706,122,2,817,4,4542,0,40
1707,122,2,818,5,4547,0,50
1708,122,2,819,5,4552,5,50
1709,122,2,820,9,4561,9,90
1710,122,2,821,4,4565,0,40
1711,122,2,822,2,4567,3,20
1712,122,2,823,2,4569,0,20
1713,122,2,824,2,4571,0,20
1714,122,2,825,4,4575,2,40
1715,122,2,826,5,4580,1,50
1716,122,2,827,6,4586,0,60
1717,122,2,828,8,4594,10,80
1718,122,2,829,4,4598,0,40
1719,122,2,830,2,4600,0,20
1720,122,2,831,2,4602,0,20
1721,122,2,832,5,4607,5,50
1722,122,2,833,5,4612,2,50
1723,122,2,834,4,4616,1,40
1724,122,2,835,9,4625,5,90
1725,122,2,836,7,4632,1,70
1726,122,2,837,2,4634,0,20
1727,122,2,838,6,4640,2,60
1728,122,2,839,8,4648,0,80
1729,122,2,840,6,4654,0,60
1730,122,2,841,8,4662,18,80
1731,122,2,842,6,4668,0,60
1732,122,2,843,9,4677,9,90
1733,122,2,844,4,4681,1,40
1734,122,2,845,6,4687,1,60
1735,122,2,846,6,4693,0,60
1736,122,2,847,6,4699,5,60
1737,122,2,848,2,4701,1,20
1738,122,2,849,2,4703,0,20
1739,122,2,850,8,4711,0,80
1740,122,2,851,4,4715,9,40
1741,122,2,852,9,4724,0,90
1742,122,2,853,8,4732,7,80
1743,122,2,854,8,4740,4,80
1744,122,2,855,8,4748,5,80
1745,122,2,856,4,4752,0,40
1746,122,2,857,9,4761,0,90
1747,122,2,858,5,4766,4,50
1748,122,2,859,3,4769,0,30
1749,122,2,860,3,4772,0,30
1750,122,2,861,9,4781,3,90
1751,122,2,862,7,4788,0,70
1752,122,2,863,8,4796,4,80
1753,122,2,864,9,4805,0,90
1754,122,2,865,8,4813,7,80
1755,122,2,866,8,4821,0,80
1756,122,2,867,9,4830,9,90
1757,122,2,868,8,4838,4,80
1758,122,2,869,8,4846,0,80
1759,122,2,870,3,4849,7,30
1760,122,2,871,7,4856,4,70
1761,122,2,872,8,4864,3,80
1762,122,2,873,8,4872,3,80
1763,122,2,874,7,4879,0,70
1764,122,2,875,3,4882,0,30
1765,122,2,876,6,4888,0,60
1766,122,2,877,9,4897,19,90
1767,122,2,878,8,4905,0,80
1768,122,2,879,2,4907,7,20
1769,122,2,880,9,4916,0,90
1770,122,2,881,5,4921,11,50
1771,122,2,882,4,4925,1,40
1772,122,2,883,9,4934,2,90
1773,122,2,884,6,4940,4,60
1774,122,2,885,7,4947,3,70
1775,122,2,886,6,4953,1,60
1776,122,2,887,6,4959,5,60
1777,122,2,888,3,4962,0,30
1778,122,2,889,7,4969,8,70
1779,122,2,890,5,4974,0,50
1780,122,2,891,9,4983,0,90
1781,122,2,892,7,4990,18,70
1782,122,2,893,6,4996,4,60
1783,122,3,1,7,7,4,70
1784,122,3,2,3,10,1,30
1785,122,3,3,9,19,2,90
1786,122,3,4,6,25,5,60
1787,122,3,5,9,34,3,90
1788,122,3,6,9,43,0,90
1789,122,3,7,8,51,7,80
1790,122,3,8,4,55,0,40
1791,122,3,9,8,63,0,80
1792,122,3,10,8,71,0,80
1793,122,3,11,6,77,0,60
1794,122,3,12,4,81,0,40
1795,122,3,13,6,87,17,60
1796,122,3,14,8,95,3,80
1797,122,3,15,4,99,1,40
1798,122,3,16,7,106,2,70
1799,122,3,17,5,111,0,50
1800,122,3,18,9,120,6,90
1801,122,3,19,4,124,3,40
1802,122,3,20,8,132,4,80
1803,122,3,21,4,136,0,40
1804,122,3,22,7,143,4,70
1805,122,3,23,2,145,0,20
1806,122,3,24,4,149,0,40
1807,122,3,25,3,152,3,30
1808,122,3,26,8,160,3,80
1809,122,3,27,8,168,8,80
1810,122,3,28,6,174,5,60
1811,122,3,29,6,180,2,60
1812,122,3,30,5,185,0,50
1813,122,3,31,7,192,9,70
1814,122,3,32,6,198,3,60
1815,122,3,33,6,204,7,60
1816,122,3,34,4,208,0,40
1817,122,3,35,2,210,0,20
1818,122,3,36,5,215,2,50
1819,122,3,37,6,221,0,60
1820,122,3,38,9,230,6,90
1821,122,3,39,9,239,5,90
1822,122,3,40,4,243,5,40
1823,122,3,41,4,247,0,40
1824,122,3,42,6,253,4,60
1825,122,3,43,6,259,2,60
1826,122,3,44,5,264,0,50
1827,122,3,45,8,272,0,80
1828,122,3,46,8,280,8,80
1829,122,3,47,2,282,0,20
1830,122,3,48,7,289,0,70
1831,122,3,49,3,292,7,30
1832,122,3,50,9,301,3,90
1833,122,3,51,6,307,0,60
1834,122,3,52,3,310,2,30
1835,122,3,53,2,312,0,20
1836,122,3,54,6,318,0,60
1837,122,3,55,6,324,9,60
1838,122,3,56,8,332,0,80
1839,122,3,57,5,337,0,50
1840,122,3,58,2,339,0,20
1841,122,3,59,7,346,0,70
1842,122,3,60,9,355,14,90
1843,122,3,61,2,357,0,20
1844,122,3,62,7,364,4,70
1845,122,3,63,4,368,0,40
1846,122,3,64,6,374,0,60
1847,122,3,65,4,378,5,40
1848,122,3,66,3,381,0,30
1849,122,3,67,6,387,2,60
1850,122,3,68,9,396,0,90
1851,122,3,69,3,399,0,30
1852,122,3,70,7,406,0,70
1853,122,3,71,8,414,0,80
1854,122,3,72,8,422,15,80
1855,122,3,73,4,426,0,40
1856,122,3,74,3,429,3,30
1857,122,3,75,8,437,3,80
1858,122,3,76,6,443,3,60
1859,122,3,77,8,451,0,80
1860,122,3,78,2,453,0,20
1861,122,3,79,2,455,4,20
1862,122,3,80,7,462,4,70
1863,122,3,81,2,464,0,20
1864,122,3,82,5,469,0,50
1865,122,3,83,5,474,0,50
1866,122,3,84,9,483,13,90
1867,122,3,85,9,492,0,90
1868,122,3,86,5,497,9,50
1869,122,3,87,7,504,3,70
1870,122,3,88,6,510,1,60
1871,122,3,89,9,519,5,90
1872,122,3,90,2,521,0,20
1873,122,3,91,9,530,3,90
1874,122,3,92,7,537,4,70
1875,122,3,93,7,544,0,70
1876,122,3,94,9,553,9,90
1877,122,3,95,7,560,4,70
1878,122,3,96,6,566,0,60
1879,122,3,97,8,574,0,80
1880,122,3,98,2,576,11,20
1881,122,3,99,4,580,2,40
1882,122,3,100,7,587,0,70
1883,122,3,101,8,595,7,80
1884,122,3,102,6,601,2,60
1885,122,3,103,7,608,1,70
1886,122,3,104,9,617,3,90
1887,122,3,105,8,625,2,80
1888,122,3,106,4,629,0,40
1889,122,3,107,3,632,0,30
1890,122,3,108,5,637,5,50
1891,122,3,109,5,642,1,50
1892,122,3,110,4,646,0,40
1893,122,3,111,2,648,0,20
1894,122,3,112,6,654,0,60
1895,122,3,113,6,660,0,60
1896,122,3,114,6,666,16,60
1897,122,3,115,7,673,0,70
1898,122,3,116,5,678,10,50
1899,122,3,117,9,687,7,90
1900,122,3,118,9,696,4,90
1901,122,3,119,6,702,4,60
1902,122,3,120,6,708,0,60
1903,122,3,121,7,715,4,70
1904,122,3,122,4,719,4,40
1905,122,3,123,6,725,0,60
1906,122,3,124,9,734,7,90
1907,122,3,125,7,741,3,70
1908,122,3,126,9,750,2,90
1909,122,3,127,4,754,4,40
1910,122,3,128,9,763,5,90
1911,122,3,129,5,768,0,50
1912,122,3,130,7,775,0,70
1913,122,3,131,2,777,5,20
1914,122,3,132,9,786,4,90
1915,122,3,133,9,795,3,90
1916,122,3,134,6,801,5,60
1917,122,3,135,4,805,1,40
1918,122,3,136,5,810,0,50
1919,122,3,137,9,819,11,90
1920,122,3,138,3,822,2,30
1921,122,3,139,5,827,1,50
1922,122,3,140,2,829,0,20
1923,122,3,141,3,832,0,30
1924,122,3,142,8,840,0,80
1925,122,3,143,7,847,9,70
1926,122,3,144,7,854,4,70
1927,122,3,145,9,863,2,90
1928,122,3,146,2,865,0,20
1929,122,3,147,3,868,1,30
1930,122,3,148,8,876,0,80
1931,122,3,149,7,883,0,70
1932,122,3,150,8,891,9,80
1933,122,3,151,7,898,5,70
1934,122,3,152,7,905,0,70
1935,122,3,153,6,911,9,60
1936,122,3,154,7,918,0,70
1937,122,3,155,9,927,3,90
1938,122,3,156,2,929,0,20
1939,122,3,157,9,938,0,90
1940,122,3,158,2,940,0,20
1941,122,3,159,5,945,7,50
1942,122,3,160,5,950,0,50
1943,122,3,161,5,955,0,50
1944,122,3,162,7,962,8,70
1945,122,3,163,2,964,3,20
1946,122,3,164,9,973,0,90
1947,122,3,165,4,977,0,40
1948,122,3,166,2,979,8,20
1949,122,3,167,7,986,2,70
1950,122,3,168,5,991,1,50
1951,122,3,169,5,996,0,50
1952,122,3,170,8,1004,0,80
1953,122,3,171,4,1008,8,40
1954,122,3,172,2,1010,4,20
1955,122,3,173,9,1019,3,90
1956,122,3,174,5,1024,4,50
1957,122,3,175,5,1029,2,50
1958,122,3,176,4,1033,0,40
1959,122,3,177,4,1037,7,40
1960,122,3,178,8,1045,5,80
1961,122,3,179,2,1047,0,20
1962,122,3,180,6,1053,4,60
1963,122,3,181,3,1056,2,30
1964,122,3,182,4,1060,1,40
1965,122,3,183,3,1063,4,30
1966,122,3,184,2,1065,2,20
1967,122,3,185,5,1070,0,50
1968,122,3,186,6,1076,4,60
1969,122,3,187,2,1078,0,20
1970,122,3,188,7,1085,0,70
1971,122,3,189,8,1093,0,80
1972,122,3,190,2,1095,11,20
1973,122,3,191,5,1100,3,50
1974,122,3,192,4,1104,2,40
1975,122,3,193,6,1110,2,60
1976,122,3,194,7,1117,4,70
1977,122,3,195,5,1122,0,50
1978,122,3,196,7,1129,4,70
1979,122,3,197,5,1134,0,50
1980,122,3,198,6,1140,0,60
1981,122,3,199,5,1145,5,50
1982,122,3,200,4,1149,2,40
1983,122,3,201,8,1157,0,80
1984,122,3,202,6,1163,8,60
1985,122,3,203,8,1171,0,80
1986,122,3,204,5,1176,10,50
1987,122,3,205,6,1182,2,60
1988,122,3,206,8,1190,6,80
1989,122,3,207,4,1194,0,40
1990,122,3,208,4,1198,0,40
1991,122,3,209,5,1203,5,50
1992,122,3,210,4,1207,1,40
1993,122,3,211,5,1212,3,50
1994,122,3,212,2,1214,0,20
1995,122,3,213,9,1223,3,90
1996,122,3,214,9,1232,2,90
1997,122,3,215,7,1239,0,70
1998,122,3,216,6,1245,6,60
1999,122,3,217,8,1253,0,80
2000,122,3,218,5,1258,7,50
2001,122,3,219,6,1264,3,60
2002,122,3,220,8,1272,0,80
2003,122,3,221,9,1281,14,90
2004,122,3,222,7,1288,1,70
2005,122,3,223,5,1293,3,50
2006,122,3,224,7,1300,0,70
2007,122,3,225,9,1309,8,90
2008,122,3,226,4,1313,1,40
2009,122,3,227,3,1316,0,30
2010,122,3,228,2,1318,4,20
2011,122,3,229,4,1322,0,40
2012,122,3,230,2,1324,2,20
2013,122,3,231,5,1329,0,50
2014,122,3,232,7,1336,3,70
2015,122,3,233,7,1343,2,70
2016,122,3,234,8,1351,2,80
2017,122,3,235,6,1357,5,60
2018,122,3,236,8,1365,4,80
2019,122,3,237,5,1370,3,50
2020,122,3,238,9,1379,5,90
2021,122,3,239,7,1386,2,70
2022,122,3,240,3,1389,2,30
2023,122,3,241,2,1391,0,20
2024,122,3,242,8,1399,4,80
2025,122,3,243,2,1401,1,20
2026,122,3,244,2,1403,1,20
2027,122,3,245,6,1409,2,60
2028,122,3,246,6,1415,2,60
2029,122,3,247,6,1421,0,60
2030,122,3,248,4,1425,5,40
2031,122,3,249,3,1428,0,30
2032,122,3,250,8,1436,9,80
2033,122,3,251,3,1439,1,30
2034,122,3,252,2,1441,0,20
2035,122,3,253,4,1445,0,40
2036,122,3,254,9,1454,10,90
2037,122,3,255,5,1459,3,50
2038,122,3,256,8,1467,6,80
2039,122,3,257,8,1475,0,80
2040,122,3,258,5,1480,9,50
2041,122,3,259,8,1488,7,80
2042,122,3,260,4,1492,0,40
2043,122,3,261,6,1498,0,60
2044,122,3,262,2,1500,6,20
2045,122,3,263,3,1503,2,30
2046,122,3,264,6,1509,0,60
2047,122,3,265,8,1517,10,80
2048,122,3,266,6,1523,0,60
2049,122,3,267,7,1530,5,70
2050,122,3,268,4,1534,5,40
2051,122,3,269,2,1536,0,20
2052,122,3,270,4,1540,4,40
2053,122,3,271,4,1544,4,40
2054,122,3,272,3,1547,1,30
2055,122,3,273,6,1553,1,60
2056,122,3,274,3,1556,2,30
2057,122,3,275,4,1560,1,40
2058,122,3,276,3,1563,3,30
2059,122,3,277,2,1565,0,20
2060,122,3,278,9,1574,0,90
2061,122,3,279,3,1577,0,30
2062,122,3,280,5,1582,11,50
2063,122,3,281,3,1585,1,30
2064,122,3,282,8,1593,5,80
2065,122,3,283,2,1595,0,20
2066,122,3,284,6,1601,5,60
2067,122,3,285,3,1604,2,30
2068,122,3,286,3,1607,0,30
2069,122,3,287,4,1611,3,40
2070,122,3,288,7,1618,2,70
2071,122,3,289,9,1627,5,90
2072,122,3,290,8,1635,5,80
2073,122,3,291,9,1644,6,90
2074,122,3,292,3,1647,0,30
2075,122,3,293,5,1652,5,50
2076,122,3,294,8,1660,6,80
2077,122,3,295,7,1667,2,70
2078,122,3,296,3,1670,2,30
2079,122,3,297,9,1679,7,90
2080,122,3,298,8,1687,3,80
2081,122,3,299,4,1691,1,40
2082,122,3,300,9,1700,5,90
2083,122,3,301,3,1703,1,30
2084,122,3,302,8,1711,0,80
2085,122,3,303,2,1713,0,20
2086,122,3,304,3,1716,9,30
2087,122,3,305,5,1721,0,50
2088,122,3,306,6,1727,3,60
2089,122,3,307,8,1735,4,80
2090,122,3,308,2,1737,0,20
2091,122,3,309,2,1739,0,20
2092,122,3,310,2,1741,0,20
2093,122,3,311,7,1748,1,70
2094,122,3,312,4,1752,3,40
2095,122,3,313,6,1758,5,60
2096,122,3,314,8,1766,0,80
2097,122,3,315,2,1768,2,20
2098,122,3,316,5,1773,0,50
2099,122,3,317,4,1777,4,40
2100,122,3,318,9,1786,4,90
2101,122,3,319,6,1792,1,60
2102,122,3,320,9,1801,5,90
2103,122,3,321,8,1809,8,80
2104,122,3,322,2,1811,1,20
2105,122,3,323,6,1817,2,60
2106,122,3,324,3,1820,0,30
2107,122,3,325,3,1823,3,30
2108,122,3,326,8,1831,4,80
2109,122,3,327,9,1840,0,90
2110,122,3,328,5,1845,5,50
2111,122,3,329,2,1847,0,20
2112,122,3,330,8,1855,10,80
2113,122,3,331,8,1863,4,80
2114,122,3,332,8,1871,0,80
2115,122,3,333,4,1875,0,40
2116,122,3,334,8,1883,11,80
2117,122,3,335,5,1888,0,50
2118,122,3,336,2,1890,1,20
2119,122,3,337,2,1892,1,20
2120,122,3,338,5,1897,2,50
2121,122,3,339,8,1905,0,80
2122,122,3,340,9,1914,0,90
2123,122,3,341,5,1919,7,50
2124,122,3,342,9,1928,0,90
2125,122,3,343,3,1931,7,30
2126,122,3,344,3,1934,2,30
2127,122,3,345,8,1942,6,80
2128,122,3,346,4,1946,2,40
2129,122,3,347,5,1951,0,50
2130,122,3,348,7,1958,1,70
2131,122,3,349,2,1960,2,20
2132,122,3,350,8,1968,6,80
2133,122,3,351,6,1974,0,60
2134,122,3,352,3,1977,0,30
2135,122,3,353,5,1982,5,50
2136,122,3,354,5,1987,5,50
2137,122,3,355,6,1993,5,60
2138,122,3,356,3,1996,1,30
2139,122,3,357,7,2003,0,70
2140,122,3,358,7,2010,0,70
2141,122,3,359,3,2013,17,30
2142,122,3,360,8,2021,0,80
2143,122,3,361,5,2026,0,50
2144,122,3,362,4,2030,8,40
2145,122,3,363,8,2038,4,80
2146,122,3,364,3,2041,0,30
2147,122,3,365,3,2044,0,30
2148,122,3,366,9,2053,6,90
2149,122,3,367,3,2056,0,30
2150,122,3,368,4,2060,0,40
2151,122,3,369,7,2067,0,70
2152,122,3,370,2,2069,0,20
2153,122,3,371,6,2075,0,60
2154,122,3,372,7,2082,9,70
2155,122,3,373,7,2089,0,70
2156,122,3,374,6,2095,8,60
2157,122,3,375,7,2102,0,70
2158,122,3,376,3,2105,0,30
2159,122,3,377,2,2107,7,20
2160,122,3,378,8,2115,7,80
2161,122,3,379,3,2118,2,30
2162,122,3,380,6,2124,0,60
2163,122,3,381,4,2128,0,40
2164,122,3,382,9,2137,0,90
2165,122,3,383,3,2140,12,30
2166,122,3,384,9,2149,5,90
2167,122,3,385,7,2156,3,70
2168,122,3,386,2,2158,2,20
2169,122,3,387,3,2161,2,30
2170,122,3,388,3,2164,6,30
2171,122,3,389,9,2173,0,90
2172,122,3,390,2,2175,7,20
2173,122,3,391,5,2180,2,50
2174,122,3,392,5,2185,2,50
2175,122,3,393,7,2192,0,70
2176,122,3,394,8,2200,6,80
2177,122,3,395,5,2205,2,50
2178,122,3,396,6,2211,3,60
2179,122,3,397,2,2213,0,20
2180,122,3,398,7,2220,4,70
2181,122,3,399,5,2225,2,50
2182,122,3,400,3,2228,0,30
2183,122,3,401,8,2236,0,80
2184,122,3,402,9,2245,0,90
2185,122,3,403,7,2252,22,70
2186,122,3,404,4,2256,2,40
2187,122,3,405,5,2261,5,50
2188,122,3,406,6,2267,2,60
2189,122,3,407,4,2271,4,40
2190,122,3,408,5,2276,2,50
2191,122,3,409,2,2278,1,20
2192,122,3,410,2,2280,0,20
2193,122,3,411,5,2285,0,50
2194,122,3,412,2,2287,0,20
2195,122,3,413,7,2294,4,70
2196,122,3,414,6,2300,0,60
2197,122,3,415,5,2305,6,50
2198,122,3,416,3,2308,1,30
2199,122,3,417,4,2312,2,40
2200,122,3,418,8,2320,0,80
2201,122,3,419,8,2328,0,80
2202,122,3,420,2,2330,11,20
2203,122,3,421,3,2333,1,30
2204,122,3,422,4,2337,0,40
2205,122,3,423,7,2344,10,70
2206,122,3,424,8,2352,6,80
2207,122,3,425,3,2355,3,30
2208,122,3,426,3,2358,0,30
2209,122,3,427,6,2364,0,60
2210,122,3,428,9,2373,10,90
2211,122,3,429,6,2379,0,60
2212,122,3,430,8,2387,5,80
2213,122,3,431,2,2389,0,20
2214,122,3,432,7,2396,0,70
2215,122,3,433,5,2401,0,50
2216,122,3,434,7,2408,0,70
2217,122,3,435,2,2410,0,20
2218,122,3,436,7,2417,0,70
2219,122,3,437,7,2424,27,70
2220,122,3,438,8,2432,0,80
2221,122,3,439,6,2438,0,60
2222,122,3,440,2,2440,11,20
2223,122,3,441,9,2449,5,90
2224,122,3,442,2,2451,0,20
2225,122,3,443,8,2459,10,80
2226,122,3,444,3,2462,2,30
2227,122,3,445,6,2468,0,60
2228,122,3,446,4,2472,0,40
2229,122,3,447,4,2476,10,40
2230,122,3,448,4,2480,2,40
2231,122,3,449,9,2489,0,90
2232,122,3,450,9,2498,0,90
2233,122,3,451,8,2506,14,80
2234,122,3,452,7,2513,5,70
2235,122,3,453,8,2521,0,80
2236,122,3,454,5,2526,0,50
2237,122,3,455,4,2530,11,40
2238,122,3,456,3,2533,0,30
2239,122,3,457,5,2538,5,50
2240,122,3,458,6,2544,4,60
2241,122,3,459,9,2553,3,90
2242,122,3,460,5,2558,0,50
2243,122,3,461,9,2567,4,90
2244,122,3,462,8,2575,0,80
2245,122,3,463,6,2581,0,60
2246,122,3,464,9,2590,10,90
2247,122,3,465,9,2599,2,90
2248,122,3,466,3,2602,2,30
2249,122,3,467,4,2606,0,40
2250,122,3,468,3,2609,0,30
2251,122,3,469,2,2611,1,20
2252,122,3,470,6,2617,0,60
2253,122,3,471,5,2622,0,50
2254,122,3,472,9,2631,11,90
2255,122,3,473,9,2640,0,90
2256,122,3,474,6,2646,0,60
2257,122,3,475,4,2650,0,40
2258,122,3,476,5,2655,16,50
2259,122,3,477,2,2657,1,20
2260,122,3,478,5,2662,0,50
2261,122,3,479,7,2669,7,70
2262,122,3,480,9,2678,9,90
2263,122,3,481,7,2685,3,70
2264,122,3,482,7,2692,0,70
2265,122,3,483,2,2694,0,20
2266,122,3,484,6,2700,8,60
2267,122,3,485,8,2708,4,80
2268,122,3,486,8,2716,3,80
2269,122,3,487,7,2723,0,70
2270,122,3,488,6,2729,6,60
2271,122,3,489,2,2731,0,20
2272,122,3,490,7,2738,0,70
2273,122,3,491,3,2741,0,30
2274,122,3,492,7,2748,9,70
2275,122,3,493,8,2756,0,80
2276,122,3,494,8,2764,9,80
2277,122,3,495,9,2773,0,90
2278,122,3,496,9,2782,0,90
2279,122,3,497,8,2790,15,80
2280,122,3,498,6,2796,2,60
2281,122,3,499,4,2800,1,40
2282,122,3,500,3,2803,0,30
2283,122,3,501,3,2806,3,30
2284,122,3,502,4,2810,0,40
2285,122,3,503,2,2812,2,20
2286,122,3,504,4,2816,0,40
2287,122,3,505,9,2825,9,90
2288,122,3,506,6,2831,0,60
2289,122,3,507,9,2840,0,90
2290,122,3,508,6,2846,14,60
2291,122,3,509,9,2855,5,90
2292,122,3,510,7,2862,1,70
2293,122,3,511,2,2864,0,20
2294,122,3,512,2,2866,2,20
2295,122,3,513,5,2871,0,50
2296,122,3,514,8,2879,0,80
2297,122,3,515,9,2888,0,90
2298,122,3,516,6,2894,19,60
2299,122,3,517,8,2902,0,80
2300,122,3,518,6,2908,0,60
2301,122,3,519,4,2912,12,40
2302,122,3,520,3,2915,0,30
2303,122,3,521,6,2921,0,60
2304,122,3,522,3,2924,7,30
2305,122,3,523,2,2926,0,20
2306,122,3,524,4,2930,3,40
2307,122,3,525,3,2933,2,30
2308,122,3,526,9,2942,0,90
2309,122,3,527,2,2944,6,20
2310,122,3,528,3,2947,1,30
2311,122,3,529,5,2952,4,50
2312,122,3,530,2,2954,0,20
2313,122,3,531,2,2956,2,20
2314,122,3,532,6,2962,3,60
2315,122,3,533,6,2968,5,60
2316,122,3,534,5,2973,0,50
2317,122,3,535,4,2977,4,40
2318,122,3,536,3,2980,2,30
2319,122,3,537,4,2984,2,40
2320,122,3,538,3,2987,3,30
2321,122,3,539,8,2995,0,80
2322,122,3,540,2,2997,10,20
2323,122,3,541,5,3002,3,50
2324,122,3,542,5,3007,2,50
2325,122,3,543,2,3009,1,20
2326,122,3,544,9,3018,5,90
2327,122,3,545,7,3025,4,70
2328,122,3,546,6,3031,3,60
2329,122,3,547,7,3038,4,70
2330,122,3,548,3,3041,0,30
2331,122,3,549,8,3049,9,80
2332,122,3,550,3,3052,0,30
2333,122,3,551,7,3059,0,70
2334,122,3,552,5,3064,5,50
2335,122,3,553,9,3073,0,90
2336,122,3,554,3,3076,0,30
2337,122,3,555,2,3078,0,20
2338,122,3,556,7,3085,7,70
2339,122,3,557,7,3092,3,70
2340,122,3,558,8,3100,0,80
2341,122,3,559,5,3105,6,50
2342,122,3,560,8,3113,2,80
2343,122,3,561,3,3116,0,30
2344,122,3,562,7,3123,3,70
2345,122,3,563,7,3130,2,70
2346,122,3,564,5,3135,3,50
2347,122,3,565,2,3137,1,20
2348,122,3,566,8,3145,3,80
2349,122,3,567,2,3147,0,20
2350,122,3,568,8,3155,0,80
2351,122,3,569,5,3160,4,50
2352,122,3,570,9,3169,7,90
2353,122,3,571,5,3174,5,50
2354,122,3,572,7,3181,0,70
2355,122,3,573,9,3190,0,90
2356,122,3,574,3,3193,5,30
2357,122,3,575,2,3195,2,20
2358,122,3,576,5,3200,4,50
2359,122,3,577,2,3202,1,20
2360,122,3,578,3,3205,0,30
2361,122,3,579,8,3213,6,80
2362,122,3,580,5,3218,2,50
2363,122,3,581,7,3225,0,70
2364,122,3,582,8,3233,6,80
2365,122,3,583,5,3238,0,50
2366,122,3,584,9,3247,0,90
2367,122,3,585,6,3253,8,60
2368,122,3,586,2,3255,3,20
2369,122,3,587,6,3261,2,60
2370,122,3,588,8,3269,0,80
2371,122,3,589,3,3272,5,30
2372,122,3,590,4,3276,4,40
2373,122,3,591,8,3284,0,80
2374,122,3,592,5,3289,12,50
2375,122,3,593,6,3295,4,60
2376,122,3,594,2,3297,1,20
2377,122,3,595,4,3301,0,40
2378,122,3,596,8,3309,6,80
2379,122,3,597,6,3315,0,60
2380,122,3,598,7,3322,8,70
2381,122,3,599,4,3326,2,40
2382,122,3,600,3,3329,0,30
2383,122,3,601,8,3337,5,80
2384,122,3,602,9,3346,0,90
2385,122,3,603,6,3352,0,60
2386,122,3,604,9,3361,8,90
2387,122,3,605,5,3366,1,50
2388,122,3,606,4,3370,1,40
2389,122,3,607,9,3379,0,90
2390,122,3,608,5,3384,0,50
2391,122,3,609,9,3393,13,90
2392,122,3,610,6,3399,6,60
2393,122,3,611,7,3406,1,70
2394,122,3,612,6,3412,2,60
2395,122,3,613,3,3415,1,30
2396,122,3,614,3,3418,2,30
2397,122,3,615,3,3421,4,30
2398,122,3,616,2,3423,1,20
2399,122,3,617,4,3427,0,40
2400,122,3,618,5,3432,0,50
2401,122,3,619,8,3440,12,80
2402,122,3,620,3,3443,3,30
2403,122,3,621,4,3447,0,40
2404,122,3,622,3,3450,0,30
2405,122,3,623,5,3455,0,50
2406,122,3,624,6,3461,0,60
2407,122,3,625,9,3470,0,90
2408,122,3,626,2,3472,0,20
2409,122,3,627,8,3480,0,80
2410,122,3,628,2,3482,20,20
2411,122,3,629,3,3485,0,30
2412,122,3,630,7,3492,4,70
2413,122,3,631,8,3500,8,80
2414,122,3,632,6,3506,0,60
2415,122,3,633,6,3512,4,60
2416,122,3,634,4,3516,1,40
2417,122,3,635,2,3518,0,20
2418,122,3,636,8,3526,0,80
2419,122,3,637,4,3530,8,40
2420,122,3,638,2,3532,2,20
2421,122,3,639,9,3541,0,90
2422,122,3,640,8,3549,10,80
2423,122,3,641,9,3558,0,90
2424,122,3,642,8,3566,0,80
2425,122,3,643,9,3575,9,90
2426,122,3,644,7,3582,0,70
2427,122,3,645,6,3588,15,60
2428,122,3,646,6,3594,0,60
2429,122,3,647,2,3596,4,20
2430,122,3,648,5,3601,0,50
2431,122,3,649,2,3603,0,20
2432,122,3,650,5,3608,5,50
2433,122,3,651,2,3610,0,20
2434,122,3,652,5,3615,2,50
2435,122,3,653,7,3622,7,70
2436,122,3,654,8,3630,8,80
2437,122,3,655,7,3637,5,70
2438,122,3,656,5,3642,1,50
2439,122,3,657,2,3644,0,20
2440,122,3,658,9,3653,4,90
2441,122,3,659,5,3658,0,50
2442,122,3,660,4,3662,0,40
2443,122,3,661,4,3666,7,40
2444,122,3,662,8,3674,4,80
2445,122,3,663,6,3680,0,60
2446,122,3,664,7,3687,0,70
2447,122,3,665,7,3694,7,70
2448,122,3,666,3,3697,0,30
2449,122,3,667,4,3701,3,40
2450,122,3,668,8,3709,1,80
2451,122,3,669,7,3716,3,70
2452,122,3,670,8,3724,0,80
2453,122,3,671,4,3728,11,40
2454,122,3,672,5,3733,0,50
2455,122,3,673,9,3742,6,90
2456,122,3,674,2,3744,0,20
2457,122,3,675,6,3750,0,60
2458,122,3,676,9,3759,0,90
2459,122,3,677,9,3768,0,90
2460,122,3,678,7,3775,0,70
2461,122,3,679,6,3781,0,60
2462,122,3,680,8,3789,19,80
2463,122,3,681,8,3797,0,80
2464,122,3,682,8,3805,9,80
2465,122,3,683,6,3811,4,60
2466,122,3,684,7,3818,3,70
2467,122,3,685,8,3826,5,80
2468,122,3,686,2,3828,2,20
2469,122,3,687,3,3831,1,30
2470,122,3,688,4,3835,0,40
2471,122,3,689,8,3843,0,80
2472,122,3,690,4,3847,2,40
2473,122,3,691,5,3852,2,50
2474,122,3,692,4,3856,0,40
2475,122,3,693,3,3859,4,30
2476,122,3,694,3,3862,0,30
2477,122,3,695,9,3871,7,90
2478,122,3,696,5,3876,1,50
2479,122,3,697,4,3880,1,40
2480,122,3,698,2,3882,0,20
2481,122,3,699,7,3889,0,70
2482,122,3,700,5,3894,10,50
2483,122,3,701,2,3896,3,20
2484,122,3,702,9,3905,3,90
2485,122,3,703,6,3911,2,60
2486,122,3,704,2,3913,1,20
2487,122,3,705,8,3921,7,80
2488,122,3,706,9,3930,0,90
2489,122,3,707,5,3935,0,50
2490,122,3,708,8,3943,13,80
2491,122,3,709,6,3949,1,60
2492,122,3,710,5,3954,0,50
2493,122,3,711,8,3962,8,80
2494,122,3,712,4,3966,0,40
2495,122,3,713,4,3970,0,40
2496,122,3,714,3,3973,1,30
2497,122,3,715,8,3981,4,80
2498,122,3,716,4,3985,1,40
2499,122,3,717,4,3989,1,40
2500,122,3,718,8,3997,3,80
2501,122,3,719,2,3999,0,20
2502,122,3,720,5,4004,0,50
2503,122,3,721,5,4009,6,50
2504,122,3,722,5,4014,3,50
2505,122,3,723,7,4021,4,70
2506,122,3,724,9,4030,2,90
2507,122,3,725,2,4032,1,20
2508,122,3,726,2,4034,1,20
2509,122,3,727,3,4037,0,30
2510,122,3,728,4,4041,1,40
2511,122,3,729,8,4049,10,80
2512,122,3,730,2,4051,0,20
2513,122,3,731,6,4057,6,60
2514,122,3,732,3,4060,0,30
2515,122,3,733,2,4062,0,20
2516,122,3,734,6,4068,0,60
2517,122,3,735,3,4071,3,30
2518,122,3,736,5,4076,4,50
2519,122,3,737,2,4078,2,20
2520,122,3,738,3,4081,0,30
2521,122,3,739,6,4087,5,60
2522,122,3,740,2,4089,0,20
2523,122,3,741,8,4097,5,80
2524,122,3,742,5,4102,2,50
2525,122,3,743,4,4106,6,40
2526,122,3,744,3,4109,0,30
2527,122,3,745,3,4112,0,30
2528,122,3,746,2,4114,0,20
2529,122,3,747,5,4119,11,50
2530,122,3,748,3,4122,0,30
2531,122,3,749,6,4128,4,60
2532,122,3,750,8,4136,6,80
2533,122,3,751,5,4141,3,50
2534,122,3,752,3,4144,0,30
2535,122,3,753,5,4149,3,50
2536,122,3,754,9,4158,0,90
2537,122,3,755,8,4166,11,80
2538,122,3,756,8,4174,0,80
2539,122,3,757,5,4179,8,50
2540,122,3,758,9,4188,8,90
2541,122,3,759,2,4190,1,20
2542,122,3,760,7,4197,0,70
2543,122,3,761,5,4202,0,50
2544,122,3,762,8,4210,7,80
2545,122,3,763,6,4216,0,60
2546,122,3,764,3,4219,0,30
2547,122,3,765,6,4225,3,60
2548,122,3,766,5,4230,2,50
2549,122,3,767,6,4236,2,60
2550,122,3,768,3,4239,2,30
2551,122,3,769,7,4246,3,70
2552,122,3,770,3,4249,1,30
2553,122,3,771,2,4251,0,20
2554,122,3,772,2,4253,0,20
2555,122,3,773,7,4260,4,70
2556,122,3,774,2,4262,0,20
2557,122,3,775,9,4271,0,90
2558,122,3,776,4,4275,6,40
2559,122,3,777,7,4282,3,70
2560,122,3,778,3,4285,0,30
2561,122,3,779,7,4292,4,70
2562,122,3,780,5,4297,2,50
2563,122,3,781,7,4304,4,70
2564,122,3,782,5,4309,2,50
2565,122,3,783,6,4315,3,60
2566,122,3,784,4,4319,0,40
2567,122,3,785,2,4321,0,20
2568,122,3,786,6,4327,8,60
2569,122,3,787,4,4331,0,40
2570,122,3,788,6,4337,4,60
2571,122,3,789,8,4345,5,80
2572,122,3,790,3,4348,0,30
2573,122,3,791,9,4357,0,90
2574,122,3,792,7,4364,0,70
2575,122,3,793,5,4369,10,50
2576,122,3,794,5,4374,4,50
2577,122,3,795,4,4378,5,40
2578,122,3,796,3,4381,0,30
2579,122,3,797,3,4384,1,30
2580,122,3,798,9,4393,6,90
2581,122,3,799,4,4397,3,40
2582,122,3,800,7,4404,0,70
2583,122,3,801,9,4413,9,90
2584,122,3,802,8,4421,0,80
2585,122,3,803,4,4425,8,40
2586,122,3,804,8,4433,3,80
2587,122,3,805,9,4442,4,90
2588,122,3,806,6,4448,0,60
2589,122,3,807,9,4457,18,90
2590,122,3,808,2,4459,0,20
2591,122,3,809,9,4468,6,90
2592,122,3,810,5,4473,0,50
2593,122,3,811,2,4475,6,20
2594,122,3,812,6,4481,0,60
2595,122,3,813,7,4488,0,70
2596,122,3,814,2,4490,0,20
2597,122,3,815,3,4493,0,30
2598,122,3,816,4,4497,11,40
2599,122,3,817,6,4503,1,60
2600,122,3,818,4,4507,1,40
2601,122,3,819,2,4509,0,20
2602,122,3,820,2,4511,3,20
2603,122,3,821,8,4519,0,80
2604,122,3,822,6,4525,11,60
2605,122,3,823,2,4527,1,20
2606,122,3,824,7,4534,5,70
2607,122,3,825,2,4536,0,20
2608,122,3,826,2,4538,0,20
2609,122,3,827,8,4546,0,80
2610,122,3,828,9,4555,14,90
2611,122,3,829,6,4561,2,60
2612,122,3,830,5,4566,0,50
2613,122,3,831,5,4571,2,50
2614,122,3,832,8,4579,6,80
2615,122,3,833,5,4584,0,50
2616,122,3,834,4,4588,2,40
2617,122,3,835,8,4596,0,80
2618,122,3,836,3,4599,0,30
2619,122,3,837,5,4604,0,50
2620,122,3,838,9,4613,11,90
2621,122,3,839,8,4621,3,80
2622,122,3,840,5,4626,4,50
2623,122,3,841,6,4632,0,60
2624,122,3,842,4,4636,3,40
2625,122,3,843,8,4644,5,80
2626,122,3,844,3,4647,0,30
2627,122,3,845,3,4650,1,30
2628,122,3,846,2,4652,1,20
2629,122,3,847,7,4659,0,70
2630,122,3,848,3,4662,1,30
2631,122,3,849,6,4668,5,60
2632,122,3,850,4,4672,1,40
2633,122,3,851,7,4679,2,70
2634,122,3,852,6,4685,3,60
2635,122,3,853,6,4691,0,60
2636,122,3,854,9,4700,4,90
2637,122,3,855,4,4704,2,40
2638,122,3,856,6,4710,0,60
2639,122,3,857,5,4715,0,50
2640,122,3,858,4,4719,0,40
2641,122,3,859,9,4728,12,90
2642,122,3,860,3,4731,0,30
2643,122,3,861,4,4735,1,40
2644,122,3,862,9,4744,10,90
2645,122,3,863,8,4752,0,80
2646,122,3,864,6,4758,6,60
2647,122,3,865,4,4762,0,40
2648,122,3,866,3,4765,0,30
2649,122,3,867,2,4767,0,20
2650,122,3,868,4,4771,13,40
2651,122,3,869,6,4777,4,60
2652,122,3,870,4,4781,4,40
2653,122,3,871,4,4785,0,40
2654,122,3,872,8,4793,0,80
2655,122,3,873,8,4801,14,80
2656,122,3,874,7,4808,8,70
2657,122,3,875,6,4814,0,60
2658,122,3,876,5,4819,2,50
2659,122,3,877,4,4823,4,40
2660,122,3,878,8,4831,0,80
2661,122,3,879,4,4835,3,40
2662,122,3,880,7,4842,1,70
2663,122,3,881,9,4851,5,90
2664,122,3,882,7,4858,0,70
2665,122,3,883,6,4864,6,60
2666,122,3,884,9,4873,6,90
2667,122,3,885,6,4879,1,60
2668,122,3,886,7,4886,5,70
2669,122,3,887,6,4892,2,60
2670,122,3,888,5,4897,0,50
2671,122,3,889,9,4906,5,90
2672,122,3,890,4,4910,1,40
2673,122,3,891,3,4913,0,30
2674,122,3,892,2,4915,0,20
2675,122,3,893,9,4924,2,90
2676,122,3,894,2,4926,0,20
2677,122,3,895,9,4935,4,90
2678,122,3,896,8,4943,6,80
2679,122,3,897,3,4946,0,30
2680,122,3,898,5,4951,0,50
2681,122,3,899,8,4959,0,80
2682,122,3,900,9,4968,16,90
2683,122,3,901,2,4970,1,20
2684,122,3,902,4,4974,4,40
2685,122,3,903,9,4983,0,90
2686,122,3,904,9,4992,0,90
2687,122,3,905,7,4999,0,70
