,Scenario,Trial,Inspection,Interval,Time,Defects,Rate
0,239,1,1,3,3,3,30
1,239,1,2,2,5,0,20
2,239,1,3,4,9,0,40
3,239,1,4,5,14,7,50
4,239,1,5,7,21,3,70
5,239,1,6,6,27,0,60
6,239,1,7,5,32,0,50
7,239,1,8,4,36,0,40
8,239,1,9,6,42,0,60
9,239,1,10,8,50,4,80
10,239,1,11,7,57,1,70
11,239,1,12,8,65,0,80
12,239,1,13,3,68,0,30
13,239,1,14,2,70,0,20
14,239,1,15,9,79,0,90
15,239,1,16,2,81,12,20
16,239,1,17,8,89,0,80
17,239,1,18,6,95,1,60
18,239,1,19,3,98,0,30
19,239,1,20,8,106,0,80
20,239,1,21,5,111,0,50
21,239,1,22,5,116,0,50
22,239,1,23,3,119,0,30
23,239,1,24,8,127,0,80
24,239,1,25,8,135,0,80
25,239,1,26,2,137,0,20
26,239,1,27,8,145,0,80
27,239,1,28,9,154,0,90
28,239,1,29,6,160,0,60
29,239,1,30,5,165,0,50
30,239,1,31,4,169,0,40
31,239,1,32,4,173,37,40
32,239,1,33,6,179,3,60
33,239,1,34,8,187,3,80
34,239,1,35,9,196,0,90
35,239,1,36,2,198,10,20
36,239,1,37,5,203,0,50
37,239,1,38,8,211,0,80
38,239,1,39,4,215,0,40
39,239,1,40,9,224,0,90
40,239,1,41,6,230,16,60
41,239,1,42,8,238,0,80
42,239,1,43,6,244,0,60
43,239,1,44,7,251,0,70
44,239,1,45,4,255,12,40
45,239,1,46,6,261,3,60
46,239,1,47,8,269,0,80
47,239,1,48,2,271,0,20
48,239,1,49,3,274,0,30
49,239,1,50,5,279,0,50
50,239,1,51,6,285,13,60
51,239,1,52,3,288,0,30
52,239,1,53,6,294,0,60
53,239,1,54,3,297,0,30
54,239,1,55,2,299,0,20
55,239,1,56,4,303,9,40
56,239,1,57,5,308,1,50
57,239,1,58,2,310,5,20
58,239,1,59,2,312,0,20
59,239,1,60,2,314,0,20
60,239,1,61,8,322,0,80
61,239,1,62,8,330,8,80
62,239,1,63,7,337,0,70
63,239,1,64,5,342,0,50
64,239,1,65,5,347,0,50
65,239,1,66,9,356,0,90
66,239,1,67,8,364,14,80
67,239,1,68,3,367,0,30
68,239,1,69,4,371,0,40
69,239,1,70,8,379,7,80
70,239,1,71,5,384,0,50
71,239,1,72,4,388,0,40
72,239,1,73,8,396,8,80
73,239,1,74,7,403,0,70
74,239,1,75,8,411,8,80
75,239,1,76,4,415,0,40
76,239,1,77,7,422,0,70
77,239,1,78,2,424,0,20
78,239,1,79,6,430,8,60
79,239,1,80,6,436,0,60
80,239,1,81,8,444,4,80
81,239,1,82,9,453,10,90
82,239,1,83,5,458,2,50
83,239,1,84,5,463,0,50
84,239,1,85,2,465,0,20
85,239,1,86,3,468,0,30
86,239,1,87,6,474,0,60
87,239,1,88,8,482,0,80
88,239,1,89,7,489,0,70
89,239,1,90,5,494,17,50
90,239,1,91,9,503,0,90
91,239,1,92,3,506,5,30
92,239,1,93,7,513,3,70
93,239,1,94,3,516,0,30
94,239,1,95,7,523,4,70
95,239,1,96,8,531,0,80
96,239,1,97,7,538,0,70
97,239,1,98,4,542,12,40
98,239,1,99,6,548,0,60
99,239,1,100,7,555,0,70
100,239,1,101,6,561,13,60
101,239,1,102,7,568,0,70
102,239,1,103,9,577,0,90
103,239,1,104,3,580,0,30
104,239,1,105,6,586,11,60
105,239,1,106,7,593,0,70
106,239,1,107,4,597,0,40
107,239,1,108,4,601,0,40
108,239,1,109,9,610,0,90
109,239,1,110,8,618,0,80
110,239,1,111,2,620,17,20
111,239,1,112,3,623,0,30
112,239,1,113,8,631,0,80
113,239,1,114,7,638,0,70
114,239,1,115,5,643,0,50
115,239,1,116,7,650,14,70
116,239,1,117,4,654,0,40
117,239,1,118,8,662,0,80
118,239,1,119,3,665,0,30
119,239,1,120,7,672,0,70
120,239,1,121,3,675,0,30
121,239,1,122,7,682,0,70
122,239,1,123,6,688,0,60
123,239,1,124,6,694,0,60
124,239,1,125,9,703,0,90
125,239,1,126,6,709,0,60
126,239,1,127,9,718,38,90
127,239,1,128,5,723,2,50
128,239,1,129,2,725,1,20
129,239,1,130,8,733,3,80
130,239,1,131,4,737,3,40
131,239,1,132,7,744,0,70
132,239,1,133,5,749,0,50
133,239,1,134,3,752,0,30
134,239,1,135,6,758,8,60
135,239,1,136,8,766,0,80
136,239,1,137,6,772,0,60
137,239,1,138,9,781,8,90
138,239,1,139,3,784,0,30
139,239,1,140,5,789,0,50
140,239,1,141,2,791,0,20
141,239,1,142,9,800,0,90
142,239,1,143,4,804,0,40
143,239,1,144,2,806,12,20
144,239,1,145,5,811,0,50
145,239,1,146,2,813,0,20
146,239,1,147,2,815,0,20
147,239,1,148,4,819,0,40
148,239,1,149,4,823,5,40
149,239,1,150,2,825,1,20
150,239,1,151,8,833,0,80
151,239,1,152,9,842,11,90
152,239,1,153,3,845,2,30
153,239,1,154,7,852,0,70
154,239,1,155,2,854,0,20
155,239,1,156,6,860,9,60
156,239,1,157,3,863,0,30
157,239,1,158,7,870,0,70
158,239,1,159,5,875,11,50
159,239,1,160,9,884,2,90
160,239,1,161,8,892,0,80
161,239,1,162,4,896,0,40
162,239,1,163,2,898,0,20
163,239,1,164,7,905,0,70
164,239,1,165,2,907,0,20
165,239,1,166,4,911,14,40
166,239,1,167,7,918,0,70
167,239,1,168,9,927,8,90
168,239,1,169,6,933,0,60
169,239,1,170,6,939,7,60
170,239,1,171,6,945,0,60
171,239,1,172,4,949,0,40
172,239,1,173,3,952,0,30
173,239,1,174,2,954,0,20
174,239,1,175,3,957,5,30
175,239,1,176,3,960,1,30
176,239,1,177,4,964,0,40
177,239,1,178,5,969,0,50
178,239,1,179,9,978,0,90
179,239,1,180,5,983,0,50
180,239,1,181,7,990,0,70
181,239,1,182,7,997,20,70
182,239,1,183,6,1003,0,60
183,239,1,184,9,1012,0,90
184,239,1,185,8,1020,0,80
185,239,1,186,3,1023,15,30
186,239,1,187,4,1027,0,40
187,239,1,188,3,1030,3,30
188,239,1,189,8,1038,0,80
189,239,1,190,3,1041,0,30
190,239,1,191,5,1046,0,50
191,239,1,192,8,1054,0,80
192,239,1,193,9,1063,14,90
193,239,1,194,2,1065,2,20
194,239,1,195,5,1070,2,50
195,239,1,196,4,1074,0,40
196,239,1,197,6,1080,0,60
197,239,1,198,2,1082,0,20
198,239,1,199,4,1086,13,40
199,239,1,200,7,1093,2,70
200,239,1,201,2,1095,2,20
201,239,1,202,8,1103,0,80
202,239,1,203,9,1112,0,90
203,239,1,204,3,1115,0,30
204,239,1,205,4,1119,0,40
205,239,1,206,6,1125,0,60
206,239,1,207,5,1130,0,50
207,239,1,208,6,1136,0,60
208,239,1,209,6,1142,0,60
209,239,1,210,2,1144,0,20
210,239,1,211,5,1149,0,50
211,239,1,212,2,1151,0,20
212,239,1,213,7,1158,0,70
213,239,1,214,4,1162,27,40
214,239,1,215,2,1164,0,20
215,239,1,216,3,1167,0,30
216,239,1,217,6,1173,0,60
217,239,1,218,5,1178,6,50
218,239,1,219,4,1182,0,40
219,239,1,220,2,1184,2,20
220,239,1,221,2,1186,1,20
221,239,1,222,5,1191,0,50
222,239,1,223,5,1196,4,50
223,239,1,224,3,1199,2,30
224,239,1,225,9,1208,8,90
225,239,1,226,9,1217,0,90
226,239,1,227,6,1223,0,60
227,239,1,228,5,1228,0,50
228,239,1,229,5,1233,15,50
229,239,1,230,5,1238,0,50
230,239,1,231,3,1241,0,30
231,239,1,232,3,1244,0,30
232,239,1,233,5,1249,0,50
233,239,1,234,6,1255,0,60
234,239,1,235,6,1261,0,60
235,239,1,236,6,1267,16,60
236,239,1,237,5,1272,0,50
237,239,1,238,2,1274,0,20
238,239,1,239,3,1277,0,30
239,239,1,240,3,1280,0,30
240,239,1,241,5,1285,0,50
241,239,1,242,6,1291,10,60
242,239,1,243,3,1294,0,30
243,239,1,244,2,1296,5,20
244,239,1,245,3,1299,5,30
245,239,1,246,6,1305,1,60
246,239,1,247,9,1314,0,90
247,239,1,248,3,1317,3,30
248,239,1,249,9,1326,0,90
249,239,1,250,3,1329,11,30
250,239,1,251,5,1334,2,50
251,239,1,252,4,1338,0,40
252,239,1,253,9,1347,5,90
253,239,1,254,5,1352,0,50
254,239,1,255,7,1359,0,70
255,239,1,256,9,1368,12,90
256,239,1,257,2,1370,0,20
257,239,1,258,6,1376,0,60
258,239,1,259,6,1382,7,60
259,239,1,260,7,1389,2,70
260,239,1,261,4,1393,0,40
261,239,1,262,7,1400,0,70
262,239,1,263,6,1406,0,60
263,239,1,264,3,1409,0,30
264,239,1,265,4,1413,0,40
265,239,1,266,5,1418,0,50
266,239,1,267,7,1425,0,70
267,239,1,268,4,1429,20,40
268,239,1,269,8,1437,0,80
269,239,1,270,9,1446,16,90
270,239,1,271,7,1453,0,70
271,239,1,272,9,1462,5,90
272,239,1,273,7,1469,0,70
273,239,1,274,6,1475,5,60
274,239,1,275,4,1479,0,40
275,239,1,276,6,1485,0,60
276,239,1,277,9,1494,9,90
277,239,1,278,9,1503,0,90
278,239,1,279,7,1510,0,70
279,239,1,280,6,1516,0,60
280,239,1,281,7,1523,0,70
281,239,1,282,8,1531,0,80
282,239,1,283,3,1534,0,30
283,239,1,284,4,1538,25,40
284,239,1,285,9,1547,0,90
285,239,1,286,9,1556,0,90
286,239,1,287,7,1563,13,70
287,239,1,288,7,1570,0,70
288,239,1,289,2,1572,0,20
289,239,1,290,7,1579,0,70
290,239,1,291,3,1582,0,30
291,239,1,292,6,1588,17,60
292,239,1,293,8,1596,3,80
293,239,1,294,6,1602,0,60
294,239,1,295,8,1610,5,80
295,239,1,296,6,1616,0,60
296,239,1,297,3,1619,6,30
297,239,1,298,7,1626,0,70
298,239,1,299,4,1630,0,40
299,239,1,300,7,1637,0,70
300,239,1,301,5,1642,0,50
301,239,1,302,2,1644,0,20
302,239,1,303,4,1648,16,40
303,239,1,304,2,1650,0,20
304,239,1,305,4,1654,2,40
305,239,1,306,9,1663,0,90
306,239,1,307,6,1669,6,60
307,239,1,308,3,1672,0,30
308,239,1,309,7,1679,0,70
309,239,1,310,3,1682,0,30
310,239,1,311,9,1691,8,90
311,239,1,312,9,1700,0,90
312,239,1,313,3,1703,0,30
313,239,1,314,4,1707,13,40
314,239,1,315,3,1710,0,30
315,239,1,316,2,1712,0,20
316,239,1,317,4,1716,0,40
317,239,1,318,2,1718,0,20
318,239,1,319,9,1727,0,90
319,239,1,320,7,1734,0,70
320,239,1,321,8,1742,17,80
321,239,1,322,7,1749,0,70
322,239,1,323,3,1752,0,30
323,239,1,324,2,1754,0,20
324,239,1,325,9,1763,13,90
325,239,1,326,2,1765,2,20
326,239,1,327,8,1773,0,80
327,239,1,328,4,1777,9,40
328,239,1,329,8,1785,4,80
329,239,1,330,7,1792,0,70
330,239,1,331,8,1800,5,80
331,239,1,332,2,1802,0,20
332,239,1,333,6,1808,0,60
333,239,1,334,9,1817,0,90
334,239,1,335,2,1819,0,20
335,239,1,336,9,1828,0,90
336,239,1,337,6,1834,16,60
337,239,1,338,5,1839,3,50
338,239,1,339,2,1841,0,20
339,239,1,340,9,1850,6,90
340,239,1,341,5,1855,2,50
341,239,1,342,2,1857,0,20
342,239,1,343,2,1859,0,20
343,239,1,344,9,1868,0,90
344,239,1,345,6,1874,11,60
345,239,1,346,6,1880,0,60
346,239,1,347,5,1885,0,50
347,239,1,348,9,1894,0,90
348,239,1,349,9,1903,0,90
349,239,1,350,9,1912,15,90
350,239,1,351,5,1917,0,50
351,239,1,352,6,1923,0,60
352,239,1,353,5,1928,0,50
353,239,1,354,5,1933,0,50
354,239,1,355,7,1940,0,70
355,239,1,356,8,1948,0,80
356,239,1,357,9,1957,20,90
357,239,1,358,3,1960,0,30
358,239,1,359,4,1964,0,40
359,239,1,360,4,1968,3,40
360,239,1,361,4,1972,0,40
361,239,1,362,8,1980,0,80
362,239,1,363,6,1986,0,60
363,239,1,364,4,1990,7,40
364,239,1,365,9,1999,8,90
365,239,1,366,8,2007,0,80
366,239,1,367,4,2011,0,40
367,239,1,368,9,2020,16,90
368,239,1,369,5,2025,0,50
369,239,1,370,3,2028,2,30
370,239,1,371,3,2031,0,30
371,239,1,372,6,2037,0,60
372,239,1,373,3,2040,9,30
373,239,1,374,9,2049,3,90
374,239,1,375,8,2057,0,80
375,239,1,376,8,2065,6,80
376,239,1,377,4,2069,0,40
377,239,1,378,8,2077,0,80
378,239,1,379,2,2079,0,20
379,239,1,380,9,2088,0,90
380,239,1,381,7,2095,12,70
381,239,1,382,4,2099,2,40
382,239,1,383,7,2106,0,70
383,239,1,384,9,2115,0,90
384,239,1,385,8,2123,0,80
385,239,1,386,5,2128,12,50
386,239,1,387,4,2132,4,40
387,239,1,388,7,2139,0,70
388,239,1,389,2,2141,0,20
389,239,1,390,4,2145,4,40
390,239,1,391,2,2147,0,20
391,239,1,392,6,2153,1,60
392,239,1,393,9,2162,0,90
393,239,1,394,3,2165,4,30
394,239,1,395,9,2174,0,90
395,239,1,396,9,2183,8,90
396,239,1,397,8,2191,0,80
397,239,1,398,2,2193,0,20
398,239,1,399,3,2196,0,30
399,239,1,400,2,2198,6,20
400,239,1,401,6,2204,0,60
401,239,1,402,5,2209,0,50
402,239,1,403,4,2213,0,40
403,239,1,404,4,2217,0,40
404,239,1,405,9,2226,15,90
405,239,1,406,9,2235,7,90
406,239,1,407,7,2242,0,70
407,239,1,408,2,2244,0,20
408,239,1,409,8,2252,11,80
409,239,1,410,9,2261,0,90
410,239,1,411,2,2263,3,20
411,239,1,412,6,2269,0,60
412,239,1,413,9,2278,10,90
413,239,1,414,4,2282,0,40
414,239,1,415,4,2286,4,40
415,239,1,416,2,2288,2,20
416,239,1,417,8,2296,0,80
417,239,1,418,3,2299,8,30
418,239,1,419,3,2302,1,30
419,239,1,420,4,2306,0,40
420,239,1,421,8,2314,0,80
421,239,1,422,8,2322,0,80
422,239,1,423,6,2328,14,60
423,239,1,424,2,2330,1,20
424,239,1,425,6,2336,0,60
425,239,1,426,6,2342,0,60
426,239,1,427,9,2351,5,90
427,239,1,428,4,2355,0,40
428,239,1,429,9,2364,0,90
429,239,1,430,9,2373,9,90
430,239,1,431,9,2382,0,90
431,239,1,432,9,2391,0,90
432,239,1,433,6,2397,8,60
433,239,1,434,5,2402,0,50
434,239,1,435,2,2404,0,20
435,239,1,436,9,2413,0,90
436,239,1,437,4,2417,0,40
437,239,1,438,7,2424,0,70
438,239,1,439,5,2429,0,50
439,239,1,440,9,2438,0,90
440,239,1,441,5,2443,24,50
441,239,1,442,4,2447,0,40
442,239,1,443,5,2452,0,50
443,239,1,444,4,2456,5,40
444,239,1,445,6,2462,0,60
445,239,1,446,9,2471,10,90
446,239,1,447,9,2480,6,90
447,239,1,448,7,2487,0,70
448,239,1,449,8,2495,0,80
449,239,1,450,8,2503,0,80
450,239,1,451,4,2507,15,40
451,239,1,452,5,2512,0,50
452,239,1,453,6,2518,0,60
453,239,1,454,2,2520,8,20
454,239,1,455,7,2527,4,70
455,239,1,456,2,2529,0,20
456,239,1,457,7,2536,2,70
457,239,1,458,8,2544,6,80
458,239,1,459,7,2551,0,70
459,239,1,460,8,2559,0,80
460,239,1,461,9,2568,0,90
461,239,1,462,5,2573,0,50
462,239,1,463,6,2579,0,60
463,239,1,464,4,2583,0,40
464,239,1,465,2,2585,0,20
465,239,1,466,8,2593,30,80
466,239,1,467,2,2595,0,20
467,239,1,468,9,2604,6,90
468,239,1,469,3,2607,1,30
469,239,1,470,6,2613,4,60
470,239,1,471,5,2618,0,50
471,239,1,472,6,2624,0,60
472,239,1,473,9,2633,0,90
473,239,1,474,6,2639,0,60
474,239,1,475,9,2648,0,90
475,239,1,476,8,2656,0,80
476,239,1,477,2,2658,0,20
477,239,1,478,6,2664,0,60
478,239,1,479,4,2668,42,40
479,239,1,480,8,2676,0,80
480,239,1,481,5,2681,0,50
481,239,1,482,4,2685,6,40
482,239,1,483,9,2694,0,90
483,239,1,484,6,2700,5,60
484,239,1,485,9,2709,1,90
485,239,1,486,2,2711,0,20
486,239,1,487,8,2719,0,80
487,239,1,488,5,2724,9,50
488,239,1,489,3,2727,0,30
489,239,1,490,3,2730,0,30
490,239,1,491,5,2735,4,50
491,239,1,492,8,2743,0,80
492,239,1,493,7,2750,8,70
493,239,1,494,9,2759,0,90
494,239,1,495,2,2761,0,20
495,239,1,496,7,2768,0,70
496,239,1,497,7,2775,0,70
497,239,1,498,5,2780,0,50
498,239,1,499,2,2782,17,20
499,239,1,500,3,2785,0,30
500,239,1,501,8,2793,0,80
501,239,1,502,2,2795,0,20
502,239,1,503,8,2803,0,80
503,239,1,504,8,2811,11,80
504,239,1,505,7,2818,5,70
505,239,1,506,3,2821,0,30
506,239,1,507,4,2825,0,40
507,239,1,508,7,2832,0,70
508,239,1,509,5,2837,0,50
509,239,1,510,4,2841,7,40
510,239,1,511,7,2848,0,70
511,239,1,512,3,2851,3,30
512,239,1,513,4,2855,0,40
513,239,1,514,5,2860,0,50
514,239,1,515,6,2866,0,60
515,239,1,516,5,2871,0,50
516,239,1,517,2,2873,0,20
517,239,1,518,9,2882,0,90
518,239,1,519,3,2885,0,30
519,239,1,520,8,2893,0,80
520,239,1,521,3,2896,25,30
521,239,1,522,6,2902,0,60
522,239,1,523,8,2910,11,80
523,239,1,524,5,2915,0,50
524,239,1,525,8,2923,0,80
525,239,1,526,7,2930,0,70
526,239,1,527,2,2932,0,20
527,239,1,528,9,2941,0,90
528,239,1,529,4,2945,20,40
529,239,1,530,6,2951,0,60
530,239,1,531,7,2958,0,70
531,239,1,532,9,2967,0,90
532,239,1,533,4,2971,0,40
533,239,1,534,2,2973,16,20
534,239,1,535,8,2981,0,80
535,239,1,536,9,2990,9,90
536,239,1,537,2,2992,0,20
537,239,1,538,9,3001,0,90
538,239,1,539,7,3008,0,70
539,239,1,540,5,3013,0,50
540,239,1,541,2,3015,16,20
541,239,1,542,7,3022,2,70
542,239,1,543,8,3030,0,80
543,239,1,544,2,3032,8,20
544,239,1,545,2,3034,0,20
545,239,1,546,4,3038,0,40
546,239,1,547,6,3044,4,60
547,239,1,548,7,3051,0,70
548,239,1,549,5,3056,0,50
549,239,1,550,9,3065,10,90
550,239,1,551,4,3069,0,40
551,239,1,552,6,3075,0,60
552,239,1,553,8,3083,7,80
553,239,1,554,2,3085,0,20
554,239,1,555,9,3094,4,90
555,239,1,556,2,3096,0,20
556,239,1,557,7,3103,3,70
557,239,1,558,6,3109,0,60
558,239,1,559,2,3111,0,20
559,239,1,560,2,3113,0,20
560,239,1,561,4,3117,0,40
561,239,1,562,2,3119,6,20
562,239,1,563,6,3125,2,60
563,239,1,564,4,3129,0,40
564,239,1,565,5,3134,4,50
565,239,1,566,2,3136,0,20
566,239,1,567,3,3139,0,30
567,239,1,568,2,3141,0,20
568,239,1,569,3,3144,2,30
569,239,1,570,4,3148,1,40
570,239,1,571,6,3154,0,60
571,239,1,572,2,3156,0,20
572,239,1,573,2,3158,0,20
573,239,1,574,8,3166,0,80
574,239,1,575,5,3171,11,50
575,239,1,576,5,3176,1,50
576,239,1,577,8,3184,1,80
577,239,1,578,5,3189,4,50
578,239,1,579,2,3191,0,20
579,239,1,580,4,3195,2,40
580,239,1,581,7,3202,0,70
581,239,1,582,9,3211,0,90
582,239,1,583,3,3214,0,30
583,239,1,584,7,3221,5,70
584,239,1,585,2,3223,3,20
585,239,1,586,5,3228,0,50
586,239,1,587,3,3231,0,30
587,239,1,588,4,3235,0,40
588,239,1,589,8,3243,0,80
589,239,1,590,9,3252,0,90
590,239,1,591,4,3256,0,40
591,239,1,592,3,3259,0,30
592,239,1,593,7,3266,15,70
593,239,1,594,4,3270,0,40
594,239,1,595,2,3272,0,20
595,239,1,596,4,3276,0,40
596,239,1,597,9,3285,0,90
597,239,1,598,6,3291,0,60
598,239,1,599,7,3298,0,70
599,239,1,600,6,3304,0,60
600,239,1,601,3,3307,0,30
601,239,1,602,6,3313,0,60
602,239,1,603,7,3320,26,70
603,239,1,604,8,3328,0,80
604,239,1,605,3,3331,3,30
605,239,1,606,9,3340,0,90
606,239,1,607,6,3346,0,60
607,239,1,608,8,3354,11,80
608,239,1,609,6,3360,0,60
609,239,1,610,5,3365,0,50
610,239,1,611,6,3371,0,60
611,239,1,612,2,3373,0,20
612,239,1,613,8,3381,0,80
613,239,1,614,7,3388,0,70
614,239,1,615,9,3397,0,90
615,239,1,616,4,3401,16,40
616,239,1,617,9,3410,0,90
617,239,1,618,5,3415,0,50
618,239,1,619,4,3419,0,40
619,239,1,620,4,3423,0,40
620,239,1,621,3,3426,0,30
621,239,1,622,6,3432,13,60
622,239,1,623,8,3440,0,80
623,239,1,624,5,3445,0,50
624,239,1,625,7,3452,11,70
625,239,1,626,6,3458,9,60
626,239,1,627,6,3464,0,60
627,239,1,628,3,3467,0,30
628,239,1,629,8,3475,0,80
629,239,1,630,6,3481,9,60
630,239,1,631,7,3488,0,70
631,239,1,632,4,3492,0,40
632,239,1,633,8,3500,0,80
633,239,1,634,5,3505,0,50
634,239,1,635,4,3509,15,40
635,239,1,636,3,3512,3,30
636,239,1,637,4,3516,0,40
637,239,1,638,5,3521,6,50
638,239,1,639,7,3528,0,70
639,239,1,640,3,3531,5,30
640,239,1,641,4,3535,0,40
641,239,1,642,5,3540,3,50
642,239,1,643,5,3545,0,50
643,239,1,644,8,3553,1,80
644,239,1,645,6,3559,0,60
645,239,1,646,9,3568,6,90
646,239,1,647,8,3576,0,80
647,239,1,648,8,3584,5,80
648,239,1,649,4,3588,3,40
649,239,1,650,2,3590,0,20
650,239,1,651,8,3598,0,80
651,239,1,652,6,3604,0,60
652,239,1,653,6,3610,0,60
653,239,1,654,8,3618,0,80
654,239,1,655,7,3625,24,70
655,239,1,656,5,3630,0,50
656,239,1,657,2,3632,0,20
657,239,1,658,8,3640,0,80
658,239,1,659,4,3644,0,40
659,239,1,660,3,3647,5,30
660,239,1,661,4,3651,3,40
661,239,1,662,9,3660,5,90
662,239,1,663,6,3666,0,60
663,239,1,664,6,3672,4,60
664,239,1,665,5,3677,0,50
665,239,1,666,3,3680,0,30
666,239,1,667,3,3683,0,30
667,239,1,668,3,3686,0,30
668,239,1,669,8,3694,16,80
669,239,1,670,2,3696,0,20
670,239,1,671,5,3701,0,50
671,239,1,672,4,3705,0,40
672,239,1,673,9,3714,0,90
673,239,1,674,7,3721,14,70
674,239,1,675,2,3723,0,20
675,239,1,676,5,3728,2,50
676,239,1,677,8,3736,0,80
677,239,1,678,5,3741,0,50
678,239,1,679,3,3744,0,30
679,239,1,680,4,3748,11,40
680,239,1,681,3,3751,2,30
681,239,1,682,3,3754,0,30
682,239,1,683,4,3758,0,40
683,239,1,684,5,3763,0,50
684,239,1,685,9,3772,0,90
685,239,1,686,4,3776,0,40
686,239,1,687,2,3778,17,20
687,239,1,688,3,3781,2,30
688,239,1,689,8,3789,6,80
689,239,1,690,3,3792,3,30
690,239,1,691,3,3795,0,30
691,239,1,692,3,3798,3,30
692,239,1,693,4,3802,1,40
693,239,1,694,8,3810,0,80
694,239,1,695,6,3816,0,60
695,239,1,696,3,3819,0,30
696,239,1,697,8,3827,10,80
697,239,1,698,4,3831,0,40
698,239,1,699,5,3836,0,50
699,239,1,700,7,3843,0,70
700,239,1,701,4,3847,0,40
701,239,1,702,2,3849,0,20
702,239,1,703,8,3857,9,80
703,239,1,704,5,3862,4,50
704,239,1,705,2,3864,0,20
705,239,1,706,5,3869,11,50
706,239,1,707,4,3873,0,40
707,239,1,708,7,3880,0,70
708,239,1,709,7,3887,0,70
709,239,1,710,3,3890,9,30
710,239,1,711,8,3898,0,80
711,239,1,712,7,3905,0,70
712,239,1,713,3,3908,0,30
713,239,1,714,5,3913,0,50
714,239,1,715,2,3915,0,20
715,239,1,716,5,3920,12,50
716,239,1,717,3,3923,2,30
717,239,1,718,8,3931,0,80
718,239,1,719,7,3938,0,70
719,239,1,720,6,3944,0,60
720,239,1,721,3,3947,12,30
721,239,1,722,8,3955,0,80
722,239,1,723,6,3961,0,60
723,239,1,724,4,3965,0,40
724,239,1,725,6,3971,14,60
725,239,1,726,9,3980,0,90
726,239,1,727,8,3988,0,80
727,239,1,728,5,3993,0,50
728,239,1,729,9,4002,0,90
729,239,1,730,4,4006,10,40
730,239,1,731,9,4015,7,90
731,239,1,732,5,4020,4,50
732,239,1,733,9,4029,0,90
733,239,1,734,5,4034,0,50
734,239,1,735,5,4039,6,50
735,239,1,736,3,4042,4,30
736,239,1,737,8,4050,0,80
737,239,1,738,5,4055,0,50
738,239,1,739,8,4063,5,80
739,239,1,740,4,4067,0,40
740,239,1,741,9,4076,0,90
741,239,1,742,2,4078,0,20
742,239,1,743,3,4081,0,30
743,239,1,744,4,4085,0,40
744,239,1,745,6,4091,0,60
745,239,1,746,4,4095,0,40
746,239,1,747,8,4103,23,80
747,239,1,748,7,4110,0,70
748,239,1,749,9,4119,9,90
749,239,1,750,4,4123,0,40
750,239,1,751,7,4130,0,70
751,239,1,752,4,4134,6,40
752,239,1,753,7,4141,3,70
753,239,1,754,4,4145,0,40
754,239,1,755,2,4147,0,20
755,239,1,756,7,4154,0,70
756,239,1,757,4,4158,0,40
757,239,1,758,9,4167,11,90
758,239,1,759,7,4174,6,70
759,239,1,760,5,4179,3,50
760,239,1,761,2,4181,1,20
761,239,1,762,8,4189,0,80
762,239,1,763,7,4196,8,70
763,239,1,764,4,4200,1,40
764,239,1,765,5,4205,3,50
765,239,1,766,5,4210,5,50
766,239,1,767,6,4216,0,60
767,239,1,768,5,4221,0,50
768,239,1,769,9,4230,10,90
769,239,1,770,5,4235,0,50
770,239,1,771,7,4242,7,70
771,239,1,772,3,4245,2,30
772,239,1,773,2,4247,0,20
773,239,1,774,4,4251,0,40
774,239,1,775,8,4259,0,80
775,239,1,776,3,4262,0,30
776,239,1,777,8,4270,0,80
777,239,1,778,8,4278,15,80
778,239,1,779,3,4281,0,30
779,239,1,780,7,4288,8,70
780,239,1,781,5,4293,0,50
781,239,1,782,2,4295,0,20
782,239,1,783,3,4298,0,30
783,239,1,784,3,4301,0,30
784,239,1,785,5,4306,10,50
785,239,1,786,6,4312,0,60
786,239,1,787,7,4319,0,70
787,239,1,788,6,4325,0,60
788,239,1,789,5,4330,0,50
789,239,1,790,8,4338,0,80
790,239,1,791,5,4343,0,50
791,239,1,792,7,4350,0,70
792,239,1,793,3,4353,0,30
793,239,1,794,6,4359,0,60
794,239,1,795,5,4364,0,50
795,239,1,796,5,4369,41,50
796,239,1,797,3,4372,0,30
797,239,1,798,4,4376,0,40
798,239,1,799,6,4382,0,60
799,239,1,800,6,4388,0,60
800,239,1,801,6,4394,17,60
801,239,1,802,9,4403,0,90
802,239,1,803,8,4411,0,80
803,239,1,804,6,4417,16,60
804,239,1,805,4,4421,0,40
805,239,1,806,7,4428,5,70
806,239,1,807,3,4431,0,30
807,239,1,808,2,4433,3,20
808,239,1,809,7,4440,0,70
809,239,1,810,3,4443,0,30
810,239,1,811,8,4451,15,80
811,239,1,812,3,4454,0,30
812,239,1,813,7,4461,6,70
813,239,1,814,5,4466,0,50
814,239,1,815,5,4471,0,50
815,239,1,816,2,4473,3,20
816,239,1,817,6,4479,0,60
817,239,1,818,2,4481,0,20
818,239,1,819,8,4489,0,80
819,239,1,820,9,4498,0,90
820,239,1,821,8,4506,13,80
821,239,1,822,2,4508,0,20
822,239,1,823,5,4513,5,50
823,239,1,824,5,4518,0,50
824,239,1,825,2,4520,0,20
825,239,1,826,2,4522,0,20
826,239,1,827,9,4531,6,90
827,239,1,828,9,4540,4,90
828,239,1,829,7,4547,0,70
829,239,1,830,2,4549,0,20
830,239,1,831,8,4557,0,80
831,239,1,832,4,4561,0,40
832,239,1,833,5,4566,7,50
833,239,1,834,4,4570,1,40
834,239,1,835,6,4576,2,60
835,239,1,836,2,4578,0,20
836,239,1,837,5,4583,1,50
837,239,1,838,3,4586,0,30
838,239,1,839,3,4589,0,30
839,239,1,840,5,4594,4,50
840,239,1,841,7,4601,0,70
841,239,1,842,5,4606,0,50
842,239,1,843,4,4610,6,40
843,239,1,844,9,4619,4,90
844,239,1,845,8,4627,0,80
845,239,1,846,7,4634,8,70
846,239,1,847,8,4642,0,80
847,239,1,848,7,4649,6,70
848,239,1,849,2,4651,0,20
849,239,1,850,2,4653,0,20
850,239,1,851,6,4659,0,60
851,239,1,852,2,4661,0,20
852,239,1,853,3,4664,3,30
853,239,1,854,4,4668,0,40
854,239,1,855,7,4675,0,70
855,239,1,856,2,4677,0,20
856,239,1,857,6,4683,0,60
857,239,1,858,3,4686,0,30
858,239,1,859,8,4694,0,80
859,239,1,860,8,4702,29,80
860,239,1,861,6,4708,3,60
861,239,1,862,9,4717,0,90
862,239,1,863,7,4724,6,70
863,239,1,864,4,4728,0,40
864,239,1,865,5,4733,0,50
865,239,1,866,6,4739,14,60
866,239,1,867,9,4748,0,90
867,239,1,868,9,4757,5,90
868,239,1,869,5,4762,0,50
869,239,1,870,3,4765,4,30
870,239,1,871,3,4768,0,30
871,239,1,872,3,4771,3,30
872,239,1,873,8,4779,0,80
873,239,1,874,3,4782,5,30
874,239,1,875,6,4788,0,60
875,239,1,876,8,4796,0,80
876,239,1,877,4,4800,14,40
877,239,1,878,7,4807,0,70
878,239,1,879,5,4812,0,50
879,239,1,880,2,4814,0,20
880,239,1,881,5,4819,0,50
881,239,1,882,3,4822,0,30
882,239,1,883,6,4828,0,60
883,239,1,884,2,4830,0,20
884,239,1,885,3,4833,18,30
885,239,1,886,3,4836,0,30
886,239,1,887,5,4841,2,50
887,239,1,888,8,4849,5,80
888,239,1,889,7,4856,0,70
889,239,1,890,2,4858,0,20
890,239,1,891,8,4866,0,80
891,239,1,892,3,4869,13,30
892,239,1,893,5,4874,0,50
893,239,1,894,2,4876,0,20
894,239,1,895,8,4884,0,80
895,239,1,896,3,4887,0,30
896,239,1,897,5,4892,10,50
897,239,1,898,5,4897,0,50
898,239,1,899,9,4906,0,90
899,239,1,900,4,4910,10,40
900,239,1,901,9,4919,0,90
901,239,1,902,6,4925,0,60
902,239,1,903,4,4929,0,40
903,239,1,904,4,4933,0,40
904,239,1,905,2,4935,0,20
905,239,1,906,8,4943,0,80
906,239,1,907,7,4950,0,70
907,239,1,908,3,4953,0,30
908,239,1,909,8,4961,0,80
909,239,1,910,2,4963,32,20
910,239,1,911,6,4969,0,60
911,239,1,912,4,4973,0,40
912,239,1,913,6,4979,0,60
913,239,1,914,4,4983,10,40
914,239,1,915,8,4991,0,80
915,239,1,916,4,4995,9,40
916,239,1,917,3,4998,0,30
917,239,2,1,8,8,0,80
918,239,2,2,2,10,0,20
919,239,2,3,4,14,0,40
920,239,2,4,8,22,0,80
921,239,2,5,9,31,11,90
922,239,2,6,4,35,2,40
923,239,2,7,3,38,0,30
924,239,2,8,4,42,0,40
925,239,2,9,3,45,0,30
926,239,2,10,3,48,0,30
927,239,2,11,8,56,15,80
928,239,2,12,6,62,0,60
929,239,2,13,4,66,0,40
930,239,2,14,2,68,0,20
931,239,2,15,9,77,0,90
932,239,2,16,3,80,0,30
933,239,2,17,9,89,0,90
934,239,2,18,9,98,0,90
935,239,2,19,3,101,20,30
936,239,2,20,3,104,0,30
937,239,2,21,7,111,0,70
938,239,2,22,6,117,0,60
939,239,2,23,3,120,0,30
940,239,2,24,4,124,0,40
941,239,2,25,5,129,0,50
942,239,2,26,8,137,0,80
943,239,2,27,6,143,0,60
944,239,2,28,7,150,0,70
945,239,2,29,6,156,0,60
946,239,2,30,8,164,34,80
947,239,2,31,4,168,0,40
948,239,2,32,6,174,0,60
949,239,2,33,7,181,5,70
950,239,2,34,5,186,0,50
951,239,2,35,3,189,0,30
952,239,2,36,3,192,8,30
953,239,2,37,3,195,0,30
954,239,2,38,4,199,0,40
955,239,2,39,5,204,2,50
956,239,2,40,6,210,4,60
957,239,2,41,6,216,0,60
958,239,2,42,3,219,0,30
959,239,2,43,3,222,0,30
960,239,2,44,5,227,10,50
961,239,2,45,6,233,0,60
962,239,2,46,3,236,0,30
963,239,2,47,3,239,0,30
964,239,2,48,4,243,0,40
965,239,2,49,6,249,0,60
966,239,2,50,9,258,0,90
967,239,2,51,8,266,28,80
968,239,2,52,6,272,0,60
969,239,2,53,9,281,6,90
970,239,2,54,2,283,0,20
971,239,2,55,8,291,5,80
972,239,2,56,7,298,1,70
973,239,2,57,9,307,0,90
974,239,2,58,6,313,9,60
975,239,2,59,4,317,1,40
976,239,2,60,3,320,1,30
977,239,2,61,5,325,3,50
978,239,2,62,8,333,0,80
979,239,2,63,3,336,0,30
980,239,2,64,8,344,0,80
981,239,2,65,6,350,14,60
982,239,2,66,8,358,0,80
983,239,2,67,3,361,0,30
984,239,2,68,8,369,0,80
985,239,2,69,9,378,9,90
986,239,2,70,7,385,0,70
987,239,2,71,6,391,0,60
988,239,2,72,6,397,0,60
989,239,2,73,8,405,11,80
990,239,2,74,4,409,2,40
991,239,2,75,8,417,0,80
992,239,2,76,7,424,0,70
993,239,2,77,8,432,0,80
994,239,2,78,8,440,14,80
995,239,2,79,8,448,0,80
996,239,2,80,7,455,0,70
997,239,2,81,2,457,0,20
998,239,2,82,5,462,8,50
999,239,2,83,8,470,3,80
1000,239,2,84,4,474,0,40
1001,239,2,85,7,481,0,70
1002,239,2,86,6,487,0,60
1003,239,2,87,8,495,12,80
1004,239,2,88,8,503,0,80
1005,239,2,89,7,510,0,70
1006,239,2,90,3,513,0,30
1007,239,2,91,3,516,9,30
1008,239,2,92,2,518,0,20
1009,239,2,93,5,523,0,50
1010,239,2,94,5,528,0,50
1011,239,2,95,7,535,0,70
1012,239,2,96,7,542,14,70
1013,239,2,97,9,551,5,90
1014,239,2,98,4,555,0,40
1015,239,2,99,3,558,0,30
1016,239,2,100,2,560,0,20
1017,239,2,101,2,562,5,20
1018,239,2,102,4,566,3,40
1019,239,2,103,2,568,0,20
1020,239,2,104,9,577,0,90
1021,239,2,105,4,581,0,40
1022,239,2,106,6,587,0,60
1023,239,2,107,4,591,13,40
1024,239,2,108,5,596,0,50
1025,239,2,109,4,600,3,40
1026,239,2,110,5,605,0,50
1027,239,2,111,3,608,0,30
1028,239,2,112,4,612,0,40
1029,239,2,113,6,618,0,60
1030,239,2,114,2,620,0,20
1031,239,2,115,7,627,0,70
1032,239,2,116,2,629,0,20
1033,239,2,117,4,633,0,40
1034,239,2,118,4,637,18,40
1035,239,2,119,8,645,0,80
1036,239,2,120,6,651,0,60
1037,239,2,121,3,654,13,30
1038,239,2,122,5,659,0,50
1039,239,2,123,8,667,12,80
1040,239,2,124,6,673,3,60
1041,239,2,125,6,679,0,60
1042,239,2,126,3,682,0,30
1043,239,2,127,2,684,0,20
1044,239,2,128,6,690,0,60
1045,239,2,129,6,696,0,60
1046,239,2,130,5,701,0,50
1047,239,2,131,4,705,0,40
1048,239,2,132,8,713,0,80
1049,239,2,133,7,720,0,70
1050,239,2,134,2,722,22,20
1051,239,2,135,9,731,6,90
1052,239,2,136,9,740,0,90
1053,239,2,137,6,746,10,60
1054,239,2,138,3,749,0,30
1055,239,2,139,9,758,0,90
1056,239,2,140,2,760,0,20
1057,239,2,141,7,767,8,70
1058,239,2,142,2,769,0,20
1059,239,2,143,8,777,5,80
1060,239,2,144,9,786,0,90
1061,239,2,145,9,795,0,90
1062,239,2,146,8,803,15,80
1063,239,2,147,7,810,3,70
1064,239,2,148,2,812,0,20
1065,239,2,149,8,820,0,80
1066,239,2,150,5,825,0,50
1067,239,2,151,6,831,0,60
1068,239,2,152,5,836,0,50
1069,239,2,153,8,844,0,80
1070,239,2,154,4,848,0,40
1071,239,2,155,8,856,0,80
1072,239,2,156,6,862,31,60
1073,239,2,157,3,865,0,30
1074,239,2,158,3,868,0,30
1075,239,2,159,8,876,0,80
1076,239,2,160,7,883,14,70
1077,239,2,161,6,889,2,60
1078,239,2,162,8,897,0,80
1079,239,2,163,7,904,0,70
1080,239,2,164,4,908,16,40
1081,239,2,165,5,913,2,50
1082,239,2,166,8,921,0,80
1083,239,2,167,4,925,0,40
1084,239,2,168,6,931,0,60
1085,239,2,169,4,935,10,40
1086,239,2,170,5,940,3,50
1087,239,2,171,9,949,0,90
1088,239,2,172,5,954,7,50
1089,239,2,173,4,958,0,40
1090,239,2,174,2,960,2,20
1091,239,2,175,3,963,0,30
1092,239,2,176,9,972,5,90
1093,239,2,177,9,981,0,90
1094,239,2,178,8,989,15,80
1095,239,2,179,5,994,0,50
1096,239,2,180,9,1003,3,90
1097,239,2,181,8,1011,0,80
1098,239,2,182,7,1018,0,70
1099,239,2,183,6,1024,11,60
1100,239,2,184,8,1032,0,80
1101,239,2,185,4,1036,0,40
1102,239,2,186,6,1042,4,60
1103,239,2,187,9,1051,0,90
1104,239,2,188,3,1054,0,30
1105,239,2,189,5,1059,0,50
1106,239,2,190,4,1063,0,40
1107,239,2,191,3,1066,0,30
1108,239,2,192,7,1073,0,70
1109,239,2,193,4,1077,0,40
1110,239,2,194,3,1080,0,30
1111,239,2,195,6,1086,30,60
1112,239,2,196,6,1092,4,60
1113,239,2,197,3,1095,0,30
1114,239,2,198,2,1097,0,20
1115,239,2,199,7,1104,0,70
1116,239,2,200,9,1113,0,90
1117,239,2,201,4,1117,15,40
1118,239,2,202,7,1124,0,70
1119,239,2,203,6,1130,0,60
1120,239,2,204,2,1132,0,20
1121,239,2,205,4,1136,13,40
1122,239,2,206,7,1143,1,70
1123,239,2,207,9,1152,0,90
1124,239,2,208,7,1159,0,70
1125,239,2,209,2,1161,8,20
1126,239,2,210,6,1167,4,60
1127,239,2,211,4,1171,0,40
1128,239,2,212,8,1179,0,80
1129,239,2,213,5,1184,0,50
1130,239,2,214,8,1192,0,80
1131,239,2,215,7,1199,14,70
1132,239,2,216,3,1202,1,30
1133,239,2,217,7,1209,0,70
1134,239,2,218,3,1212,0,30
1135,239,2,219,2,1214,0,20
1136,239,2,220,3,1217,6,30
1137,239,2,221,4,1221,5,40
1138,239,2,222,4,1225,4,40
1139,239,2,223,5,1230,4,50
1140,239,2,224,9,1239,0,90
1141,239,2,225,3,1242,0,30
1142,239,2,226,8,1250,0,80
1143,239,2,227,7,1257,0,70
1144,239,2,228,4,1261,17,40
1145,239,2,229,9,1270,0,90
1146,239,2,230,3,1273,0,30
1147,239,2,231,6,1279,0,60
1148,239,2,232,8,1287,0,80
1149,239,2,233,9,1296,16,90
1150,239,2,234,5,1301,2,50
1151,239,2,235,2,1303,0,20
1152,239,2,236,8,1311,2,80
1153,239,2,237,4,1315,0,40
1154,239,2,238,3,1318,5,30
1155,239,2,239,6,1324,0,60
1156,239,2,240,8,1332,0,80
1157,239,2,241,6,1338,9,60
1158,239,2,242,7,1345,5,70
1159,239,2,243,9,1354,3,90
1160,239,2,244,2,1356,0,20
1161,239,2,245,3,1359,0,30
1162,239,2,246,7,1366,0,70
1163,239,2,247,2,1368,5,20
1164,239,2,248,3,1371,0,30
1165,239,2,249,9,1380,6,90
1166,239,2,250,6,1386,0,60
1167,239,2,251,9,1395,0,90
1168,239,2,252,9,1404,0,90
1169,239,2,253,2,1406,0,20
1170,239,2,254,2,1408,0,20
1171,239,2,255,8,1416,0,80
1172,239,2,256,2,1418,21,20
1173,239,2,257,7,1425,1,70
1174,239,2,258,7,1432,0,70
1175,239,2,259,3,1435,9,30
1176,239,2,260,6,1441,2,60
1177,239,2,261,4,1445,6,40
1178,239,2,262,2,1447,0,20
1179,239,2,263,2,1449,0,20
1180,239,2,264,6,1455,6,60
1181,239,2,265,5,1460,0,50
1182,239,2,266,3,1463,0,30
1183,239,2,267,5,1468,1,50
1184,239,2,268,4,1472,0,40
1185,239,2,269,3,1475,2,30
1186,239,2,270,2,1477,1,20
1187,239,2,271,7,1484,0,70
1188,239,2,272,7,1491,0,70
1189,239,2,273,9,1500,0,90
1190,239,2,274,7,1507,20,70
1191,239,2,275,6,1513,0,60
1192,239,2,276,9,1522,0,90
1193,239,2,277,3,1525,0,30
1194,239,2,278,6,1531,18,60
1195,239,2,279,9,1540,3,90
1196,239,2,280,6,1546,0,60
1197,239,2,281,5,1551,4,50
1198,239,2,282,9,1560,2,90
1199,239,2,283,4,1564,0,40
1200,239,2,284,5,1569,0,50
1201,239,2,285,2,1571,0,20
1202,239,2,286,3,1574,8,30
1203,239,2,287,3,1577,1,30
1204,239,2,288,5,1582,0,50
1205,239,2,289,3,1585,2,30
1206,239,2,290,5,1590,5,50
1207,239,2,291,3,1593,3,30
1208,239,2,292,4,1597,1,40
1209,239,2,293,2,1599,0,20
1210,239,2,294,3,1602,0,30
1211,239,2,295,5,1607,0,50
1212,239,2,296,2,1609,0,20
1213,239,2,297,9,1618,0,90
1214,239,2,298,8,1626,17,80
1215,239,2,299,4,1630,0,40
1216,239,2,300,2,1632,2,20
1217,239,2,301,8,1640,0,80
1218,239,2,302,6,1646,5,60
1219,239,2,303,5,1651,3,50
1220,239,2,304,3,1654,3,30
1221,239,2,305,5,1659,0,50
1222,239,2,306,2,1661,0,20
1223,239,2,307,7,1668,3,70
1224,239,2,308,9,1677,0,90
1225,239,2,309,7,1684,0,70
1226,239,2,310,4,1688,0,40
1227,239,2,311,9,1697,0,90
1228,239,2,312,7,1704,0,70
1229,239,2,313,9,1713,0,90
1230,239,2,314,3,1716,0,30
1231,239,2,315,7,1723,28,70
1232,239,2,316,8,1731,0,80
1233,239,2,317,7,1738,0,70
1234,239,2,318,8,1746,0,80
1235,239,2,319,2,1748,0,20
1236,239,2,320,3,1751,11,30
1237,239,2,321,8,1759,4,80
1238,239,2,322,6,1765,5,60
1239,239,2,323,3,1768,0,30
1240,239,2,324,9,1777,0,90
1241,239,2,325,5,1782,10,50
1242,239,2,326,5,1787,0,50
1243,239,2,327,5,1792,5,50
1244,239,2,328,7,1799,0,70
1245,239,2,329,7,1806,0,70
1246,239,2,330,5,1811,0,50
1247,239,2,331,5,1816,0,50
1248,239,2,332,9,1825,0,90
1249,239,2,333,2,1827,0,20
1250,239,2,334,2,1829,20,20
1251,239,2,335,3,1832,0,30
1252,239,2,336,8,1840,0,80
1253,239,2,337,5,1845,0,50
1254,239,2,338,3,1848,0,30
1255,239,2,339,5,1853,0,50
1256,239,2,340,6,1859,0,60
1257,239,2,341,8,1867,0,80
1258,239,2,342,8,1875,29,80
1259,239,2,343,7,1882,6,70
1260,239,2,344,8,1890,2,80
1261,239,2,345,6,1896,0,60
1262,239,2,346,8,1904,5,80
1263,239,2,347,9,1913,0,90
1264,239,2,348,6,1919,0,60
1265,239,2,349,4,1923,0,40
1266,239,2,350,7,1930,0,70
1267,239,2,351,4,1934,14,40
1268,239,2,352,4,1938,0,40
1269,239,2,353,5,1943,3,50
1270,239,2,354,8,1951,0,80
1271,239,2,355,9,1960,5,90
1272,239,2,356,9,1969,0,90
1273,239,2,357,6,1975,8,60
1274,239,2,358,9,1984,3,90
1275,239,2,359,6,1990,0,60
1276,239,2,360,2,1992,4,20
1277,239,2,361,3,1995,0,30
1278,239,2,362,7,2002,0,70
1279,239,2,363,9,2011,12,90
1280,239,2,364,6,2017,0,60
1281,239,2,365,2,2019,0,20
1282,239,2,366,4,2023,3,40
1283,239,2,367,3,2026,0,30
1284,239,2,368,2,2028,0,20
1285,239,2,369,5,2033,3,50
1286,239,2,370,4,2037,0,40
1287,239,2,371,7,2044,0,70
1288,239,2,372,2,2046,0,20
1289,239,2,373,9,2055,0,90
1290,239,2,374,6,2061,0,60
1291,239,2,375,5,2066,18,50
1292,239,2,376,5,2071,6,50
1293,239,2,377,2,2073,0,20
1294,239,2,378,6,2079,0,60
1295,239,2,379,4,2083,0,40
1296,239,2,380,7,2090,0,70
1297,239,2,381,4,2094,0,40
1298,239,2,382,4,2098,0,40
1299,239,2,383,7,2105,0,70
1300,239,2,384,3,2108,21,30
1301,239,2,385,4,2112,5,40
1302,239,2,386,6,2118,0,60
1303,239,2,387,7,2125,0,70
1304,239,2,388,4,2129,0,40
1305,239,2,389,6,2135,0,60
1306,239,2,390,7,2142,0,70
1307,239,2,391,8,2150,0,80
1308,239,2,392,3,2153,19,30
1309,239,2,393,8,2161,0,80
1310,239,2,394,4,2165,2,40
1311,239,2,395,2,2167,0,20
1312,239,2,396,3,2170,0,30
1313,239,2,397,8,2178,12,80
1314,239,2,398,9,2187,0,90
1315,239,2,399,7,2194,0,70
1316,239,2,400,3,2197,13,30
1317,239,2,401,8,2205,0,80
1318,239,2,402,7,2212,0,70
1319,239,2,403,5,2217,0,50
1320,239,2,404,5,2222,15,50
1321,239,2,405,7,2229,0,70
1322,239,2,406,4,2233,4,40
1323,239,2,407,6,2239,2,60
1324,239,2,408,7,2246,0,70
1325,239,2,409,7,2253,5,70
1326,239,2,410,3,2256,3,30
1327,239,2,411,8,2264,0,80
1328,239,2,412,5,2269,0,50
1329,239,2,413,5,2274,9,50
1330,239,2,414,5,2279,0,50
1331,239,2,415,2,2281,0,20
1332,239,2,416,5,2286,5,50
1333,239,2,417,4,2290,1,40
1334,239,2,418,3,2293,0,30
1335,239,2,419,4,2297,0,40
1336,239,2,420,7,2304,0,70
1337,239,2,421,2,2306,13,20
1338,239,2,422,7,2313,0,70
1339,239,2,423,4,2317,0,40
1340,239,2,424,9,2326,0,90
1341,239,2,425,9,2335,0,90
1342,239,2,426,5,2340,17,50
1343,239,2,427,2,2342,0,20
1344,239,2,428,3,2345,0,30
1345,239,2,429,7,2352,0,70
1346,239,2,430,3,2355,4,30
1347,239,2,431,5,2360,0,50
1348,239,2,432,5,2365,3,50
1349,239,2,433,4,2369,3,40
1350,239,2,434,5,2374,2,50
1351,239,2,435,2,2376,0,20
1352,239,2,436,3,2379,0,30
1353,239,2,437,9,2388,0,90
1354,239,2,438,9,2397,9,90
1355,239,2,439,8,2405,6,80
1356,239,2,440,5,2410,4,50
1357,239,2,441,6,2416,0,60
1358,239,2,442,2,2418,0,20
1359,239,2,443,3,2421,0,30
1360,239,2,444,9,2430,0,90
1361,239,2,445,6,2436,0,60
1362,239,2,446,3,2439,0,30
1363,239,2,447,4,2443,15,40
1364,239,2,448,4,2447,0,40
1365,239,2,449,7,2454,0,70
1366,239,2,450,8,2462,0,80
1367,239,2,451,4,2466,0,40
1368,239,2,452,5,2471,0,50
1369,239,2,453,6,2477,0,60
1370,239,2,454,4,2481,0,40
1371,239,2,455,9,2490,0,90
1372,239,2,456,2,2492,0,20
1373,239,2,457,4,2496,0,40
1374,239,2,458,6,2502,31,60
1375,239,2,459,3,2505,0,30
1376,239,2,460,4,2509,0,40
1377,239,2,461,2,2511,2,20
1378,239,2,462,6,2517,3,60
1379,239,2,463,6,2523,0,60
1380,239,2,464,8,2531,0,80
1381,239,2,465,8,2539,0,80
1382,239,2,466,2,2541,0,20
1383,239,2,467,6,2547,0,60
1384,239,2,468,8,2555,0,80
1385,239,2,469,3,2558,0,30
1386,239,2,470,7,2565,18,70
1387,239,2,471,2,2567,0,20
1388,239,2,472,9,2576,0,90
1389,239,2,473,5,2581,0,50
1390,239,2,474,8,2589,0,80
1391,239,2,475,7,2596,0,70
1392,239,2,476,5,2601,0,50
1393,239,2,477,6,2607,0,60
1394,239,2,478,3,2610,21,30
1395,239,2,479,9,2619,0,90
1396,239,2,480,3,2622,0,30
1397,239,2,481,5,2627,4,50
1398,239,2,482,2,2629,0,20
1399,239,2,483,3,2632,2,30
1400,239,2,484,5,2637,0,50
1401,239,2,485,4,2641,0,40
1402,239,2,486,9,2650,0,90
1403,239,2,487,2,2652,0,20
1404,239,2,488,9,2661,0,90
1405,239,2,489,3,2664,0,30
1406,239,2,490,5,2669,26,50
1407,239,2,491,6,2675,0,60
1408,239,2,492,7,2682,8,70
1409,239,2,493,3,2685,0,30
1410,239,2,494,7,2692,8,70
1411,239,2,495,5,2697,0,50
1412,239,2,496,7,2704,0,70
1413,239,2,497,3,2707,0,30
1414,239,2,498,5,2712,7,50
1415,239,2,499,4,2716,0,40
1416,239,2,500,3,2719,0,30
1417,239,2,501,3,2722,4,30
1418,239,2,502,7,2729,0,70
1419,239,2,503,2,2731,0,20
1420,239,2,504,8,2739,0,80
1421,239,2,505,6,2745,0,60
1422,239,2,506,9,2754,0,90
1423,239,2,507,8,2762,0,80
1424,239,2,508,3,2765,25,30
1425,239,2,509,8,2773,0,80
1426,239,2,510,3,2776,0,30
1427,239,2,511,4,2780,0,40
1428,239,2,512,6,2786,9,60
1429,239,2,513,6,2792,4,60
1430,239,2,514,9,2801,0,90
1431,239,2,515,4,2805,0,40
1432,239,2,516,5,2810,0,50
1433,239,2,517,7,2817,8,70
1434,239,2,518,9,2826,0,90
1435,239,2,519,3,2829,0,30
1436,239,2,520,2,2831,8,20
1437,239,2,521,6,2837,0,60
1438,239,2,522,3,2840,0,30
1439,239,2,523,2,2842,0,20
1440,239,2,524,4,2846,9,40
1441,239,2,525,5,2851,0,50
1442,239,2,526,9,2860,6,90
1443,239,2,527,8,2868,0,80
1444,239,2,528,8,2876,10,80
1445,239,2,529,2,2878,0,20
1446,239,2,530,5,2883,0,50
1447,239,2,531,7,2890,4,70
1448,239,2,532,6,2896,0,60
1449,239,2,533,2,2898,0,20
1450,239,2,534,9,2907,0,90
1451,239,2,535,8,2915,0,80
1452,239,2,536,3,2918,16,30
1453,239,2,537,4,2922,0,40
1454,239,2,538,3,2925,2,30
1455,239,2,539,7,2932,4,70
1456,239,2,540,3,2935,2,30
1457,239,2,541,7,2942,0,70
1458,239,2,542,5,2947,10,50
1459,239,2,543,3,2950,2,30
1460,239,2,544,4,2954,1,40
1461,239,2,545,9,2963,6,90
1462,239,2,546,2,2965,0,20
1463,239,2,547,8,2973,0,80
1464,239,2,548,2,2975,0,20
1465,239,2,549,8,2983,22,80
1466,239,2,550,9,2992,7,90
1467,239,2,551,5,2997,0,50
1468,239,2,552,8,3005,0,80
1469,239,2,553,5,3010,9,50
1470,239,2,554,8,3018,0,80
1471,239,2,555,2,3020,4,20
1472,239,2,556,7,3027,0,70
1473,239,2,557,9,3036,0,90
1474,239,2,558,2,3038,0,20
1475,239,2,559,7,3045,0,70
1476,239,2,560,6,3051,0,60
1477,239,2,561,6,3057,0,60
1478,239,2,562,8,3065,17,80
1479,239,2,563,7,3072,2,70
1480,239,2,564,7,3079,0,70
1481,239,2,565,2,3081,0,20
1482,239,2,566,6,3087,6,60
1483,239,2,567,7,3094,0,70
1484,239,2,568,3,3097,6,30
1485,239,2,569,7,3104,2,70
1486,239,2,570,8,3112,0,80
1487,239,2,571,3,3115,8,30
1488,239,2,572,6,3121,0,60
1489,239,2,573,9,3130,0,90
1490,239,2,574,4,3134,0,40
1491,239,2,575,4,3138,0,40
1492,239,2,576,5,3143,7,50
1493,239,2,577,4,3147,3,40
1494,239,2,578,8,3155,6,80
1495,239,2,579,6,3161,0,60
1496,239,2,580,9,3170,0,90
1497,239,2,581,6,3176,0,60
1498,239,2,582,8,3184,0,80
1499,239,2,583,3,3187,17,30
1500,239,2,584,8,3195,0,80
1501,239,2,585,7,3202,4,70
1502,239,2,586,8,3210,5,80
1503,239,2,587,4,3214,0,40
1504,239,2,588,4,3218,5,40
1505,239,2,589,6,3224,0,60
1506,239,2,590,6,3230,0,60
1507,239,2,591,5,3235,0,50
1508,239,2,592,3,3238,10,30
1509,239,2,593,5,3243,0,50
1510,239,2,594,8,3251,0,80
1511,239,2,595,6,3257,10,60
1512,239,2,596,7,3264,0,70
1513,239,2,597,6,3270,0,60
1514,239,2,598,5,3275,0,50
1515,239,2,599,4,3279,0,40
1516,239,2,600,5,3284,0,50
1517,239,2,601,3,3287,0,30
1518,239,2,602,4,3291,19,40
1519,239,2,603,6,3297,4,60
1520,239,2,604,2,3299,3,20
1521,239,2,605,9,3308,0,90
1522,239,2,606,8,3316,0,80
1523,239,2,607,6,3322,10,60
1524,239,2,608,7,3329,8,70
1525,239,2,609,5,3334,0,50
1526,239,2,610,8,3342,0,80
1527,239,2,611,3,3345,0,30
1528,239,2,612,9,3354,12,90
1529,239,2,613,6,3360,5,60
1530,239,2,614,7,3367,0,70
1531,239,2,615,5,3372,8,50
1532,239,2,616,2,3374,2,20
1533,239,2,617,5,3379,2,50
1534,239,2,618,5,3384,0,50
1535,239,2,619,8,3392,0,80
1536,239,2,620,5,3397,9,50
1537,239,2,621,9,3406,0,90
1538,239,2,622,2,3408,0,20
1539,239,2,623,6,3414,0,60
1540,239,2,624,3,3417,16,30
1541,239,2,625,8,3425,2,80
1542,239,2,626,8,3433,0,80
1543,239,2,627,5,3438,9,50
1544,239,2,628,6,3444,1,60
1545,239,2,629,2,3446,0,20
1546,239,2,630,4,3450,6,40
1547,239,2,631,3,3453,0,30
1548,239,2,632,8,3461,7,80
1549,239,2,633,3,3464,0,30
1550,239,2,634,6,3470,2,60
1551,239,2,635,3,3473,2,30
1552,239,2,636,9,3482,4,90
1553,239,2,637,2,3484,0,20
1554,239,2,638,7,3491,3,70
1555,239,2,639,4,3495,0,40
1556,239,2,640,2,3497,0,20
1557,239,2,641,6,3503,0,60
1558,239,2,642,3,3506,4,30
1559,239,2,643,7,3513,0,70
1560,239,2,644,4,3517,6,40
1561,239,2,645,7,3524,0,70
1562,239,2,646,9,3533,0,90
1563,239,2,647,2,3535,0,20
1564,239,2,648,3,3538,0,30
1565,239,2,649,5,3543,0,50
1566,239,2,650,5,3548,0,50
1567,239,2,651,9,3557,0,90
1568,239,2,652,7,3564,0,70
1569,239,2,653,3,3567,0,30
1570,239,2,654,8,3575,0,80
1571,239,2,655,4,3579,0,40
1572,239,2,656,8,3587,0,80
1573,239,2,657,6,3593,0,60
1574,239,2,658,5,3598,0,50
1575,239,2,659,3,3601,0,30
1576,239,2,660,7,3608,0,70
1577,239,2,661,8,3616,40,80
1578,239,2,662,8,3624,0,80
1579,239,2,663,3,3627,0,30
1580,239,2,664,4,3631,0,40
1581,239,2,665,6,3637,0,60
1582,239,2,666,8,3645,0,80
1583,239,2,667,6,3651,15,60
1584,239,2,668,2,3653,0,20
1585,239,2,669,2,3655,1,20
1586,239,2,670,9,3664,0,90
1587,239,2,671,7,3671,0,70
1588,239,2,672,3,3674,12,30
1589,239,2,673,8,3682,2,80
1590,239,2,674,6,3688,3,60
1591,239,2,675,5,3693,0,50
1592,239,2,676,6,3699,0,60
1593,239,2,677,4,3703,11,40
1594,239,2,678,5,3708,0,50
1595,239,2,679,2,3710,0,20
1596,239,2,680,2,3712,5,20
1597,239,2,681,4,3716,0,40
1598,239,2,682,2,3718,0,20
1599,239,2,683,7,3725,0,70
1600,239,2,684,2,3727,0,20
1601,239,2,685,9,3736,0,90
1602,239,2,686,9,3745,0,90
1603,239,2,687,6,3751,0,60
1604,239,2,688,6,3757,0,60
1605,239,2,689,5,3762,0,50
1606,239,2,690,5,3767,0,50
1607,239,2,691,6,3773,0,60
1608,239,2,692,3,3776,0,30
1609,239,2,693,2,3778,0,20
1610,239,2,694,7,3785,0,70
1611,239,2,695,4,3789,0,40
1612,239,2,696,8,3797,0,80
1613,239,2,697,2,3799,0,20
1614,239,2,698,8,3807,0,80
1615,239,2,699,7,3814,0,70
1616,239,2,700,3,3817,0,30
1617,239,2,701,5,3822,0,50
1618,239,2,702,3,3825,64,30
1619,239,2,703,6,3831,3,60
1620,239,2,704,8,3839,4,80
1621,239,2,705,9,3848,0,90
1622,239,2,706,2,3850,0,20
1623,239,2,707,4,3854,9,40
1624,239,2,708,4,3858,0,40
1625,239,2,709,5,3863,3,50
1626,239,2,710,5,3868,0,50
1627,239,2,711,3,3871,0,30
1628,239,2,712,4,3875,0,40
1629,239,2,713,8,3883,11,80
1630,239,2,714,5,3888,0,50
1631,239,2,715,3,3891,0,30
1632,239,2,716,2,3893,0,20
1633,239,2,717,6,3899,9,60
1634,239,2,718,5,3904,0,50
1635,239,2,719,6,3910,0,60
1636,239,2,720,7,3917,7,70
1637,239,2,721,6,3923,0,60
1638,239,2,722,8,3931,0,80
1639,239,2,723,4,3935,0,40
1640,239,2,724,3,3938,0,30
1641,239,2,725,6,3944,0,60
1642,239,2,726,9,3953,0,90
1643,239,2,727,5,3958,0,50
1644,239,2,728,4,3962,36,40
1645,239,2,729,6,3968,2,60
1646,239,2,730,6,3974,0,60
1647,239,2,731,4,3978,3,40
1648,239,2,732,8,3986,6,80
1649,239,2,733,2,3988,0,20
1650,239,2,734,9,3997,0,90
1651,239,2,735,3,4000,2,30
1652,239,2,736,2,4002,0,20
1653,239,2,737,2,4004,2,20
1654,239,2,738,2,4006,0,20
1655,239,2,739,4,4010,0,40
1656,239,2,740,4,4014,0,40
1657,239,2,741,4,4018,0,40
1658,239,2,742,4,4022,7,40
1659,239,2,743,6,4028,2,60
1660,239,2,744,3,4031,2,30
1661,239,2,745,5,4036,2,50
1662,239,2,746,8,4044,3,80
1663,239,2,747,9,4053,0,90
1664,239,2,748,7,4060,0,70
1665,239,2,749,8,4068,14,80
1666,239,2,750,7,4075,0,70
1667,239,2,751,5,4080,0,50
1668,239,2,752,2,4082,5,20
1669,239,2,753,9,4091,0,90
1670,239,2,754,4,4095,6,40
1671,239,2,755,7,4102,0,70
1672,239,2,756,8,4110,5,80
1673,239,2,757,3,4113,0,30
1674,239,2,758,3,4116,0,30
1675,239,2,759,3,4119,0,30
1676,239,2,760,9,4128,0,90
1677,239,2,761,7,4135,7,70
1678,239,2,762,8,4143,0,80
1679,239,2,763,2,4145,0,20
1680,239,2,764,2,4147,0,20
1681,239,2,765,7,4154,0,70
1682,239,2,766,7,4161,0,70
1683,239,2,767,7,4168,0,70
1684,239,2,768,2,4170,0,20
1685,239,2,769,7,4177,0,70
1686,239,2,770,9,4186,17,90
1687,239,2,771,9,4195,6,90
1688,239,2,772,5,4200,0,50
1689,239,2,773,6,4206,0,60
1690,239,2,774,2,4208,6,20
1691,239,2,775,6,4214,4,60
1692,239,2,776,3,4217,0,30
1693,239,2,777,9,4226,0,90
1694,239,2,778,9,4235,11,90
1695,239,2,779,6,4241,0,60
1696,239,2,780,9,4250,11,90
1697,239,2,781,5,4255,4,50
1698,239,2,782,4,4259,2,40
1699,239,2,783,6,4265,3,60
1700,239,2,784,2,4267,0,20
1701,239,2,785,4,4271,2,40
1702,239,2,786,5,4276,4,50
1703,239,2,787,9,4285,7,90
1704,239,2,788,4,4289,4,40
1705,239,2,789,2,4291,1,20
1706,239,2,790,2,4293,0,20
1707,239,2,791,7,4300,5,70
1708,239,2,792,9,4309,6,90
1709,239,2,793,4,4313,2,40
1710,239,2,794,8,4321,0,80
1711,239,2,795,5,4326,7,50
1712,239,2,796,3,4329,0,30
1713,239,2,797,3,4332,0,30
1714,239,2,798,7,4339,7,70
1715,239,2,799,8,4347,0,80
1716,239,2,800,8,4355,0,80
1717,239,2,801,3,4358,0,30
1718,239,2,802,4,4362,0,40
1719,239,2,803,4,4366,20,40
1720,239,2,804,5,4371,0,50
1721,239,2,805,3,4374,0,30
1722,239,2,806,6,4380,0,60
1723,239,2,807,4,4384,0,40
1724,239,2,808,7,4391,0,70
1725,239,2,809,4,4395,0,40
1726,239,2,810,9,4404,12,90
1727,239,2,811,4,4408,0,40
1728,239,2,812,6,4414,0,60
1729,239,2,813,9,4423,0,90
1730,239,2,814,5,4428,0,50
1731,239,2,815,6,4434,0,60
1732,239,2,816,2,4436,0,20
1733,239,2,817,9,4445,0,90
1734,239,2,818,6,4451,0,60
1735,239,2,819,5,4456,25,50
1736,239,2,820,6,4462,0,60
1737,239,2,821,6,4468,5,60
1738,239,2,822,5,4473,0,50
1739,239,2,823,3,4476,3,30
1740,239,2,824,3,4479,0,30
1741,239,2,825,3,4482,3,30
1742,239,2,826,5,4487,0,50
1743,239,2,827,4,4491,0,40
1744,239,2,828,5,4496,5,50
1745,239,2,829,8,4504,0,80
1746,239,2,830,9,4513,0,90
1747,239,2,831,9,4522,10,90
1748,239,2,832,4,4526,0,40
1749,239,2,833,3,4529,0,30
1750,239,2,834,5,4534,3,50
1751,239,2,835,4,4538,2,40
1752,239,2,836,2,4540,0,20
1753,239,2,837,6,4546,5,60
1754,239,2,838,9,4555,1,90
1755,239,2,839,8,4563,0,80
1756,239,2,840,5,4568,0,50
1757,239,2,841,4,4572,5,40
1758,239,2,842,2,4574,0,20
1759,239,2,843,9,4583,5,90
1760,239,2,844,2,4585,0,20
1761,239,2,845,3,4588,1,30
1762,239,2,846,7,4595,0,70
1763,239,2,847,7,4602,0,70
1764,239,2,848,4,4606,0,40
1765,239,2,849,8,4614,0,80
1766,239,2,850,7,4621,18,70
1767,239,2,851,9,4630,1,90
1768,239,2,852,2,4632,0,20
1769,239,2,853,6,4638,0,60
1770,239,2,854,5,4643,0,50
1771,239,2,855,4,4647,0,40
1772,239,2,856,9,4656,0,90
1773,239,2,857,2,4658,16,20
1774,239,2,858,5,4663,0,50
1775,239,2,859,2,4665,0,20
1776,239,2,860,9,4674,0,90
1777,239,2,861,3,4677,11,30
1778,239,2,862,8,4685,0,80
1779,239,2,863,7,4692,0,70
1780,239,2,864,7,4699,11,70
1781,239,2,865,5,4704,0,50
1782,239,2,866,6,4710,0,60
1783,239,2,867,8,4718,3,80
1784,239,2,868,4,4722,0,40
1785,239,2,869,3,4725,0,30
1786,239,2,870,2,4727,0,20
1787,239,2,871,2,4729,0,20
1788,239,2,872,2,4731,0,20
1789,239,2,873,2,4733,0,20
1790,239,2,874,9,4742,0,90
1791,239,2,875,3,4745,0,30
1792,239,2,876,2,4747,0,20
1793,239,2,877,6,4753,0,60
1794,239,2,878,9,4762,19,90
1795,239,2,879,9,4771,0,90
1796,239,2,880,5,4776,5,50
1797,239,2,881,6,4782,0,60
1798,239,2,882,5,4787,0,50
1799,239,2,883,7,4794,0,70
1800,239,2,884,4,4798,0,40
1801,239,2,885,7,4805,0,70
1802,239,2,886,5,4810,17,50
1803,239,2,887,8,4818,0,80
1804,239,2,888,3,4821,0,30
1805,239,2,889,9,4830,8,90
1806,239,2,890,3,4833,0,30
1807,239,2,891,4,4837,0,40
1808,239,2,892,9,4846,7,90
1809,239,2,893,7,4853,0,70
1810,239,2,894,8,4861,0,80
1811,239,2,895,7,4868,10,70
1812,239,2,896,3,4871,0,30
1813,239,2,897,2,4873,0,20
1814,239,2,898,8,4881,6,80
1815,239,2,899,7,4888,0,70
1816,239,2,900,8,4896,0,80
1817,239,2,901,3,4899,0,30
1818,239,2,902,5,4904,0,50
1819,239,2,903,2,4906,0,20
1820,239,2,904,2,4908,0,20
1821,239,2,905,7,4915,0,70
1822,239,2,906,2,4917,19,20
1823,239,2,907,4,4921,0,40
1824,239,2,908,9,4930,3,90
1825,239,2,909,6,4936,2,60
1826,239,2,910,9,4945,0,90
1827,239,2,911,8,4953,14,80
1828,239,2,912,8,4961,5,80
1829,239,2,913,3,4964,1,30
1830,239,2,914,9,4973,0,90
1831,239,2,915,8,4981,0,80
1832,239,2,916,6,4987,0,60
1833,239,2,917,8,4995,0,80
1834,239,3,1,3,3,5,30
1835,239,3,2,2,5,0,20
1836,239,3,3,9,14,8,90
1837,239,3,4,7,21,0,70
1838,239,3,5,9,30,0,90
1839,239,3,6,4,34,0,40
1840,239,3,7,4,38,0,40
1841,239,3,8,5,43,15,50
1842,239,3,9,3,46,0,30
1843,239,3,10,4,50,4,40
1844,239,3,11,8,58,2,80
1845,239,3,12,7,65,3,70
1846,239,3,13,8,73,0,80
1847,239,3,14,8,81,0,80
1848,239,3,15,9,90,0,90
1849,239,3,16,3,93,0,30
1850,239,3,17,2,95,14,20
1851,239,3,18,9,104,0,90
1852,239,3,19,2,106,0,20
1853,239,3,20,9,115,0,90
1854,239,3,21,8,123,0,80
1855,239,3,22,9,132,0,90
1856,239,3,23,5,137,18,50
1857,239,3,24,9,146,6,90
1858,239,3,25,9,155,0,90
1859,239,3,26,4,159,0,40
1860,239,3,27,9,168,0,90
1861,239,3,28,3,171,0,30
1862,239,3,29,9,180,19,90
1863,239,3,30,7,187,0,70
1864,239,3,31,7,194,0,70
1865,239,3,32,3,197,5,30
1866,239,3,33,8,205,1,80
1867,239,3,34,8,213,3,80
1868,239,3,35,2,215,0,20
1869,239,3,36,6,221,0,60
1870,239,3,37,2,223,0,20
1871,239,3,38,3,226,0,30
1872,239,3,39,5,231,6,50
1873,239,3,40,6,237,4,60
1874,239,3,41,2,239,0,20
1875,239,3,42,4,243,0,40
1876,239,3,43,9,252,9,90
1877,239,3,44,6,258,0,60
1878,239,3,45,2,260,0,20
1879,239,3,46,6,266,0,60
1880,239,3,47,5,271,0,50
1881,239,3,48,8,279,0,80
1882,239,3,49,6,285,0,60
1883,239,3,50,9,294,0,90
1884,239,3,51,4,298,0,40
1885,239,3,52,3,301,0,30
1886,239,3,53,6,307,0,60
1887,239,3,54,4,311,0,40
1888,239,3,55,7,318,0,70
1889,239,3,56,4,322,0,40
1890,239,3,57,2,324,30,20
1891,239,3,58,7,331,0,70
1892,239,3,59,9,340,0,90
1893,239,3,60,2,342,0,20
1894,239,3,61,6,348,0,60
1895,239,3,62,6,354,9,60
1896,239,3,63,5,359,0,50
1897,239,3,64,5,364,0,50
1898,239,3,65,3,367,8,30
1899,239,3,66,7,374,0,70
1900,239,3,67,4,378,0,40
1901,239,3,68,5,383,0,50
1902,239,3,69,5,388,0,50
1903,239,3,70,3,391,0,30
1904,239,3,71,7,398,0,70
1905,239,3,72,6,404,0,60
1906,239,3,73,5,409,0,50
1907,239,3,74,3,412,22,30
1908,239,3,75,5,417,0,50
1909,239,3,76,7,424,6,70
1910,239,3,77,7,431,0,70
1911,239,3,78,6,437,0,60
1912,239,3,79,9,446,0,90
1913,239,3,80,8,454,14,80
1914,239,3,81,3,457,0,30
1915,239,3,82,7,464,0,70
1916,239,3,83,5,469,11,50
1917,239,3,84,6,475,0,60
1918,239,3,85,8,483,0,80
1919,239,3,86,6,489,0,60
1920,239,3,87,8,497,0,80
1921,239,3,88,3,500,0,30
1922,239,3,89,8,508,0,80
1923,239,3,90,5,513,18,50
1924,239,3,91,5,518,0,50
1925,239,3,92,8,526,0,80
1926,239,3,93,8,534,17,80
1927,239,3,94,2,536,0,20
1928,239,3,95,2,538,4,20
1929,239,3,96,2,540,1,20
1930,239,3,97,3,543,1,30
1931,239,3,98,4,547,0,40
1932,239,3,99,6,553,3,60
1933,239,3,100,7,560,0,70
1934,239,3,101,3,563,5,30
1935,239,3,102,3,566,4,30
1936,239,3,103,3,569,0,30
1937,239,3,104,5,574,9,50
1938,239,3,105,2,576,0,20
1939,239,3,106,8,584,0,80
1940,239,3,107,4,588,5,40
1941,239,3,108,6,594,0,60
1942,239,3,109,3,597,0,30
1943,239,3,110,4,601,8,40
1944,239,3,111,7,608,0,70
1945,239,3,112,7,615,2,70
1946,239,3,113,7,622,0,70
1947,239,3,114,9,631,0,90
1948,239,3,115,3,634,8,30
1949,239,3,116,2,636,0,20
1950,239,3,117,2,638,1,20
1951,239,3,118,2,640,0,20
1952,239,3,119,5,645,0,50
1953,239,3,120,4,649,0,40
1954,239,3,121,9,658,0,90
1955,239,3,122,6,664,15,60
1956,239,3,123,7,671,0,70
1957,239,3,124,5,676,7,50
1958,239,3,125,9,685,0,90
1959,239,3,126,3,688,0,30
1960,239,3,127,7,695,0,70
1961,239,3,128,2,697,0,20
1962,239,3,129,5,702,0,50
1963,239,3,130,6,708,13,60
1964,239,3,131,3,711,0,30
1965,239,3,132,5,716,4,50
1966,239,3,133,4,720,0,40
1967,239,3,134,5,725,0,50
1968,239,3,135,2,727,6,20
1969,239,3,136,7,734,0,70
1970,239,3,137,5,739,7,50
1971,239,3,138,9,748,0,90
1972,239,3,139,6,754,0,60
1973,239,3,140,7,761,13,70
1974,239,3,141,4,765,2,40
1975,239,3,142,3,768,0,30
1976,239,3,143,2,770,3,20
1977,239,3,144,6,776,3,60
1978,239,3,145,4,780,0,40
1979,239,3,146,8,788,0,80
1980,239,3,147,6,794,3,60
1981,239,3,148,5,799,0,50
1982,239,3,149,4,803,0,40
1983,239,3,150,9,812,0,90
1984,239,3,151,7,819,9,70
1985,239,3,152,9,828,0,90
1986,239,3,153,8,836,0,80
1987,239,3,154,5,841,0,50
1988,239,3,155,3,844,0,30
1989,239,3,156,3,847,0,30
1990,239,3,157,2,849,0,20
1991,239,3,158,7,856,0,70
1992,239,3,159,5,861,0,50
1993,239,3,160,7,868,34,70
1994,239,3,161,5,873,3,50
1995,239,3,162,4,877,0,40
1996,239,3,163,8,885,2,80
1997,239,3,164,7,892,0,70
1998,239,3,165,7,899,0,70
1999,239,3,166,7,906,11,70
2000,239,3,167,4,910,0,40
2001,239,3,168,3,913,4,30
2002,239,3,169,9,922,3,90
2003,239,3,170,5,927,3,50
2004,239,3,171,3,930,0,30
2005,239,3,172,5,935,5,50
2006,239,3,173,4,939,3,40
2007,239,3,174,7,946,3,70
2008,239,3,175,6,952,0,60
2009,239,3,176,2,954,2,20
2010,239,3,177,7,961,4,70
2011,239,3,178,2,963,0,20
2012,239,3,179,7,970,0,70
2013,239,3,180,4,974,0,40
2014,239,3,181,5,979,0,50
2015,239,3,182,3,982,0,30
2016,239,3,183,9,991,17,90
2017,239,3,184,4,995,2,40
2018,239,3,185,5,1000,0,50
2019,239,3,186,4,1004,0,40
2020,239,3,187,3,1007,7,30
2021,239,3,188,2,1009,0,20
2022,239,3,189,5,1014,4,50
2023,239,3,190,7,1021,2,70
2024,239,3,191,3,1024,0,30
2025,239,3,192,3,1027,0,30
2026,239,3,193,2,1029,0,20
2027,239,3,194,6,1035,0,60
2028,239,3,195,7,1042,0,70
2029,239,3,196,8,1050,0,80
2030,239,3,197,4,1054,0,40
2031,239,3,198,5,1059,0,50
2032,239,3,199,8,1067,0,80
2033,239,3,200,4,1071,0,40
2034,239,3,201,7,1078,0,70
2035,239,3,202,9,1087,31,90
2036,239,3,203,6,1093,0,60
2037,239,3,204,9,1102,0,90
2038,239,3,205,8,1110,0,80
2039,239,3,206,8,1118,0,80
2040,239,3,207,8,1126,0,80
2041,239,3,208,2,1128,18,20
2042,239,3,209,4,1132,2,40
2043,239,3,210,2,1134,0,20
2044,239,3,211,3,1137,0,30
2045,239,3,212,8,1145,0,80
2046,239,3,213,4,1149,0,40
2047,239,3,214,9,1158,0,90
2048,239,3,215,4,1162,16,40
2049,239,3,216,2,1164,0,20
2050,239,3,217,5,1169,0,50
2051,239,3,218,9,1178,0,90
2052,239,3,219,7,1185,13,70
2053,239,3,220,2,1187,6,20
2054,239,3,221,2,1189,0,20
2055,239,3,222,3,1192,0,30
2056,239,3,223,5,1197,0,50
2057,239,3,224,8,1205,0,80
2058,239,3,225,4,1209,10,40
2059,239,3,226,5,1214,2,50
2060,239,3,227,9,1223,0,90
2061,239,3,228,2,1225,0,20
2062,239,3,229,2,1227,0,20
2063,239,3,230,4,1231,11,40
2064,239,3,231,2,1233,0,20
2065,239,3,232,7,1240,2,70
2066,239,3,233,7,1247,0,70
2067,239,3,234,9,1256,0,90
2068,239,3,235,6,1262,0,60
2069,239,3,236,4,1266,0,40
2070,239,3,237,9,1275,19,90
2071,239,3,238,2,1277,0,20
2072,239,3,239,2,1279,0,20
2073,239,3,240,4,1283,4,40
2074,239,3,241,4,1287,0,40
2075,239,3,242,4,1291,4,40
2076,239,3,243,8,1299,0,80
2077,239,3,244,3,1302,7,30
2078,239,3,245,5,1307,0,50
2079,239,3,246,6,1313,9,60
2080,239,3,247,7,1320,0,70
2081,239,3,248,3,1323,0,30
2082,239,3,249,4,1327,0,40
2083,239,3,250,2,1329,10,20
2084,239,3,251,9,1338,6,90
2085,239,3,252,2,1340,1,20
2086,239,3,253,4,1344,0,40
2087,239,3,254,6,1350,0,60
2088,239,3,255,5,1355,0,50
2089,239,3,256,4,1359,0,40
2090,239,3,257,5,1364,11,50
2091,239,3,258,3,1367,0,30
2092,239,3,259,6,1373,1,60
2093,239,3,260,6,1379,1,60
2094,239,3,261,6,1385,0,60
2095,239,3,262,3,1388,2,30
2096,239,3,263,6,1394,0,60
2097,239,3,264,9,1403,0,90
2098,239,3,265,7,1410,0,70
2099,239,3,266,9,1419,0,90
2100,239,3,267,8,1427,19,80
2101,239,3,268,3,1430,0,30
2102,239,3,269,2,1432,0,20
2103,239,3,270,3,1435,0,30
2104,239,3,271,8,1443,0,80
2105,239,3,272,6,1449,14,60
2106,239,3,273,4,1453,2,40
2107,239,3,274,3,1456,0,30
2108,239,3,275,8,1464,0,80
2109,239,3,276,9,1473,5,90
2110,239,3,277,5,1478,0,50
2111,239,3,278,2,1480,0,20
2112,239,3,279,4,1484,7,40
2113,239,3,280,8,1492,4,80
2114,239,3,281,8,1500,3,80
2115,239,3,282,3,1503,0,30
2116,239,3,283,8,1511,5,80
2117,239,3,284,7,1518,0,70
2118,239,3,285,4,1522,4,40
2119,239,3,286,3,1525,0,30
2120,239,3,287,2,1527,3,20
2121,239,3,288,4,1531,2,40
2122,239,3,289,4,1535,0,40
2123,239,3,290,7,1542,6,70
2124,239,3,291,2,1544,0,20
2125,239,3,292,4,1548,1,40
2126,239,3,293,7,1555,0,70
2127,239,3,294,9,1564,0,90
2128,239,3,295,9,1573,6,90
2129,239,3,296,6,1579,0,60
2130,239,3,297,4,1583,0,40
2131,239,3,298,5,1588,4,50
2132,239,3,299,3,1591,0,30
2133,239,3,300,8,1599,0,80
2134,239,3,301,7,1606,7,70
2135,239,3,302,3,1609,0,30
2136,239,3,303,3,1612,0,30
2137,239,3,304,9,1621,0,90
2138,239,3,305,7,1628,0,70
2139,239,3,306,2,1630,0,20
2140,239,3,307,5,1635,0,50
2141,239,3,308,7,1642,26,70
2142,239,3,309,9,1651,7,90
2143,239,3,310,7,1658,0,70
2144,239,3,311,3,1661,0,30
2145,239,3,312,6,1667,0,60
2146,239,3,313,6,1673,0,60
2147,239,3,314,2,1675,0,20
2148,239,3,315,6,1681,0,60
2149,239,3,316,8,1689,18,80
2150,239,3,317,2,1691,0,20
2151,239,3,318,6,1697,4,60
2152,239,3,319,5,1702,0,50
2153,239,3,320,9,1711,0,90
2154,239,3,321,9,1720,8,90
2155,239,3,322,4,1724,0,40
2156,239,3,323,2,1726,0,20
2157,239,3,324,9,1735,0,90
2158,239,3,325,5,1740,0,50
2159,239,3,326,6,1746,15,60
2160,239,3,327,5,1751,0,50
2161,239,3,328,8,1759,0,80
2162,239,3,329,9,1768,11,90
2163,239,3,330,3,1771,1,30
2164,239,3,331,3,1774,1,30
2165,239,3,332,4,1778,0,40
2166,239,3,333,5,1783,0,50
2167,239,3,334,3,1786,0,30
2168,239,3,335,3,1789,0,30
2169,239,3,336,6,1795,11,60
2170,239,3,337,8,1803,2,80
2171,239,3,338,7,1810,5,70
2172,239,3,339,7,1817,0,70
2173,239,3,340,3,1820,0,30
2174,239,3,341,5,1825,9,50
2175,239,3,342,7,1832,0,70
2176,239,3,343,2,1834,2,20
2177,239,3,344,8,1842,0,80
2178,239,3,345,6,1848,0,60
2179,239,3,346,7,1855,0,70
2180,239,3,347,7,1862,18,70
2181,239,3,348,8,1870,0,80
2182,239,3,349,9,1879,0,90
2183,239,3,350,8,1887,18,80
2184,239,3,351,3,1890,0,30
2185,239,3,352,2,1892,2,20
2186,239,3,353,9,1901,4,90
2187,239,3,354,9,1910,0,90
2188,239,3,355,7,1917,0,70
2189,239,3,356,6,1923,0,60
2190,239,3,357,4,1927,13,40
2191,239,3,358,2,1929,0,20
2192,239,3,359,7,1936,8,70
2193,239,3,360,7,1943,0,70
2194,239,3,361,7,1950,9,70
2195,239,3,362,2,1952,0,20
2196,239,3,363,2,1954,8,20
2197,239,3,364,3,1957,0,30
2198,239,3,365,7,1964,0,70
2199,239,3,366,9,1973,10,90
2200,239,3,367,5,1978,3,50
2201,239,3,368,3,1981,0,30
2202,239,3,369,2,1983,0,20
2203,239,3,370,5,1988,0,50
2204,239,3,371,9,1997,9,90
2205,239,3,372,4,2001,0,40
2206,239,3,373,9,2010,6,90
2207,239,3,374,9,2019,0,90
2208,239,3,375,3,2022,0,30
2209,239,3,376,5,2027,0,50
2210,239,3,377,5,2032,0,50
2211,239,3,378,8,2040,0,80
2212,239,3,379,2,2042,9,20
2213,239,3,380,9,2051,0,90
2214,239,3,381,3,2054,0,30
2215,239,3,382,9,2063,0,90
2216,239,3,383,4,2067,0,40
2217,239,3,384,2,2069,0,20
2218,239,3,385,7,2076,0,70
2219,239,3,386,7,2083,21,70
2220,239,3,387,5,2088,0,50
2221,239,3,388,7,2095,0,70
2222,239,3,389,6,2101,0,60
2223,239,3,390,8,2109,12,80
2224,239,3,391,2,2111,1,20
2225,239,3,392,4,2115,0,40
2226,239,3,393,2,2117,0,20
2227,239,3,394,5,2122,0,50
2228,239,3,395,9,2131,0,90
2229,239,3,396,3,2134,12,30
2230,239,3,397,3,2137,1,30
2231,239,3,398,6,2143,4,60
2232,239,3,399,3,2146,0,30
2233,239,3,400,4,2150,0,40
2234,239,3,401,2,2152,0,20
2235,239,3,402,5,2157,0,50
2236,239,3,403,5,2162,0,50
2237,239,3,404,5,2167,10,50
2238,239,3,405,6,2173,3,60
2239,239,3,406,4,2177,0,40
2240,239,3,407,2,2179,0,20
2241,239,3,408,2,2181,3,20
2242,239,3,409,2,2183,0,20
2243,239,3,410,7,2190,1,70
2244,239,3,411,8,2198,0,80
2245,239,3,412,7,2205,0,70
2246,239,3,413,3,2208,0,30
2247,239,3,414,7,2215,15,70
2248,239,3,415,2,2217,0,20
2249,239,3,416,7,2224,0,70
2250,239,3,417,4,2228,0,40
2251,239,3,418,6,2234,14,60
2252,239,3,419,5,2239,0,50
2253,239,3,420,9,2248,8,90
2254,239,3,421,7,2255,0,70
2255,239,3,422,2,2257,3,20
2256,239,3,423,6,2263,0,60
2257,239,3,424,6,2269,0,60
2258,239,3,425,3,2272,0,30
2259,239,3,426,3,2275,0,30
2260,239,3,427,6,2281,0,60
2261,239,3,428,7,2288,16,70
2262,239,3,429,4,2292,0,40
2263,239,3,430,4,2296,0,40
2264,239,3,431,7,2303,0,70
2265,239,3,432,6,2309,0,60
2266,239,3,433,3,2312,0,30
2267,239,3,434,7,2319,16,70
2268,239,3,435,8,2327,0,80
2269,239,3,436,4,2331,0,40
2270,239,3,437,7,2338,0,70
2271,239,3,438,2,2340,0,20
2272,239,3,439,5,2345,0,50
2273,239,3,440,9,2354,0,90
2274,239,3,441,6,2360,0,60
2275,239,3,442,9,2369,0,90
2276,239,3,443,3,2372,0,30
2277,239,3,444,7,2379,0,70
2278,239,3,445,8,2387,33,80
2279,239,3,446,9,2396,2,90
2280,239,3,447,2,2398,0,20
2281,239,3,448,4,2402,0,40
2282,239,3,449,8,2410,0,80
2283,239,3,450,5,2415,0,50
2284,239,3,451,5,2420,0,50
2285,239,3,452,7,2427,0,70
2286,239,3,453,4,2431,20,40
2287,239,3,454,2,2433,1,20
2288,239,3,455,6,2439,0,60
2289,239,3,456,2,2441,4,20
2290,239,3,457,4,2445,0,40
2291,239,3,458,4,2449,0,40
2292,239,3,459,7,2456,0,70
2293,239,3,460,7,2463,12,70
2294,239,3,461,8,2471,9,80
2295,239,3,462,5,2476,0,50
2296,239,3,463,2,2478,0,20
2297,239,3,464,2,2480,5,20
2298,239,3,465,7,2487,0,70
2299,239,3,466,8,2495,7,80
2300,239,3,467,2,2497,0,20
2301,239,3,468,7,2504,5,70
2302,239,3,469,6,2510,0,60
2303,239,3,470,9,2519,0,90
2304,239,3,471,2,2521,6,20
2305,239,3,472,8,2529,2,80
2306,239,3,473,7,2536,0,70
2307,239,3,474,9,2545,10,90
2308,239,3,475,5,2550,0,50
2309,239,3,476,3,2553,0,30
2310,239,3,477,4,2557,6,40
2311,239,3,478,4,2561,0,40
2312,239,3,479,4,2565,0,40
2313,239,3,480,5,2570,0,50
2314,239,3,481,4,2574,0,40
2315,239,3,482,7,2581,10,70
2316,239,3,483,9,2590,4,90
2317,239,3,484,3,2593,0,30
2318,239,3,485,7,2600,0,70
2319,239,3,486,9,2609,9,90
2320,239,3,487,5,2614,0,50
2321,239,3,488,7,2621,8,70
2322,239,3,489,2,2623,0,20
2323,239,3,490,7,2630,0,70
2324,239,3,491,7,2637,0,70
2325,239,3,492,2,2639,0,20
2326,239,3,493,4,2643,0,40
2327,239,3,494,8,2651,14,80
2328,239,3,495,6,2657,0,60
2329,239,3,496,6,2663,0,60
2330,239,3,497,2,2665,0,20
2331,239,3,498,8,2673,13,80
2332,239,3,499,9,2682,0,90
2333,239,3,500,3,2685,4,30
2334,239,3,501,9,2694,0,90
2335,239,3,502,6,2700,10,60
2336,239,3,503,4,2704,0,40
2337,239,3,504,6,2710,0,60
2338,239,3,505,8,2718,0,80
2339,239,3,506,7,2725,0,70
2340,239,3,507,9,2734,0,90
2341,239,3,508,9,2743,16,90
2342,239,3,509,6,2749,0,60
2343,239,3,510,8,2757,8,80
2344,239,3,511,7,2764,0,70
2345,239,3,512,2,2766,6,20
2346,239,3,513,7,2773,0,70
2347,239,3,514,2,2775,0,20
2348,239,3,515,8,2783,4,80
2349,239,3,516,5,2788,1,50
2350,239,3,517,9,2797,2,90
2351,239,3,518,4,2801,0,40
2352,239,3,519,6,2807,0,60
2353,239,3,520,9,2816,0,90
2354,239,3,521,4,2820,0,40
2355,239,3,522,4,2824,0,40
2356,239,3,523,9,2833,18,90
2357,239,3,524,9,2842,0,90
2358,239,3,525,4,2846,8,40
2359,239,3,526,5,2851,0,50
2360,239,3,527,3,2854,0,30
2361,239,3,528,9,2863,0,90
2362,239,3,529,5,2868,9,50
2363,239,3,530,8,2876,0,80
2364,239,3,531,9,2885,0,90
2365,239,3,532,9,2894,0,90
2366,239,3,533,5,2899,0,50
2367,239,3,534,7,2906,0,70
2368,239,3,535,4,2910,0,40
2369,239,3,536,6,2916,0,60
2370,239,3,537,6,2922,22,60
2371,239,3,538,8,2930,0,80
2372,239,3,539,8,2938,0,80
2373,239,3,540,7,2945,12,70
2374,239,3,541,8,2953,3,80
2375,239,3,542,4,2957,1,40
2376,239,3,543,6,2963,0,60
2377,239,3,544,3,2966,0,30
2378,239,3,545,8,2974,0,80
2379,239,3,546,9,2983,0,90
2380,239,3,547,3,2986,0,30
2381,239,3,548,3,2989,0,30
2382,239,3,549,8,2997,0,80
2383,239,3,550,2,2999,0,20
2384,239,3,551,5,3004,0,50
2385,239,3,552,4,3008,0,40
2386,239,3,553,6,3014,0,60
2387,239,3,554,7,3021,0,70
2388,239,3,555,2,3023,0,20
2389,239,3,556,5,3028,27,50
2390,239,3,557,7,3035,0,70
2391,239,3,558,9,3044,8,90
2392,239,3,559,9,3053,0,90
2393,239,3,560,3,3056,9,30
2394,239,3,561,7,3063,0,70
2395,239,3,562,5,3068,0,50
2396,239,3,563,2,3070,5,20
2397,239,3,564,6,3076,3,60
2398,239,3,565,4,3080,2,40
2399,239,3,566,7,3087,0,70
2400,239,3,567,2,3089,0,20
2401,239,3,568,2,3091,0,20
2402,239,3,569,4,3095,6,40
2403,239,3,570,6,3101,0,60
2404,239,3,571,5,3106,0,50
2405,239,3,572,7,3113,0,70
2406,239,3,573,5,3118,12,50
2407,239,3,574,2,3120,0,20
2408,239,3,575,5,3125,2,50
2409,239,3,576,9,3134,3,90
2410,239,3,577,8,3142,0,80
2411,239,3,578,7,3149,0,70
2412,239,3,579,8,3157,0,80
2413,239,3,580,7,3164,0,70
2414,239,3,581,6,3170,0,60
2415,239,3,582,8,3178,0,80
2416,239,3,583,9,3187,0,90
2417,239,3,584,8,3195,0,80
2418,239,3,585,2,3197,18,20
2419,239,3,586,4,3201,1,40
2420,239,3,587,7,3208,3,70
2421,239,3,588,5,3213,0,50
2422,239,3,589,8,3221,0,80
2423,239,3,590,9,3230,0,90
2424,239,3,591,3,3233,0,30
2425,239,3,592,5,3238,14,50
2426,239,3,593,3,3241,0,30
2427,239,3,594,5,3246,2,50
2428,239,3,595,4,3250,0,40
2429,239,3,596,4,3254,5,40
2430,239,3,597,5,3259,3,50
2431,239,3,598,2,3261,0,20
2432,239,3,599,2,3263,0,20
2433,239,3,600,5,3268,0,50
2434,239,3,601,8,3276,0,80
2435,239,3,602,8,3284,12,80
2436,239,3,603,3,3287,0,30
2437,239,3,604,8,3295,0,80
2438,239,3,605,4,3299,0,40
2439,239,3,606,9,3308,0,90
2440,239,3,607,7,3315,10,70
2441,239,3,608,8,3323,0,80
2442,239,3,609,2,3325,0,20
2443,239,3,610,4,3329,0,40
2444,239,3,611,4,3333,0,40
2445,239,3,612,5,3338,13,50
2446,239,3,613,5,3343,0,50
2447,239,3,614,5,3348,0,50
2448,239,3,615,9,3357,0,90
2449,239,3,616,3,3360,0,30
2450,239,3,617,4,3364,0,40
2451,239,3,618,5,3369,0,50
2452,239,3,619,5,3374,0,50
2453,239,3,620,3,3377,23,30
2454,239,3,621,3,3380,0,30
2455,239,3,622,8,3388,0,80
2456,239,3,623,8,3396,9,80
2457,239,3,624,6,3402,0,60
2458,239,3,625,2,3404,0,20
2459,239,3,626,4,3408,0,40
2460,239,3,627,6,3414,0,60
2461,239,3,628,7,3421,0,70
2462,239,3,629,6,3427,11,60
2463,239,3,630,8,3435,3,80
2464,239,3,631,5,3440,0,50
2465,239,3,632,7,3447,0,70
2466,239,3,633,2,3449,0,20
2467,239,3,634,6,3455,13,60
2468,239,3,635,7,3462,0,70
2469,239,3,636,4,3466,0,40
2470,239,3,637,2,3468,9,20
2471,239,3,638,9,3477,2,90
2472,239,3,639,5,3482,3,50
2473,239,3,640,6,3488,0,60
2474,239,3,641,7,3495,0,70
2475,239,3,642,4,3499,9,40
2476,239,3,643,6,3505,0,60
2477,239,3,644,7,3512,0,70
2478,239,3,645,3,3515,0,30
2479,239,3,646,7,3522,5,70
2480,239,3,647,6,3528,0,60
2481,239,3,648,3,3531,4,30
2482,239,3,649,8,3539,2,80
2483,239,3,650,9,3548,2,90
2484,239,3,651,2,3550,0,20
2485,239,3,652,9,3559,5,90
2486,239,3,653,7,3566,0,70
2487,239,3,654,2,3568,0,20
2488,239,3,655,7,3575,8,70
2489,239,3,656,3,3578,4,30
2490,239,3,657,2,3580,0,20
2491,239,3,658,2,3582,0,20
2492,239,3,659,3,3585,0,30
2493,239,3,660,3,3588,0,30
2494,239,3,661,2,3590,10,20
2495,239,3,662,4,3594,0,40
2496,239,3,663,6,3600,0,60
2497,239,3,664,8,3608,0,80
2498,239,3,665,8,3616,0,80
2499,239,3,666,3,3619,0,30
2500,239,3,667,5,3624,11,50
2501,239,3,668,7,3631,0,70
2502,239,3,669,6,3637,0,60
2503,239,3,670,9,3646,0,90
2504,239,3,671,3,3649,13,30
2505,239,3,672,8,3657,0,80
2506,239,3,673,9,3666,10,90
2507,239,3,674,5,3671,3,50
2508,239,3,675,6,3677,0,60
2509,239,3,676,7,3684,0,70
2510,239,3,677,8,3692,0,80
2511,239,3,678,5,3697,0,50
2512,239,3,679,7,3704,0,70
2513,239,3,680,5,3709,30,50
2514,239,3,681,2,3711,2,20
2515,239,3,682,5,3716,4,50
2516,239,3,683,7,3723,0,70
2517,239,3,684,9,3732,0,90
2518,239,3,685,7,3739,0,70
2519,239,3,686,7,3746,9,70
2520,239,3,687,4,3750,0,40
2521,239,3,688,7,3757,0,70
2522,239,3,689,2,3759,0,20
2523,239,3,690,2,3761,0,20
2524,239,3,691,5,3766,17,50
2525,239,3,692,2,3768,0,20
2526,239,3,693,7,3775,0,70
2527,239,3,694,7,3782,0,70
2528,239,3,695,4,3786,0,40
2529,239,3,696,9,3795,13,90
2530,239,3,697,3,3798,0,30
2531,239,3,698,2,3800,0,20
2532,239,3,699,8,3808,0,80
2533,239,3,700,2,3810,0,20
2534,239,3,701,2,3812,0,20
2535,239,3,702,3,3815,0,30
2536,239,3,703,8,3823,10,80
2537,239,3,704,9,3832,5,90
2538,239,3,705,4,3836,3,40
2539,239,3,706,5,3841,0,50
2540,239,3,707,6,3847,0,60
2541,239,3,708,5,3852,9,50
2542,239,3,709,8,3860,2,80
2543,239,3,710,8,3868,0,80
2544,239,3,711,4,3872,0,40
2545,239,3,712,5,3877,8,50
2546,239,3,713,2,3879,0,20
2547,239,3,714,4,3883,0,40
2548,239,3,715,6,3889,7,60
2549,239,3,716,6,3895,0,60
2550,239,3,717,3,3898,1,30
2551,239,3,718,8,3906,2,80
2552,239,3,719,6,3912,0,60
2553,239,3,720,9,3921,8,90
2554,239,3,721,9,3930,0,90
2555,239,3,722,9,3939,0,90
2556,239,3,723,8,3947,9,80
2557,239,3,724,6,3953,0,60
2558,239,3,725,6,3959,0,60
2559,239,3,726,8,3967,0,80
2560,239,3,727,4,3971,0,40
2561,239,3,728,3,3974,18,30
2562,239,3,729,7,3981,0,70
2563,239,3,730,3,3984,0,30
2564,239,3,731,7,3991,0,70
2565,239,3,732,8,3999,0,80
2566,239,3,733,2,4001,0,20
2567,239,3,734,3,4004,13,30
2568,239,3,735,9,4013,0,90
2569,239,3,736,7,4020,0,70
2570,239,3,737,9,4029,10,90
2571,239,3,738,5,4034,0,50
2572,239,3,739,9,4043,1,90
2573,239,3,740,5,4048,2,50
2574,239,3,741,8,4056,3,80
2575,239,3,742,9,4065,0,90
2576,239,3,743,4,4069,0,40
2577,239,3,744,5,4074,0,50
2578,239,3,745,6,4080,6,60
2579,239,3,746,7,4087,1,70
2580,239,3,747,4,4091,1,40
2581,239,3,748,6,4097,2,60
2582,239,3,749,2,4099,0,20
2583,239,3,750,8,4107,8,80
2584,239,3,751,3,4110,0,30
2585,239,3,752,4,4114,0,40
2586,239,3,753,5,4119,0,50
2587,239,3,754,3,4122,2,30
2588,239,3,755,9,4131,2,90
2589,239,3,756,2,4133,0,20
2590,239,3,757,7,4140,0,70
2591,239,3,758,4,4144,9,40
2592,239,3,759,2,4146,0,20
2593,239,3,760,5,4151,5,50
2594,239,3,761,4,4155,0,40
2595,239,3,762,8,4163,0,80
2596,239,3,763,4,4167,0,40
2597,239,3,764,7,4174,6,70
2598,239,3,765,5,4179,3,50
2599,239,3,766,4,4183,1,40
2600,239,3,767,9,4192,0,90
2601,239,3,768,5,4197,3,50
2602,239,3,769,5,4202,3,50
2603,239,3,770,4,4206,0,40
2604,239,3,771,9,4215,4,90
2605,239,3,772,7,4222,2,70
2606,239,3,773,4,4226,0,40
2607,239,3,774,7,4233,0,70
2608,239,3,775,5,4238,3,50
2609,239,3,776,7,4245,5,70
2610,239,3,777,6,4251,2,60
2611,239,3,778,8,4259,0,80
2612,239,3,779,4,4263,7,40
2613,239,3,780,8,4271,3,80
2614,239,3,781,4,4275,0,40
2615,239,3,782,4,4279,5,40
2616,239,3,783,3,4282,0,30
2617,239,3,784,5,4287,5,50
2618,239,3,785,4,4291,0,40
2619,239,3,786,8,4299,0,80
2620,239,3,787,7,4306,0,70
2621,239,3,788,8,4314,15,80
2622,239,3,789,6,4320,3,60
2623,239,3,790,4,4324,3,40
2624,239,3,791,2,4326,0,20
2625,239,3,792,6,4332,4,60
2626,239,3,793,3,4335,2,30
2627,239,3,794,7,4342,0,70
2628,239,3,795,5,4347,0,50
2629,239,3,796,8,4355,0,80
2630,239,3,797,2,4357,0,20
2631,239,3,798,3,4360,0,30
2632,239,3,799,5,4365,0,50
2633,239,3,800,9,4374,18,90
2634,239,3,801,7,4381,5,70
2635,239,3,802,3,4384,2,30
2636,239,3,803,8,4392,0,80
2637,239,3,804,9,4401,6,90
2638,239,3,805,5,4406,0,50
2639,239,3,806,5,4411,0,50
2640,239,3,807,9,4420,0,90
2641,239,3,808,7,4427,0,70
2642,239,3,809,2,4429,0,20
2643,239,3,810,5,4434,0,50
2644,239,3,811,8,4442,0,80
2645,239,3,812,5,4447,0,50
2646,239,3,813,5,4452,0,50
2647,239,3,814,2,4454,0,20
2648,239,3,815,2,4456,0,20
2649,239,3,816,9,4465,0,90
2650,239,3,817,3,4468,32,30
2651,239,3,818,3,4471,0,30
2652,239,3,819,5,4476,0,50
2653,239,3,820,7,4483,0,70
2654,239,3,821,9,4492,0,90
2655,239,3,822,6,4498,0,60
2656,239,3,823,3,4501,13,30
2657,239,3,824,9,4510,0,90
2658,239,3,825,7,4517,0,70
2659,239,3,826,7,4524,9,70
2660,239,3,827,5,4529,0,50
2661,239,3,828,2,4531,5,20
2662,239,3,829,9,4540,7,90
2663,239,3,830,9,4549,4,90
2664,239,3,831,8,4557,0,80
2665,239,3,832,2,4559,3,20
2666,239,3,833,6,4565,2,60
2667,239,3,834,2,4567,1,20
2668,239,3,835,2,4569,0,20
2669,239,3,836,4,4573,0,40
2670,239,3,837,2,4575,0,20
2671,239,3,838,6,4581,0,60
2672,239,3,839,2,4583,0,20
2673,239,3,840,6,4589,0,60
2674,239,3,841,8,4597,7,80
2675,239,3,842,3,4600,2,30
2676,239,3,843,5,4605,0,50
2677,239,3,844,6,4611,0,60
2678,239,3,845,6,4617,0,60
2679,239,3,846,7,4624,0,70
2680,239,3,847,2,4626,0,20
2681,239,3,848,2,4628,0,20
2682,239,3,849,7,4635,12,70
2683,239,3,850,8,4643,0,80
2684,239,3,851,3,4646,0,30
2685,239,3,852,9,4655,0,90
2686,239,3,853,2,4657,0,20
2687,239,3,854,7,4664,0,70
2688,239,3,855,3,4667,0,30
2689,239,3,856,6,4673,20,60
2690,239,3,857,5,4678,0,50
2691,239,3,858,8,4686,0,80
2692,239,3,859,9,4695,0,90
2693,239,3,860,2,4697,7,20
2694,239,3,861,5,4702,0,50
2695,239,3,862,3,4705,3,30
2696,239,3,863,4,4709,4,40
2697,239,3,864,6,4715,5,60
2698,239,3,865,4,4719,0,40
2699,239,3,866,9,4728,9,90
2700,239,3,867,5,4733,3,50
2701,239,3,868,6,4739,5,60
2702,239,3,869,4,4743,2,40
2703,239,3,870,9,4752,0,90
2704,239,3,871,6,4758,0,60
2705,239,3,872,4,4762,0,40
2706,239,3,873,9,4771,0,90
2707,239,3,874,3,4774,13,30
2708,239,3,875,9,4783,0,90
2709,239,3,876,3,4786,6,30
2710,239,3,877,2,4788,0,20
2711,239,3,878,2,4790,0,20
2712,239,3,879,4,4794,0,40
2713,239,3,880,3,4797,0,30
2714,239,3,881,6,4803,0,60
2715,239,3,882,4,4807,10,40
2716,239,3,883,5,4812,0,50
2717,239,3,884,9,4821,0,90
2718,239,3,885,4,4825,6,40
2719,239,3,886,2,4827,2,20
2720,239,3,887,7,4834,1,70
2721,239,3,888,4,4838,0,40
2722,239,3,889,2,4840,0,20
2723,239,3,890,2,4842,0,20
2724,239,3,891,9,4851,0,90
2725,239,3,892,3,4854,0,30
2726,239,3,893,7,4861,8,70
2727,239,3,894,2,4863,0,20
2728,239,3,895,7,4870,8,70
2729,239,3,896,2,4872,0,20
2730,239,3,897,4,4876,2,40
2731,239,3,898,4,4880,4,40
2732,239,3,899,3,4883,0,30
2733,239,3,900,5,4888,0,50
2734,239,3,901,6,4894,0,60
2735,239,3,902,7,4901,0,70
2736,239,3,903,2,4903,11,20
2737,239,3,904,4,4907,0,40
2738,239,3,905,2,4909,0,20
2739,239,3,906,5,4914,6,50
2740,239,3,907,3,4917,1,30
2741,239,3,908,9,4926,7,90
2742,239,3,909,2,4928,0,20
2743,239,3,910,5,4933,0,50
2744,239,3,911,7,4940,7,70
2745,239,3,912,5,4945,4,50
2746,239,3,913,4,4949,0,40
2747,239,3,914,9,4958,0,90
2748,239,3,915,9,4967,11,90
2749,239,3,916,8,4975,0,80
2750,239,3,917,5,4980,4,50
2751,239,3,918,8,4988,0,80
2752,239,3,919,7,4995,0,70
