,Scenario,Trial,Inspection,Interval,Time,Defects,Rate
0,356,1,1,2,2,0,20
1,356,1,2,9,11,0,90
2,356,1,3,3,14,0,30
3,356,1,4,9,23,0,90
4,356,1,5,6,29,0,60
5,356,1,6,4,33,0,40
6,356,1,7,8,41,0,80
7,356,1,8,5,46,0,50
8,356,1,9,5,51,0,50
9,356,1,10,3,54,0,30
10,356,1,11,6,60,0,60
11,356,1,12,5,65,0,50
12,356,1,13,7,72,0,70
13,356,1,14,2,74,0,20
14,356,1,15,7,81,0,70
15,356,1,16,4,85,0,40
16,356,1,17,2,87,0,20
17,356,1,18,2,89,0,20
18,356,1,19,9,98,0,90
19,356,1,20,2,100,0,20
20,356,1,21,9,109,0,90
21,356,1,22,9,118,0,90
22,356,1,23,3,121,56,30
23,356,1,24,7,128,0,70
24,356,1,25,2,130,0,20
25,356,1,26,9,139,0,90
26,356,1,27,9,148,0,90
27,356,1,28,9,157,0,90
28,356,1,29,3,160,0,30
29,356,1,30,2,162,0,20
30,356,1,31,8,170,0,80
31,356,1,32,8,178,0,80
32,356,1,33,3,181,0,30
33,356,1,34,9,190,0,90
34,356,1,35,9,199,0,90
35,356,1,36,2,201,0,20
36,356,1,37,6,207,0,60
37,356,1,38,5,212,0,50
38,356,1,39,8,220,0,80
39,356,1,40,6,226,0,60
40,356,1,41,5,231,0,50
41,356,1,42,3,234,0,30
42,356,1,43,8,242,0,80
43,356,1,44,3,245,0,30
44,356,1,45,5,250,0,50
45,356,1,46,8,258,0,80
46,356,1,47,6,264,0,60
47,356,1,48,4,268,0,40
48,356,1,49,7,275,0,70
49,356,1,50,5,280,0,50
50,356,1,51,2,282,0,20
51,356,1,52,3,285,0,30
52,356,1,53,2,287,0,20
53,356,1,54,6,293,0,60
54,356,1,55,7,300,0,70
55,356,1,56,4,304,0,40
56,356,1,57,3,307,0,30
57,356,1,58,6,313,0,60
58,356,1,59,7,320,0,70
59,356,1,60,6,326,0,60
60,356,1,61,6,332,0,60
61,356,1,62,6,338,0,60
62,356,1,63,7,345,0,70
63,356,1,64,4,349,0,40
64,356,1,65,4,353,0,40
65,356,1,66,2,355,0,20
66,356,1,67,4,359,0,40
67,356,1,68,6,365,0,60
68,356,1,69,6,371,0,60
69,356,1,70,8,379,0,80
70,356,1,71,9,388,0,90
71,356,1,72,2,390,0,20
72,356,1,73,5,395,0,50
73,356,1,74,8,403,131,80
74,356,1,75,5,408,0,50
75,356,1,76,8,416,0,80
76,356,1,77,8,424,0,80
77,356,1,78,3,427,0,30
78,356,1,79,4,431,0,40
79,356,1,80,8,439,0,80
80,356,1,81,3,442,21,30
81,356,1,82,9,451,0,90
82,356,1,83,7,458,0,70
83,356,1,84,8,466,0,80
84,356,1,85,4,470,0,40
85,356,1,86,2,472,0,20
86,356,1,87,8,480,0,80
87,356,1,88,9,489,0,90
88,356,1,89,2,491,0,20
89,356,1,90,6,497,0,60
90,356,1,91,2,499,0,20
91,356,1,92,4,503,0,40
92,356,1,93,2,505,0,20
93,356,1,94,2,507,0,20
94,356,1,95,5,512,0,50
95,356,1,96,4,516,0,40
96,356,1,97,4,520,0,40
97,356,1,98,9,529,0,90
98,356,1,99,5,534,0,50
99,356,1,100,5,539,0,50
100,356,1,101,3,542,0,30
101,356,1,102,5,547,0,50
102,356,1,103,4,551,0,40
103,356,1,104,6,557,0,60
104,356,1,105,4,561,0,40
105,356,1,106,2,563,0,20
106,356,1,107,7,570,0,70
107,356,1,108,8,578,0,80
108,356,1,109,3,581,0,30
109,356,1,110,8,589,0,80
110,356,1,111,2,591,0,20
111,356,1,112,3,594,0,30
112,356,1,113,5,599,0,50
113,356,1,114,8,607,0,80
114,356,1,115,7,614,0,70
115,356,1,116,8,622,0,80
116,356,1,117,3,625,0,30
117,356,1,118,3,628,0,30
118,356,1,119,4,632,0,40
119,356,1,120,4,636,0,40
120,356,1,121,4,640,0,40
121,356,1,122,7,647,0,70
122,356,1,123,3,650,0,30
123,356,1,124,3,653,0,30
124,356,1,125,2,655,0,20
125,356,1,126,4,659,0,40
126,356,1,127,8,667,0,80
127,356,1,128,9,676,0,90
128,356,1,129,2,678,0,20
129,356,1,130,7,685,0,70
130,356,1,131,9,694,0,90
131,356,1,132,3,697,0,30
132,356,1,133,3,700,0,30
133,356,1,134,4,704,0,40
134,356,1,135,7,711,0,70
135,356,1,136,4,715,0,40
136,356,1,137,4,719,0,40
137,356,1,138,5,724,0,50
138,356,1,139,5,729,0,50
139,356,1,140,5,734,0,50
140,356,1,141,2,736,0,20
141,356,1,142,9,745,0,90
142,356,1,143,7,752,0,70
143,356,1,144,3,755,0,30
144,356,1,145,5,760,0,50
145,356,1,146,2,762,0,20
146,356,1,147,8,770,191,80
147,356,1,148,8,778,0,80
148,356,1,149,7,785,0,70
149,356,1,150,9,794,0,90
150,356,1,151,4,798,0,40
151,356,1,152,7,805,0,70
152,356,1,153,9,814,0,90
153,356,1,154,8,822,28,80
154,356,1,155,9,831,0,90
155,356,1,156,7,838,0,70
156,356,1,157,7,845,0,70
157,356,1,158,4,849,0,40
158,356,1,159,3,852,0,30
159,356,1,160,7,859,0,70
160,356,1,161,2,861,0,20
161,356,1,162,5,866,0,50
162,356,1,163,2,868,0,20
163,356,1,164,7,875,0,70
164,356,1,165,4,879,0,40
165,356,1,166,3,882,0,30
166,356,1,167,5,887,0,50
167,356,1,168,6,893,0,60
168,356,1,169,7,900,0,70
169,356,1,170,3,903,0,30
170,356,1,171,9,912,0,90
171,356,1,172,7,919,0,70
172,356,1,173,7,926,0,70
173,356,1,174,2,928,0,20
174,356,1,175,4,932,0,40
175,356,1,176,7,939,0,70
176,356,1,177,8,947,0,80
177,356,1,178,3,950,0,30
178,356,1,179,9,959,0,90
179,356,1,180,6,965,0,60
180,356,1,181,8,973,0,80
181,356,1,182,2,975,0,20
182,356,1,183,8,983,0,80
183,356,1,184,6,989,0,60
184,356,1,185,6,995,0,60
185,356,1,186,5,1000,0,50
186,356,1,187,6,1006,0,60
187,356,1,188,9,1015,0,90
188,356,1,189,7,1022,0,70
189,356,1,190,8,1030,0,80
190,356,1,191,8,1038,0,80
191,356,1,192,9,1047,0,90
192,356,1,193,7,1054,0,70
193,356,1,194,8,1062,0,80
194,356,1,195,7,1069,0,70
195,356,1,196,5,1074,0,50
196,356,1,197,9,1083,0,90
197,356,1,198,4,1087,0,40
198,356,1,199,9,1096,0,90
199,356,1,200,3,1099,0,30
200,356,1,201,5,1104,0,50
201,356,1,202,2,1106,0,20
202,356,1,203,9,1115,0,90
203,356,1,204,7,1122,0,70
204,356,1,205,5,1127,0,50
205,356,1,206,3,1130,0,30
206,356,1,207,6,1136,0,60
207,356,1,208,9,1145,0,90
208,356,1,209,9,1154,0,90
209,356,1,210,6,1160,0,60
210,356,1,211,2,1162,0,20
211,356,1,212,9,1171,0,90
212,356,1,213,4,1175,0,40
213,356,1,214,5,1180,0,50
214,356,1,215,6,1186,0,60
215,356,1,216,9,1195,0,90
216,356,1,217,5,1200,0,50
217,356,1,218,6,1206,0,60
218,356,1,219,6,1212,0,60
219,356,1,220,8,1220,213,80
220,356,1,221,5,1225,0,50
221,356,1,222,6,1231,0,60
222,356,1,223,8,1239,0,80
223,356,1,224,3,1242,0,30
224,356,1,225,6,1248,0,60
225,356,1,226,5,1253,0,50
226,356,1,227,7,1260,0,70
227,356,1,228,7,1267,0,70
228,356,1,229,6,1273,0,60
229,356,1,230,2,1275,0,20
230,356,1,231,4,1279,0,40
231,356,1,232,4,1283,0,40
232,356,1,233,5,1288,0,50
233,356,1,234,5,1293,40,50
234,356,1,235,2,1295,0,20
235,356,1,236,9,1304,0,90
236,356,1,237,9,1313,0,90
237,356,1,238,9,1322,0,90
238,356,1,239,2,1324,0,20
239,356,1,240,5,1329,0,50
240,356,1,241,5,1334,15,50
241,356,1,242,8,1342,0,80
242,356,1,243,5,1347,0,50
243,356,1,244,7,1354,0,70
244,356,1,245,7,1361,0,70
245,356,1,246,5,1366,0,50
246,356,1,247,8,1374,0,80
247,356,1,248,5,1379,0,50
248,356,1,249,8,1387,0,80
249,356,1,250,6,1393,0,60
250,356,1,251,5,1398,0,50
251,356,1,252,9,1407,0,90
252,356,1,253,7,1414,0,70
253,356,1,254,7,1421,0,70
254,356,1,255,9,1430,0,90
255,356,1,256,9,1439,0,90
256,356,1,257,5,1444,0,50
257,356,1,258,5,1449,0,50
258,356,1,259,9,1458,0,90
259,356,1,260,3,1461,0,30
260,356,1,261,2,1463,0,20
261,356,1,262,5,1468,0,50
262,356,1,263,6,1474,0,60
263,356,1,264,3,1477,0,30
264,356,1,265,5,1482,0,50
265,356,1,266,8,1490,0,80
266,356,1,267,3,1493,0,30
267,356,1,268,2,1495,79,20
268,356,1,269,6,1501,0,60
269,356,1,270,8,1509,0,80
270,356,1,271,8,1517,0,80
271,356,1,272,9,1526,0,90
272,356,1,273,8,1534,0,80
273,356,1,274,9,1543,0,90
274,356,1,275,4,1547,0,40
275,356,1,276,9,1556,0,90
276,356,1,277,9,1565,0,90
277,356,1,278,9,1574,0,90
278,356,1,279,7,1581,0,70
279,356,1,280,3,1584,0,30
280,356,1,281,2,1586,0,20
281,356,1,282,9,1595,0,90
282,356,1,283,2,1597,0,20
283,356,1,284,5,1602,0,50
284,356,1,285,2,1604,0,20
285,356,1,286,7,1611,0,70
286,356,1,287,9,1620,0,90
287,356,1,288,3,1623,0,30
288,356,1,289,3,1626,0,30
289,356,1,290,3,1629,0,30
290,356,1,291,8,1637,0,80
291,356,1,292,3,1640,0,30
292,356,1,293,4,1644,0,40
293,356,1,294,2,1646,0,20
294,356,1,295,7,1653,0,70
295,356,1,296,7,1660,0,70
296,356,1,297,5,1665,0,50
297,356,1,298,5,1670,0,50
298,356,1,299,2,1672,0,20
299,356,1,300,4,1676,0,40
300,356,1,301,9,1685,0,90
301,356,1,302,7,1692,0,70
302,356,1,303,4,1696,0,40
303,356,1,304,7,1703,0,70
304,356,1,305,2,1705,0,20
305,356,1,306,2,1707,0,20
306,356,1,307,5,1712,0,50
307,356,1,308,6,1718,0,60
308,356,1,309,3,1721,0,30
309,356,1,310,7,1728,0,70
310,356,1,311,4,1732,0,40
311,356,1,312,8,1740,0,80
312,356,1,313,7,1747,0,70
313,356,1,314,5,1752,0,50
314,356,1,315,6,1758,0,60
315,356,1,316,7,1765,132,70
316,356,1,317,6,1771,0,60
317,356,1,318,6,1777,0,60
318,356,1,319,8,1785,0,80
319,356,1,320,9,1794,0,90
320,356,1,321,3,1797,0,30
321,356,1,322,8,1805,0,80
322,356,1,323,2,1807,0,20
323,356,1,324,7,1814,0,70
324,356,1,325,5,1819,0,50
325,356,1,326,3,1822,0,30
326,356,1,327,2,1824,0,20
327,356,1,328,4,1828,0,40
328,356,1,329,6,1834,0,60
329,356,1,330,6,1840,0,60
330,356,1,331,2,1842,36,20
331,356,1,332,3,1845,0,30
332,356,1,333,9,1854,0,90
333,356,1,334,5,1859,0,50
334,356,1,335,4,1863,0,40
335,356,1,336,4,1867,0,40
336,356,1,337,8,1875,0,80
337,356,1,338,8,1883,0,80
338,356,1,339,2,1885,0,20
339,356,1,340,5,1890,0,50
340,356,1,341,7,1897,0,70
341,356,1,342,5,1902,0,50
342,356,1,343,2,1904,0,20
343,356,1,344,6,1910,0,60
344,356,1,345,8,1918,0,80
345,356,1,346,5,1923,0,50
346,356,1,347,4,1927,0,40
347,356,1,348,6,1933,0,60
348,356,1,349,7,1940,0,70
349,356,1,350,7,1947,0,70
350,356,1,351,4,1951,0,40
351,356,1,352,5,1956,0,50
352,356,1,353,7,1963,62,70
353,356,1,354,5,1968,0,50
354,356,1,355,3,1971,0,30
355,356,1,356,3,1974,0,30
356,356,1,357,7,1981,0,70
357,356,1,358,3,1984,0,30
358,356,1,359,8,1992,0,80
359,356,1,360,6,1998,0,60
360,356,1,361,7,2005,0,70
361,356,1,362,2,2007,0,20
362,356,1,363,4,2011,0,40
363,356,1,364,9,2020,0,90
364,356,1,365,5,2025,0,50
365,356,1,366,4,2029,0,40
366,356,1,367,4,2033,0,40
367,356,1,368,8,2041,0,80
368,356,1,369,7,2048,0,70
369,356,1,370,4,2052,0,40
370,356,1,371,4,2056,0,40
371,356,1,372,9,2065,0,90
372,356,1,373,3,2068,0,30
373,356,1,374,9,2077,0,90
374,356,1,375,8,2085,0,80
375,356,1,376,8,2093,0,80
376,356,1,377,6,2099,0,60
377,356,1,378,5,2104,0,50
378,356,1,379,7,2111,0,70
379,356,1,380,9,2120,0,90
380,356,1,381,2,2122,0,20
381,356,1,382,4,2126,0,40
382,356,1,383,8,2134,0,80
383,356,1,384,2,2136,0,20
384,356,1,385,7,2143,0,70
385,356,1,386,2,2145,0,20
386,356,1,387,4,2149,0,40
387,356,1,388,8,2157,0,80
388,356,1,389,9,2166,0,90
389,356,1,390,4,2170,104,40
390,356,1,391,5,2175,0,50
391,356,1,392,3,2178,0,30
392,356,1,393,3,2181,0,30
393,356,1,394,6,2187,0,60
394,356,1,395,2,2189,0,20
395,356,1,396,5,2194,0,50
396,356,1,397,5,2199,17,50
397,356,1,398,4,2203,0,40
398,356,1,399,2,2205,0,20
399,356,1,400,5,2210,0,50
400,356,1,401,7,2217,0,70
401,356,1,402,3,2220,0,30
402,356,1,403,7,2227,0,70
403,356,1,404,8,2235,0,80
404,356,1,405,8,2243,0,80
405,356,1,406,5,2248,0,50
406,356,1,407,4,2252,0,40
407,356,1,408,3,2255,0,30
408,356,1,409,8,2263,0,80
409,356,1,410,3,2266,34,30
410,356,1,411,9,2275,0,90
411,356,1,412,3,2278,0,30
412,356,1,413,3,2281,0,30
413,356,1,414,5,2286,0,50
414,356,1,415,9,2295,0,90
415,356,1,416,7,2302,0,70
416,356,1,417,7,2309,0,70
417,356,1,418,5,2314,0,50
418,356,1,419,2,2316,0,20
419,356,1,420,7,2323,0,70
420,356,1,421,3,2326,0,30
421,356,1,422,3,2329,0,30
422,356,1,423,9,2338,0,90
423,356,1,424,6,2344,0,60
424,356,1,425,9,2353,0,90
425,356,1,426,5,2358,0,50
426,356,1,427,4,2362,56,40
427,356,1,428,6,2368,0,60
428,356,1,429,4,2372,0,40
429,356,1,430,8,2380,0,80
430,356,1,431,5,2385,0,50
431,356,1,432,4,2389,0,40
432,356,1,433,3,2392,0,30
433,356,1,434,8,2400,0,80
434,356,1,435,9,2409,0,90
435,356,1,436,9,2418,0,90
436,356,1,437,4,2422,0,40
437,356,1,438,9,2431,0,90
438,356,1,439,6,2437,0,60
439,356,1,440,2,2439,0,20
440,356,1,441,3,2442,0,30
441,356,1,442,8,2450,0,80
442,356,1,443,8,2458,0,80
443,356,1,444,6,2464,0,60
444,356,1,445,9,2473,0,90
445,356,1,446,3,2476,0,30
446,356,1,447,3,2479,0,30
447,356,1,448,2,2481,0,20
448,356,1,449,4,2485,0,40
449,356,1,450,5,2490,0,50
450,356,1,451,3,2493,0,30
451,356,1,452,5,2498,0,50
452,356,1,453,3,2501,0,30
453,356,1,454,8,2509,0,80
454,356,1,455,7,2516,0,70
455,356,1,456,6,2522,0,60
456,356,1,457,4,2526,0,40
457,356,1,458,8,2534,0,80
458,356,1,459,3,2537,0,30
459,356,1,460,9,2546,0,90
460,356,1,461,7,2553,0,70
461,356,1,462,9,2562,0,90
462,356,1,463,2,2564,0,20
463,356,1,464,8,2572,92,80
464,356,1,465,3,2575,0,30
465,356,1,466,8,2583,0,80
466,356,1,467,4,2587,0,40
467,356,1,468,6,2593,0,60
468,356,1,469,4,2597,0,40
469,356,1,470,3,2600,0,30
470,356,1,471,7,2607,18,70
471,356,1,472,6,2613,6,60
472,356,1,473,5,2618,0,50
473,356,1,474,6,2624,0,60
474,356,1,475,7,2631,0,70
475,356,1,476,6,2637,0,60
476,356,1,477,7,2644,0,70
477,356,1,478,8,2652,0,80
478,356,1,479,5,2657,0,50
479,356,1,480,5,2662,0,50
480,356,1,481,9,2671,0,90
481,356,1,482,5,2676,0,50
482,356,1,483,4,2680,0,40
483,356,1,484,3,2683,0,30
484,356,1,485,5,2688,0,50
485,356,1,486,9,2697,0,90
486,356,1,487,8,2705,0,80
487,356,1,488,9,2714,0,90
488,356,1,489,9,2723,0,90
489,356,1,490,8,2731,0,80
490,356,1,491,3,2734,0,30
491,356,1,492,2,2736,0,20
492,356,1,493,9,2745,0,90
493,356,1,494,5,2750,0,50
494,356,1,495,2,2752,0,20
495,356,1,496,4,2756,0,40
496,356,1,497,8,2764,0,80
497,356,1,498,2,2766,0,20
498,356,1,499,9,2775,0,90
499,356,1,500,5,2780,0,50
500,356,1,501,8,2788,0,80
501,356,1,502,9,2797,0,90
502,356,1,503,5,2802,0,50
503,356,1,504,6,2808,89,60
504,356,1,505,7,2815,0,70
505,356,1,506,2,2817,0,20
506,356,1,507,7,2824,0,70
507,356,1,508,3,2827,0,30
508,356,1,509,7,2834,0,70
509,356,1,510,7,2841,0,70
510,356,1,511,8,2849,0,80
511,356,1,512,6,2855,0,60
512,356,1,513,7,2862,0,70
513,356,1,514,6,2868,0,60
514,356,1,515,5,2873,0,50
515,356,1,516,2,2875,0,20
516,356,1,517,2,2877,0,20
517,356,1,518,4,2881,0,40
518,356,1,519,7,2888,0,70
519,356,1,520,6,2894,0,60
520,356,1,521,5,2899,44,50
521,356,1,522,3,2902,0,30
522,356,1,523,9,2911,0,90
523,356,1,524,5,2916,0,50
524,356,1,525,4,2920,0,40
525,356,1,526,3,2923,0,30
526,356,1,527,3,2926,0,30
527,356,1,528,8,2934,0,80
528,356,1,529,7,2941,0,70
529,356,1,530,7,2948,0,70
530,356,1,531,3,2951,0,30
531,356,1,532,7,2958,0,70
532,356,1,533,2,2960,0,20
533,356,1,534,8,2968,0,80
534,356,1,535,6,2974,0,60
535,356,1,536,4,2978,0,40
536,356,1,537,7,2985,0,70
537,356,1,538,7,2992,0,70
538,356,1,539,4,2996,0,40
539,356,1,540,3,2999,0,30
540,356,1,541,7,3006,0,70
541,356,1,542,6,3012,0,60
542,356,1,543,6,3018,0,60
543,356,1,544,9,3027,0,90
544,356,1,545,8,3035,0,80
545,356,1,546,8,3043,0,80
546,356,1,547,3,3046,0,30
547,356,1,548,6,3052,77,60
548,356,1,549,7,3059,0,70
549,356,1,550,4,3063,0,40
550,356,1,551,6,3069,0,60
551,356,1,552,3,3072,0,30
552,356,1,553,8,3080,0,80
553,356,1,554,7,3087,0,70
554,356,1,555,5,3092,0,50
555,356,1,556,7,3099,0,70
556,356,1,557,4,3103,0,40
557,356,1,558,7,3110,0,70
558,356,1,559,8,3118,0,80
559,356,1,560,3,3121,0,30
560,356,1,561,5,3126,0,50
561,356,1,562,3,3129,0,30
562,356,1,563,6,3135,0,60
563,356,1,564,5,3140,0,50
564,356,1,565,2,3142,0,20
565,356,1,566,9,3151,0,90
566,356,1,567,6,3157,0,60
567,356,1,568,6,3163,0,60
568,356,1,569,9,3172,0,90
569,356,1,570,7,3179,0,70
570,356,1,571,2,3181,0,20
571,356,1,572,6,3187,0,60
572,356,1,573,8,3195,0,80
573,356,1,574,5,3200,0,50
574,356,1,575,8,3208,0,80
575,356,1,576,3,3211,0,30
576,356,1,577,5,3216,0,50
577,356,1,578,5,3221,0,50
578,356,1,579,5,3226,0,50
579,356,1,580,7,3233,0,70
580,356,1,581,6,3239,0,60
581,356,1,582,6,3245,0,60
582,356,1,583,9,3254,0,90
583,356,1,584,9,3263,0,90
584,356,1,585,8,3271,0,80
585,356,1,586,6,3277,0,60
586,356,1,587,6,3283,0,60
587,356,1,588,4,3287,0,40
588,356,1,589,3,3290,0,30
589,356,1,590,8,3298,0,80
590,356,1,591,7,3305,0,70
591,356,1,592,2,3307,0,20
592,356,1,593,5,3312,0,50
593,356,1,594,8,3320,0,80
594,356,1,595,9,3329,0,90
595,356,1,596,6,3335,0,60
596,356,1,597,6,3341,0,60
597,356,1,598,3,3344,161,30
598,356,1,599,9,3353,0,90
599,356,1,600,4,3357,2,40
600,356,1,601,9,3366,0,90
601,356,1,602,4,3370,0,40
602,356,1,603,9,3379,0,90
603,356,1,604,2,3381,0,20
604,356,1,605,3,3384,0,30
605,356,1,606,5,3389,0,50
606,356,1,607,5,3394,0,50
607,356,1,608,4,3398,0,40
608,356,1,609,8,3406,0,80
609,356,1,610,6,3412,0,60
610,356,1,611,9,3421,0,90
611,356,1,612,9,3430,0,90
612,356,1,613,4,3434,36,40
613,356,1,614,9,3443,0,90
614,356,1,615,8,3451,0,80
615,356,1,616,8,3459,0,80
616,356,1,617,4,3463,0,40
617,356,1,618,5,3468,0,50
618,356,1,619,7,3475,0,70
619,356,1,620,7,3482,0,70
620,356,1,621,2,3484,0,20
621,356,1,622,4,3488,0,40
622,356,1,623,7,3495,0,70
623,356,1,624,8,3503,0,80
624,356,1,625,9,3512,40,90
625,356,1,626,2,3514,0,20
626,356,1,627,4,3518,0,40
627,356,1,628,4,3522,0,40
628,356,1,629,6,3528,0,60
629,356,1,630,7,3535,0,70
630,356,1,631,8,3543,0,80
631,356,1,632,7,3550,0,70
632,356,1,633,2,3552,0,20
633,356,1,634,2,3554,0,20
634,356,1,635,6,3560,0,60
635,356,1,636,2,3562,0,20
636,356,1,637,3,3565,0,30
637,356,1,638,5,3570,0,50
638,356,1,639,3,3573,0,30
639,356,1,640,2,3575,0,20
640,356,1,641,5,3580,0,50
641,356,1,642,2,3582,0,20
642,356,1,643,5,3587,0,50
643,356,1,644,9,3596,0,90
644,356,1,645,2,3598,0,20
645,356,1,646,7,3605,0,70
646,356,1,647,2,3607,0,20
647,356,1,648,7,3614,0,70
648,356,1,649,4,3618,0,40
649,356,1,650,9,3627,0,90
650,356,1,651,2,3629,0,20
651,356,1,652,3,3632,0,30
652,356,1,653,7,3639,0,70
653,356,1,654,2,3641,0,20
654,356,1,655,4,3645,0,40
655,356,1,656,9,3654,0,90
656,356,1,657,2,3656,0,20
657,356,1,658,6,3662,0,60
658,356,1,659,7,3669,0,70
659,356,1,660,7,3676,0,70
660,356,1,661,2,3678,0,20
661,356,1,662,4,3682,90,40
662,356,1,663,8,3690,0,80
663,356,1,664,3,3693,0,30
664,356,1,665,3,3696,0,30
665,356,1,666,6,3702,0,60
666,356,1,667,6,3708,0,60
667,356,1,668,7,3715,0,70
668,356,1,669,7,3722,0,70
669,356,1,670,6,3728,0,60
670,356,1,671,2,3730,0,20
671,356,1,672,2,3732,0,20
672,356,1,673,8,3740,0,80
673,356,1,674,9,3749,0,90
674,356,1,675,9,3758,0,90
675,356,1,676,6,3764,0,60
676,356,1,677,2,3766,0,20
677,356,1,678,4,3770,0,40
678,356,1,679,7,3777,0,70
679,356,1,680,8,3785,0,80
680,356,1,681,2,3787,0,20
681,356,1,682,3,3790,0,30
682,356,1,683,6,3796,0,60
683,356,1,684,8,3804,49,80
684,356,1,685,2,3806,0,20
685,356,1,686,9,3815,0,90
686,356,1,687,7,3822,0,70
687,356,1,688,6,3828,0,60
688,356,1,689,2,3830,0,20
689,356,1,690,5,3835,0,50
690,356,1,691,7,3842,0,70
691,356,1,692,7,3849,0,70
692,356,1,693,5,3854,23,50
693,356,1,694,5,3859,0,50
694,356,1,695,7,3866,0,70
695,356,1,696,7,3873,0,70
696,356,1,697,7,3880,0,70
697,356,1,698,6,3886,0,60
698,356,1,699,5,3891,0,50
699,356,1,700,2,3893,0,20
700,356,1,701,4,3897,0,40
701,356,1,702,3,3900,0,30
702,356,1,703,6,3906,0,60
703,356,1,704,6,3912,0,60
704,356,1,705,6,3918,0,60
705,356,1,706,6,3924,0,60
706,356,1,707,9,3933,0,90
707,356,1,708,3,3936,0,30
708,356,1,709,7,3943,0,70
709,356,1,710,4,3947,0,40
710,356,1,711,6,3953,0,60
711,356,1,712,3,3956,0,30
712,356,1,713,7,3963,0,70
713,356,1,714,9,3972,0,90
714,356,1,715,8,3980,0,80
715,356,1,716,6,3986,0,60
716,356,1,717,6,3992,0,60
717,356,1,718,3,3995,0,30
718,356,1,719,9,4004,0,90
719,356,1,720,7,4011,0,70
720,356,1,721,5,4016,0,50
721,356,1,722,4,4020,0,40
722,356,1,723,5,4025,0,50
723,356,1,724,5,4030,0,50
724,356,1,725,8,4038,0,80
725,356,1,726,2,4040,0,20
726,356,1,727,4,4044,0,40
727,356,1,728,8,4052,0,80
728,356,1,729,2,4054,0,20
729,356,1,730,8,4062,0,80
730,356,1,731,7,4069,0,70
731,356,1,732,2,4071,0,20
732,356,1,733,5,4076,0,50
733,356,1,734,3,4079,0,30
734,356,1,735,9,4088,0,90
735,356,1,736,8,4096,0,80
736,356,1,737,5,4101,0,50
737,356,1,738,8,4109,0,80
738,356,1,739,2,4111,0,20
739,356,1,740,6,4117,0,60
740,356,1,741,9,4126,0,90
741,356,1,742,2,4128,0,20
742,356,1,743,5,4133,0,50
743,356,1,744,3,4136,0,30
744,356,1,745,8,4144,0,80
745,356,1,746,8,4152,0,80
746,356,1,747,4,4156,0,40
747,356,1,748,2,4158,0,20
748,356,1,749,9,4167,0,90
749,356,1,750,9,4176,0,90
750,356,1,751,9,4185,0,90
751,356,1,752,5,4190,0,50
752,356,1,753,2,4192,0,20
753,356,1,754,5,4197,0,50
754,356,1,755,6,4203,0,60
755,356,1,756,3,4206,0,30
756,356,1,757,9,4215,0,90
757,356,1,758,6,4221,0,60
758,356,1,759,7,4228,0,70
759,356,1,760,8,4236,0,80
760,356,1,761,8,4244,0,80
761,356,1,762,7,4251,0,70
762,356,1,763,5,4256,0,50
763,356,1,764,8,4264,0,80
764,356,1,765,6,4270,0,60
765,356,1,766,4,4274,0,40
766,356,1,767,9,4283,0,90
767,356,1,768,6,4289,0,60
768,356,1,769,3,4292,0,30
769,356,1,770,2,4294,0,20
770,356,1,771,6,4300,0,60
771,356,1,772,8,4308,0,80
772,356,1,773,5,4313,0,50
773,356,1,774,8,4321,0,80
774,356,1,775,2,4323,0,20
775,356,1,776,3,4326,0,30
776,356,1,777,2,4328,0,20
777,356,1,778,7,4335,0,70
778,356,1,779,5,4340,0,50
779,356,1,780,7,4347,0,70
780,356,1,781,2,4349,0,20
781,356,1,782,3,4352,236,30
782,356,1,783,6,4358,0,60
783,356,1,784,8,4366,0,80
784,356,1,785,2,4368,0,20
785,356,1,786,8,4376,0,80
786,356,1,787,6,4382,0,60
787,356,1,788,6,4388,0,60
788,356,1,789,3,4391,0,30
789,356,1,790,6,4397,0,60
790,356,1,791,2,4399,0,20
791,356,1,792,2,4401,0,20
792,356,1,793,4,4405,0,40
793,356,1,794,4,4409,0,40
794,356,1,795,2,4411,0,20
795,356,1,796,4,4415,0,40
796,356,1,797,8,4423,0,80
797,356,1,798,8,4431,0,80
798,356,1,799,3,4434,0,30
799,356,1,800,6,4440,0,60
800,356,1,801,2,4442,0,20
801,356,1,802,8,4450,0,80
802,356,1,803,3,4453,53,30
803,356,1,804,3,4456,0,30
804,356,1,805,3,4459,0,30
805,356,1,806,9,4468,0,90
806,356,1,807,8,4476,0,80
807,356,1,808,7,4483,0,70
808,356,1,809,8,4491,0,80
809,356,1,810,8,4499,0,80
810,356,1,811,7,4506,0,70
811,356,1,812,3,4509,0,30
812,356,1,813,6,4515,0,60
813,356,1,814,7,4522,0,70
814,356,1,815,5,4527,0,50
815,356,1,816,9,4536,0,90
816,356,1,817,6,4542,0,60
817,356,1,818,7,4549,0,70
818,356,1,819,5,4554,37,50
819,356,1,820,9,4563,0,90
820,356,1,821,5,4568,0,50
821,356,1,822,8,4576,0,80
822,356,1,823,9,4585,0,90
823,356,1,824,5,4590,0,50
824,356,1,825,4,4594,0,40
825,356,1,826,5,4599,0,50
826,356,1,827,4,4603,0,40
827,356,1,828,4,4607,0,40
828,356,1,829,7,4614,0,70
829,356,1,830,6,4620,0,60
830,356,1,831,7,4627,0,70
831,356,1,832,9,4636,0,90
832,356,1,833,7,4643,0,70
833,356,1,834,8,4651,0,80
834,356,1,835,6,4657,0,60
835,356,1,836,5,4662,0,50
836,356,1,837,6,4668,0,60
837,356,1,838,4,4672,0,40
838,356,1,839,2,4674,73,20
839,356,1,840,8,4682,0,80
840,356,1,841,6,4688,0,60
841,356,1,842,4,4692,0,40
842,356,1,843,5,4697,0,50
843,356,1,844,3,4700,0,30
844,356,1,845,9,4709,0,90
845,356,1,846,6,4715,0,60
846,356,1,847,4,4719,0,40
847,356,1,848,7,4726,0,70
848,356,1,849,5,4731,0,50
849,356,1,850,7,4738,0,70
850,356,1,851,3,4741,0,30
851,356,1,852,9,4750,0,90
852,356,1,853,4,4754,0,40
853,356,1,854,7,4761,0,70
854,356,1,855,3,4764,0,30
855,356,1,856,2,4766,0,20
856,356,1,857,2,4768,0,20
857,356,1,858,5,4773,0,50
858,356,1,859,9,4782,0,90
859,356,1,860,2,4784,0,20
860,356,1,861,2,4786,0,20
861,356,1,862,7,4793,62,70
862,356,1,863,9,4802,0,90
863,356,1,864,2,4804,0,20
864,356,1,865,5,4809,0,50
865,356,1,866,3,4812,5,30
866,356,1,867,5,4817,0,50
867,356,1,868,8,4825,0,80
868,356,1,869,6,4831,0,60
869,356,1,870,9,4840,0,90
870,356,1,871,2,4842,0,20
871,356,1,872,3,4845,0,30
872,356,1,873,8,4853,0,80
873,356,1,874,8,4861,0,80
874,356,1,875,3,4864,0,30
875,356,1,876,8,4872,0,80
876,356,1,877,6,4878,35,60
877,356,1,878,6,4884,0,60
878,356,1,879,5,4889,0,50
879,356,1,880,6,4895,0,60
880,356,1,881,5,4900,0,50
881,356,1,882,7,4907,0,70
882,356,1,883,9,4916,0,90
883,356,1,884,5,4921,0,50
884,356,1,885,5,4926,0,50
885,356,1,886,4,4930,28,40
886,356,1,887,3,4933,0,30
887,356,1,888,7,4940,0,70
888,356,1,889,2,4942,0,20
889,356,1,890,6,4948,0,60
890,356,1,891,6,4954,0,60
891,356,1,892,6,4960,0,60
892,356,1,893,6,4966,0,60
893,356,1,894,7,4973,0,70
894,356,1,895,5,4978,0,50
895,356,1,896,5,4983,0,50
896,356,1,897,2,4985,0,20
897,356,1,898,9,4994,0,90
898,356,1,899,5,4999,0,50
899,356,2,1,9,9,6,90
900,356,2,2,8,17,0,80
901,356,2,3,3,20,0,30
902,356,2,4,6,26,0,60
903,356,2,5,2,28,0,20
904,356,2,6,8,36,0,80
905,356,2,7,7,43,0,70
906,356,2,8,9,52,0,90
907,356,2,9,2,54,0,20
908,356,2,10,5,59,0,50
909,356,2,11,5,64,0,50
910,356,2,12,6,70,0,60
911,356,2,13,7,77,0,70
912,356,2,14,3,80,0,30
913,356,2,15,6,86,0,60
914,356,2,16,5,91,0,50
915,356,2,17,6,97,0,60
916,356,2,18,3,100,0,30
917,356,2,19,5,105,0,50
918,356,2,20,6,111,0,60
919,356,2,21,7,118,59,70
920,356,2,22,3,121,0,30
921,356,2,23,7,128,2,70
922,356,2,24,2,130,0,20
923,356,2,25,4,134,0,40
924,356,2,26,7,141,0,70
925,356,2,27,9,150,0,90
926,356,2,28,9,159,17,90
927,356,2,29,6,165,0,60
928,356,2,30,2,167,0,20
929,356,2,31,2,169,0,20
930,356,2,32,7,176,0,70
931,356,2,33,5,181,0,50
932,356,2,34,5,186,0,50
933,356,2,35,9,195,0,90
934,356,2,36,7,202,0,70
935,356,2,37,5,207,0,50
936,356,2,38,7,214,0,70
937,356,2,39,2,216,0,20
938,356,2,40,7,223,0,70
939,356,2,41,4,227,0,40
940,356,2,42,3,230,0,30
941,356,2,43,2,232,0,20
942,356,2,44,9,241,0,90
943,356,2,45,4,245,0,40
944,356,2,46,3,248,0,30
945,356,2,47,4,252,0,40
946,356,2,48,9,261,0,90
947,356,2,49,4,265,0,40
948,356,2,50,7,272,0,70
949,356,2,51,6,278,0,60
950,356,2,52,7,285,59,70
951,356,2,53,9,294,0,90
952,356,2,54,2,296,0,20
953,356,2,55,6,302,0,60
954,356,2,56,4,306,0,40
955,356,2,57,5,311,0,50
956,356,2,58,8,319,0,80
957,356,2,59,7,326,0,70
958,356,2,60,2,328,0,20
959,356,2,61,8,336,0,80
960,356,2,62,3,339,0,30
961,356,2,63,3,342,0,30
962,356,2,64,7,349,0,70
963,356,2,65,3,352,0,30
964,356,2,66,2,354,0,20
965,356,2,67,8,362,0,80
966,356,2,68,3,365,0,30
967,356,2,69,3,368,0,30
968,356,2,70,8,376,0,80
969,356,2,71,8,384,0,80
970,356,2,72,7,391,0,70
971,356,2,73,6,397,0,60
972,356,2,74,9,406,0,90
973,356,2,75,3,409,0,30
974,356,2,76,5,414,0,50
975,356,2,77,4,418,0,40
976,356,2,78,8,426,0,80
977,356,2,79,5,431,0,50
978,356,2,80,3,434,0,30
979,356,2,81,7,441,57,70
980,356,2,82,3,444,2,30
981,356,2,83,9,453,0,90
982,356,2,84,4,457,0,40
983,356,2,85,3,460,0,30
984,356,2,86,6,466,0,60
985,356,2,87,7,473,0,70
986,356,2,88,4,477,0,40
987,356,2,89,6,483,0,60
988,356,2,90,2,485,0,20
989,356,2,91,2,487,0,20
990,356,2,92,3,490,0,30
991,356,2,93,7,497,0,70
992,356,2,94,4,501,0,40
993,356,2,95,8,509,0,80
994,356,2,96,7,516,0,70
995,356,2,97,5,521,0,50
996,356,2,98,8,529,0,80
997,356,2,99,7,536,44,70
998,356,2,100,4,540,0,40
999,356,2,101,6,546,0,60
1000,356,2,102,6,552,0,60
1001,356,2,103,2,554,0,20
1002,356,2,104,8,562,7,80
1003,356,2,105,3,565,0,30
1004,356,2,106,5,570,0,50
1005,356,2,107,3,573,0,30
1006,356,2,108,4,577,0,40
1007,356,2,109,4,581,0,40
1008,356,2,110,6,587,0,60
1009,356,2,111,4,591,0,40
1010,356,2,112,3,594,0,30
1011,356,2,113,8,602,0,80
1012,356,2,114,3,605,0,30
1013,356,2,115,8,613,0,80
1014,356,2,116,9,622,0,90
1015,356,2,117,9,631,0,90
1016,356,2,118,2,633,0,20
1017,356,2,119,2,635,0,20
1018,356,2,120,9,644,0,90
1019,356,2,121,3,647,0,30
1020,356,2,122,4,651,0,40
1021,356,2,123,7,658,0,70
1022,356,2,124,5,663,0,50
1023,356,2,125,3,666,0,30
1024,356,2,126,9,675,0,90
1025,356,2,127,9,684,0,90
1026,356,2,128,3,687,0,30
1027,356,2,129,4,691,0,40
1028,356,2,130,7,698,0,70
1029,356,2,131,8,706,0,80
1030,356,2,132,5,711,0,50
1031,356,2,133,8,719,0,80
1032,356,2,134,2,721,0,20
1033,356,2,135,8,729,0,80
1034,356,2,136,9,738,0,90
1035,356,2,137,7,745,0,70
1036,356,2,138,3,748,0,30
1037,356,2,139,3,751,0,30
1038,356,2,140,3,754,0,30
1039,356,2,141,9,763,0,90
1040,356,2,142,2,765,0,20
1041,356,2,143,7,772,89,70
1042,356,2,144,5,777,0,50
1043,356,2,145,9,786,0,90
1044,356,2,146,7,793,0,70
1045,356,2,147,7,800,0,70
1046,356,2,148,7,807,0,70
1047,356,2,149,8,815,0,80
1048,356,2,150,7,822,0,70
1049,356,2,151,3,825,0,30
1050,356,2,152,2,827,0,20
1051,356,2,153,9,836,25,90
1052,356,2,154,8,844,0,80
1053,356,2,155,5,849,0,50
1054,356,2,156,4,853,0,40
1055,356,2,157,5,858,0,50
1056,356,2,158,8,866,0,80
1057,356,2,159,9,875,0,90
1058,356,2,160,4,879,0,40
1059,356,2,161,7,886,0,70
1060,356,2,162,2,888,0,20
1061,356,2,163,3,891,0,30
1062,356,2,164,7,898,0,70
1063,356,2,165,5,903,0,50
1064,356,2,166,8,911,0,80
1065,356,2,167,4,915,0,40
1066,356,2,168,9,924,0,90
1067,356,2,169,3,927,0,30
1068,356,2,170,8,935,0,80
1069,356,2,171,6,941,0,60
1070,356,2,172,2,943,0,20
1071,356,2,173,5,948,0,50
1072,356,2,174,5,953,0,50
1073,356,2,175,7,960,0,70
1074,356,2,176,6,966,0,60
1075,356,2,177,3,969,0,30
1076,356,2,178,8,977,60,80
1077,356,2,179,6,983,0,60
1078,356,2,180,8,991,0,80
1079,356,2,181,6,997,0,60
1080,356,2,182,6,1003,0,60
1081,356,2,183,7,1010,0,70
1082,356,2,184,6,1016,0,60
1083,356,2,185,8,1024,0,80
1084,356,2,186,7,1031,0,70
1085,356,2,187,7,1038,0,70
1086,356,2,188,3,1041,0,30
1087,356,2,189,5,1046,0,50
1088,356,2,190,2,1048,0,20
1089,356,2,191,7,1055,0,70
1090,356,2,192,6,1061,0,60
1091,356,2,193,8,1069,0,80
1092,356,2,194,5,1074,0,50
1093,356,2,195,2,1076,0,20
1094,356,2,196,8,1084,0,80
1095,356,2,197,8,1092,0,80
1096,356,2,198,7,1099,0,70
1097,356,2,199,3,1102,0,30
1098,356,2,200,5,1107,0,50
1099,356,2,201,8,1115,0,80
1100,356,2,202,7,1122,0,70
1101,356,2,203,3,1125,0,30
1102,356,2,204,4,1129,0,40
1103,356,2,205,5,1134,0,50
1104,356,2,206,4,1138,0,40
1105,356,2,207,7,1145,0,70
1106,356,2,208,6,1151,0,60
1107,356,2,209,4,1155,0,40
1108,356,2,210,6,1161,0,60
1109,356,2,211,5,1166,0,50
1110,356,2,212,6,1172,0,60
1111,356,2,213,2,1174,0,20
1112,356,2,214,4,1178,0,40
1113,356,2,215,5,1183,0,50
1114,356,2,216,8,1191,0,80
1115,356,2,217,3,1194,0,30
1116,356,2,218,8,1202,0,80
1117,356,2,219,9,1211,0,90
1118,356,2,220,6,1217,0,60
1119,356,2,221,3,1220,0,30
1120,356,2,222,6,1226,0,60
1121,356,2,223,4,1230,0,40
1122,356,2,224,2,1232,0,20
1123,356,2,225,8,1240,0,80
1124,356,2,226,6,1246,0,60
1125,356,2,227,3,1249,0,30
1126,356,2,228,6,1255,0,60
1127,356,2,229,7,1262,0,70
1128,356,2,230,8,1270,134,80
1129,356,2,231,6,1276,0,60
1130,356,2,232,7,1283,0,70
1131,356,2,233,5,1288,0,50
1132,356,2,234,5,1293,0,50
1133,356,2,235,2,1295,0,20
1134,356,2,236,9,1304,0,90
1135,356,2,237,5,1309,0,50
1136,356,2,238,5,1314,0,50
1137,356,2,239,5,1319,0,50
1138,356,2,240,7,1326,0,70
1139,356,2,241,3,1329,0,30
1140,356,2,242,8,1337,0,80
1141,356,2,243,3,1340,0,30
1142,356,2,244,8,1348,0,80
1143,356,2,245,2,1350,0,20
1144,356,2,246,4,1354,0,40
1145,356,2,247,9,1363,0,90
1146,356,2,248,7,1370,0,70
1147,356,2,249,8,1378,0,80
1148,356,2,250,6,1384,0,60
1149,356,2,251,8,1392,0,80
1150,356,2,252,7,1399,0,70
1151,356,2,253,3,1402,0,30
1152,356,2,254,4,1406,0,40
1153,356,2,255,2,1408,0,20
1154,356,2,256,2,1410,0,20
1155,356,2,257,3,1413,0,30
1156,356,2,258,3,1416,0,30
1157,356,2,259,8,1424,0,80
1158,356,2,260,3,1427,0,30
1159,356,2,261,3,1430,0,30
1160,356,2,262,9,1439,0,90
1161,356,2,263,2,1441,0,20
1162,356,2,264,6,1447,0,60
1163,356,2,265,5,1452,0,50
1164,356,2,266,8,1460,0,80
1165,356,2,267,6,1466,0,60
1166,356,2,268,2,1468,0,20
1167,356,2,269,6,1474,0,60
1168,356,2,270,7,1481,0,70
1169,356,2,271,9,1490,0,90
1170,356,2,272,6,1496,0,60
1171,356,2,273,8,1504,0,80
1172,356,2,274,7,1511,0,70
1173,356,2,275,8,1519,0,80
1174,356,2,276,2,1521,0,20
1175,356,2,277,3,1524,0,30
1176,356,2,278,2,1526,117,20
1177,356,2,279,8,1534,0,80
1178,356,2,280,4,1538,0,40
1179,356,2,281,8,1546,0,80
1180,356,2,282,5,1551,0,50
1181,356,2,283,7,1558,0,70
1182,356,2,284,4,1562,0,40
1183,356,2,285,8,1570,0,80
1184,356,2,286,3,1573,0,30
1185,356,2,287,5,1578,0,50
1186,356,2,288,8,1586,0,80
1187,356,2,289,4,1590,0,40
1188,356,2,290,2,1592,0,20
1189,356,2,291,2,1594,0,20
1190,356,2,292,2,1596,0,20
1191,356,2,293,3,1599,0,30
1192,356,2,294,7,1606,0,70
1193,356,2,295,4,1610,0,40
1194,356,2,296,5,1615,0,50
1195,356,2,297,5,1620,0,50
1196,356,2,298,6,1626,0,60
1197,356,2,299,7,1633,0,70
1198,356,2,300,6,1639,0,60
1199,356,2,301,6,1645,0,60
1200,356,2,302,8,1653,0,80
1201,356,2,303,2,1655,0,20
1202,356,2,304,3,1658,0,30
1203,356,2,305,8,1666,0,80
1204,356,2,306,8,1674,0,80
1205,356,2,307,4,1678,0,40
1206,356,2,308,4,1682,0,40
1207,356,2,309,3,1685,0,30
1208,356,2,310,5,1690,0,50
1209,356,2,311,8,1698,0,80
1210,356,2,312,2,1700,0,20
1211,356,2,313,9,1709,105,90
1212,356,2,314,4,1713,0,40
1213,356,2,315,6,1719,0,60
1214,356,2,316,7,1726,0,70
1215,356,2,317,6,1732,0,60
1216,356,2,318,7,1739,0,70
1217,356,2,319,2,1741,0,20
1218,356,2,320,6,1747,0,60
1219,356,2,321,2,1749,0,20
1220,356,2,322,2,1751,0,20
1221,356,2,323,6,1757,0,60
1222,356,2,324,7,1764,0,70
1223,356,2,325,8,1772,0,80
1224,356,2,326,2,1774,0,20
1225,356,2,327,5,1779,0,50
1226,356,2,328,5,1784,0,50
1227,356,2,329,9,1793,0,90
1228,356,2,330,9,1802,0,90
1229,356,2,331,2,1804,0,20
1230,356,2,332,5,1809,51,50
1231,356,2,333,2,1811,0,20
1232,356,2,334,8,1819,0,80
1233,356,2,335,5,1824,0,50
1234,356,2,336,9,1833,0,90
1235,356,2,337,7,1840,0,70
1236,356,2,338,3,1843,0,30
1237,356,2,339,3,1846,0,30
1238,356,2,340,7,1853,0,70
1239,356,2,341,4,1857,0,40
1240,356,2,342,6,1863,0,60
1241,356,2,343,7,1870,0,70
1242,356,2,344,5,1875,0,50
1243,356,2,345,8,1883,0,80
1244,356,2,346,5,1888,0,50
1245,356,2,347,2,1890,0,20
1246,356,2,348,7,1897,0,70
1247,356,2,349,3,1900,0,30
1248,356,2,350,7,1907,44,70
1249,356,2,351,9,1916,0,90
1250,356,2,352,8,1924,0,80
1251,356,2,353,4,1928,0,40
1252,356,2,354,4,1932,0,40
1253,356,2,355,4,1936,0,40
1254,356,2,356,3,1939,0,30
1255,356,2,357,3,1942,0,30
1256,356,2,358,8,1950,0,80
1257,356,2,359,7,1957,0,70
1258,356,2,360,4,1961,0,40
1259,356,2,361,7,1968,0,70
1260,356,2,362,2,1970,0,20
1261,356,2,363,7,1977,0,70
1262,356,2,364,5,1982,0,50
1263,356,2,365,8,1990,0,80
1264,356,2,366,6,1996,0,60
1265,356,2,367,5,2001,0,50
1266,356,2,368,6,2007,0,60
1267,356,2,369,2,2009,0,20
1268,356,2,370,3,2012,0,30
1269,356,2,371,8,2020,0,80
1270,356,2,372,7,2027,0,70
1271,356,2,373,8,2035,0,80
1272,356,2,374,2,2037,0,20
1273,356,2,375,2,2039,0,20
1274,356,2,376,2,2041,0,20
1275,356,2,377,9,2050,0,90
1276,356,2,378,3,2053,0,30
1277,356,2,379,7,2060,0,70
1278,356,2,380,7,2067,0,70
1279,356,2,381,4,2071,0,40
1280,356,2,382,4,2075,0,40
1281,356,2,383,2,2077,0,20
1282,356,2,384,8,2085,0,80
1283,356,2,385,6,2091,0,60
1284,356,2,386,9,2100,0,90
1285,356,2,387,5,2105,0,50
1286,356,2,388,5,2110,0,50
1287,356,2,389,7,2117,110,70
1288,356,2,390,6,2123,0,60
1289,356,2,391,9,2132,0,90
1290,356,2,392,6,2138,0,60
1291,356,2,393,5,2143,0,50
1292,356,2,394,3,2146,0,30
1293,356,2,395,9,2155,0,90
1294,356,2,396,9,2164,0,90
1295,356,2,397,4,2168,0,40
1296,356,2,398,9,2177,0,90
1297,356,2,399,3,2180,0,30
1298,356,2,400,8,2188,0,80
1299,356,2,401,2,2190,0,20
1300,356,2,402,9,2199,0,90
1301,356,2,403,5,2204,0,50
1302,356,2,404,6,2210,0,60
1303,356,2,405,5,2215,0,50
1304,356,2,406,7,2222,0,70
1305,356,2,407,9,2231,0,90
1306,356,2,408,3,2234,0,30
1307,356,2,409,7,2241,66,70
1308,356,2,410,5,2246,0,50
1309,356,2,411,3,2249,0,30
1310,356,2,412,5,2254,0,50
1311,356,2,413,5,2259,0,50
1312,356,2,414,9,2268,0,90
1313,356,2,415,3,2271,0,30
1314,356,2,416,3,2274,20,30
1315,356,2,417,4,2278,0,40
1316,356,2,418,8,2286,0,80
1317,356,2,419,4,2290,0,40
1318,356,2,420,9,2299,0,90
1319,356,2,421,3,2302,0,30
1320,356,2,422,2,2304,0,20
1321,356,2,423,3,2307,0,30
1322,356,2,424,5,2312,0,50
1323,356,2,425,7,2319,0,70
1324,356,2,426,3,2322,0,30
1325,356,2,427,6,2328,0,60
1326,356,2,428,2,2330,0,20
1327,356,2,429,7,2337,0,70
1328,356,2,430,8,2345,0,80
1329,356,2,431,3,2348,0,30
1330,356,2,432,5,2353,0,50
1331,356,2,433,4,2357,0,40
1332,356,2,434,6,2363,0,60
1333,356,2,435,7,2370,0,70
1334,356,2,436,7,2377,0,70
1335,356,2,437,2,2379,0,20
1336,356,2,438,4,2383,0,40
1337,356,2,439,2,2385,0,20
1338,356,2,440,7,2392,0,70
1339,356,2,441,8,2400,0,80
1340,356,2,442,3,2403,0,30
1341,356,2,443,2,2405,0,20
1342,356,2,444,3,2408,0,30
1343,356,2,445,7,2415,0,70
1344,356,2,446,3,2418,0,30
1345,356,2,447,4,2422,0,40
1346,356,2,448,8,2430,0,80
1347,356,2,449,9,2439,0,90
1348,356,2,450,5,2444,0,50
1349,356,2,451,7,2451,0,70
1350,356,2,452,8,2459,0,80
1351,356,2,453,4,2463,111,40
1352,356,2,454,5,2468,0,50
1353,356,2,455,8,2476,0,80
1354,356,2,456,3,2479,0,30
1355,356,2,457,5,2484,0,50
1356,356,2,458,8,2492,0,80
1357,356,2,459,4,2496,20,40
1358,356,2,460,5,2501,0,50
1359,356,2,461,2,2503,0,20
1360,356,2,462,7,2510,0,70
1361,356,2,463,7,2517,0,70
1362,356,2,464,4,2521,0,40
1363,356,2,465,6,2527,0,60
1364,356,2,466,6,2533,0,60
1365,356,2,467,5,2538,0,50
1366,356,2,468,6,2544,0,60
1367,356,2,469,3,2547,0,30
1368,356,2,470,4,2551,16,40
1369,356,2,471,9,2560,0,90
1370,356,2,472,2,2562,0,20
1371,356,2,473,4,2566,0,40
1372,356,2,474,6,2572,0,60
1373,356,2,475,5,2577,0,50
1374,356,2,476,4,2581,0,40
1375,356,2,477,7,2588,0,70
1376,356,2,478,6,2594,0,60
1377,356,2,479,3,2597,0,30
1378,356,2,480,2,2599,0,20
1379,356,2,481,8,2607,0,80
1380,356,2,482,4,2611,0,40
1381,356,2,483,9,2620,0,90
1382,356,2,484,2,2622,0,20
1383,356,2,485,6,2628,0,60
1384,356,2,486,3,2631,0,30
1385,356,2,487,8,2639,0,80
1386,356,2,488,7,2646,0,70
1387,356,2,489,2,2648,0,20
1388,356,2,490,6,2654,0,60
1389,356,2,491,3,2657,0,30
1390,356,2,492,3,2660,0,30
1391,356,2,493,9,2669,0,90
1392,356,2,494,8,2677,0,80
1393,356,2,495,4,2681,0,40
1394,356,2,496,4,2685,0,40
1395,356,2,497,3,2688,0,30
1396,356,2,498,5,2693,0,50
1397,356,2,499,5,2698,0,50
1398,356,2,500,7,2705,0,70
1399,356,2,501,5,2710,0,50
1400,356,2,502,4,2714,0,40
1401,356,2,503,7,2721,0,70
1402,356,2,504,6,2727,0,60
1403,356,2,505,7,2734,0,70
1404,356,2,506,9,2743,0,90
1405,356,2,507,6,2749,0,60
1406,356,2,508,8,2757,0,80
1407,356,2,509,8,2765,0,80
1408,356,2,510,7,2772,0,70
1409,356,2,511,6,2778,0,60
1410,356,2,512,4,2782,0,40
1411,356,2,513,5,2787,0,50
1412,356,2,514,3,2790,0,30
1413,356,2,515,3,2793,0,30
1414,356,2,516,3,2796,0,30
1415,356,2,517,5,2801,0,50
1416,356,2,518,7,2808,0,70
1417,356,2,519,2,2810,0,20
1418,356,2,520,8,2818,0,80
1419,356,2,521,6,2824,0,60
1420,356,2,522,4,2828,0,40
1421,356,2,523,9,2837,0,90
1422,356,2,524,3,2840,0,30
1423,356,2,525,2,2842,0,20
1424,356,2,526,6,2848,0,60
1425,356,2,527,5,2853,0,50
1426,356,2,528,6,2859,0,60
1427,356,2,529,8,2867,0,80
1428,356,2,530,7,2874,0,70
1429,356,2,531,7,2881,0,70
1430,356,2,532,9,2890,0,90
1431,356,2,533,9,2899,0,90
1432,356,2,534,9,2908,0,90
1433,356,2,535,4,2912,0,40
1434,356,2,536,3,2915,0,30
1435,356,2,537,2,2917,0,20
1436,356,2,538,5,2922,0,50
1437,356,2,539,6,2928,0,60
1438,356,2,540,8,2936,211,80
1439,356,2,541,6,2942,0,60
1440,356,2,542,4,2946,0,40
1441,356,2,543,2,2948,0,20
1442,356,2,544,6,2954,0,60
1443,356,2,545,9,2963,0,90
1444,356,2,546,3,2966,0,30
1445,356,2,547,9,2975,0,90
1446,356,2,548,4,2979,0,40
1447,356,2,549,2,2981,0,20
1448,356,2,550,6,2987,0,60
1449,356,2,551,8,2995,0,80
1450,356,2,552,8,3003,0,80
1451,356,2,553,6,3009,0,60
1452,356,2,554,6,3015,0,60
1453,356,2,555,6,3021,0,60
1454,356,2,556,6,3027,0,60
1455,356,2,557,9,3036,0,90
1456,356,2,558,7,3043,0,70
1457,356,2,559,7,3050,0,70
1458,356,2,560,6,3056,0,60
1459,356,2,561,2,3058,0,20
1460,356,2,562,5,3063,0,50
1461,356,2,563,8,3071,0,80
1462,356,2,564,7,3078,0,70
1463,356,2,565,2,3080,0,20
1464,356,2,566,4,3084,0,40
1465,356,2,567,5,3089,0,50
1466,356,2,568,6,3095,0,60
1467,356,2,569,8,3103,0,80
1468,356,2,570,8,3111,0,80
1469,356,2,571,6,3117,0,60
1470,356,2,572,9,3126,0,90
1471,356,2,573,5,3131,0,50
1472,356,2,574,5,3136,0,50
1473,356,2,575,7,3143,0,70
1474,356,2,576,8,3151,0,80
1475,356,2,577,4,3155,0,40
1476,356,2,578,9,3164,0,90
1477,356,2,579,2,3166,0,20
1478,356,2,580,7,3173,0,70
1479,356,2,581,2,3175,0,20
1480,356,2,582,7,3182,0,70
1481,356,2,583,8,3190,0,80
1482,356,2,584,7,3197,0,70
1483,356,2,585,9,3206,0,90
1484,356,2,586,8,3214,0,80
1485,356,2,587,8,3222,0,80
1486,356,2,588,4,3226,0,40
1487,356,2,589,9,3235,0,90
1488,356,2,590,5,3240,0,50
1489,356,2,591,2,3242,0,20
1490,356,2,592,6,3248,0,60
1491,356,2,593,3,3251,155,30
1492,356,2,594,5,3256,0,50
1493,356,2,595,3,3259,0,30
1494,356,2,596,3,3262,0,30
1495,356,2,597,9,3271,0,90
1496,356,2,598,9,3280,0,90
1497,356,2,599,9,3289,0,90
1498,356,2,600,4,3293,0,40
1499,356,2,601,2,3295,0,20
1500,356,2,602,3,3298,0,30
1501,356,2,603,9,3307,0,90
1502,356,2,604,3,3310,0,30
1503,356,2,605,6,3316,0,60
1504,356,2,606,8,3324,0,80
1505,356,2,607,9,3333,52,90
1506,356,2,608,7,3340,0,70
1507,356,2,609,4,3344,0,40
1508,356,2,610,8,3352,0,80
1509,356,2,611,3,3355,0,30
1510,356,2,612,3,3358,0,30
1511,356,2,613,7,3365,0,70
1512,356,2,614,7,3372,22,70
1513,356,2,615,9,3381,0,90
1514,356,2,616,7,3388,0,70
1515,356,2,617,9,3397,0,90
1516,356,2,618,6,3403,0,60
1517,356,2,619,3,3406,0,30
1518,356,2,620,7,3413,20,70
1519,356,2,621,4,3417,0,40
1520,356,2,622,5,3422,0,50
1521,356,2,623,9,3431,0,90
1522,356,2,624,7,3438,0,70
1523,356,2,625,4,3442,0,40
1524,356,2,626,6,3448,0,60
1525,356,2,627,2,3450,0,20
1526,356,2,628,4,3454,0,40
1527,356,2,629,4,3458,0,40
1528,356,2,630,3,3461,0,30
1529,356,2,631,7,3468,0,70
1530,356,2,632,2,3470,0,20
1531,356,2,633,7,3477,0,70
1532,356,2,634,8,3485,0,80
1533,356,2,635,6,3491,0,60
1534,356,2,636,8,3499,0,80
1535,356,2,637,9,3508,0,90
1536,356,2,638,4,3512,0,40
1537,356,2,639,5,3517,0,50
1538,356,2,640,2,3519,0,20
1539,356,2,641,5,3524,0,50
1540,356,2,642,8,3532,0,80
1541,356,2,643,4,3536,0,40
1542,356,2,644,3,3539,0,30
1543,356,2,645,8,3547,0,80
1544,356,2,646,5,3552,0,50
1545,356,2,647,4,3556,0,40
1546,356,2,648,9,3565,0,90
1547,356,2,649,2,3567,0,20
1548,356,2,650,8,3575,85,80
1549,356,2,651,2,3577,0,20
1550,356,2,652,5,3582,0,50
1551,356,2,653,4,3586,0,40
1552,356,2,654,2,3588,0,20
1553,356,2,655,8,3596,0,80
1554,356,2,656,8,3604,0,80
1555,356,2,657,7,3611,0,70
1556,356,2,658,5,3616,0,50
1557,356,2,659,7,3623,0,70
1558,356,2,660,5,3628,0,50
1559,356,2,661,9,3637,0,90
1560,356,2,662,7,3644,0,70
1561,356,2,663,8,3652,0,80
1562,356,2,664,5,3657,0,50
1563,356,2,665,3,3660,0,30
1564,356,2,666,7,3667,0,70
1565,356,2,667,6,3673,0,60
1566,356,2,668,5,3678,60,50
1567,356,2,669,5,3683,0,50
1568,356,2,670,2,3685,0,20
1569,356,2,671,5,3690,0,50
1570,356,2,672,4,3694,0,40
1571,356,2,673,3,3697,0,30
1572,356,2,674,5,3702,0,50
1573,356,2,675,5,3707,0,50
1574,356,2,676,2,3709,0,20
1575,356,2,677,4,3713,0,40
1576,356,2,678,9,3722,0,90
1577,356,2,679,7,3729,0,70
1578,356,2,680,3,3732,0,30
1579,356,2,681,9,3741,0,90
1580,356,2,682,3,3744,0,30
1581,356,2,683,6,3750,0,60
1582,356,2,684,2,3752,0,20
1583,356,2,685,5,3757,0,50
1584,356,2,686,6,3763,35,60
1585,356,2,687,8,3771,4,80
1586,356,2,688,4,3775,0,40
1587,356,2,689,9,3784,0,90
1588,356,2,690,5,3789,0,50
1589,356,2,691,8,3797,0,80
1590,356,2,692,6,3803,0,60
1591,356,2,693,7,3810,0,70
1592,356,2,694,3,3813,0,30
1593,356,2,695,4,3817,0,40
1594,356,2,696,3,3820,0,30
1595,356,2,697,2,3822,0,20
1596,356,2,698,5,3827,0,50
1597,356,2,699,5,3832,0,50
1598,356,2,700,2,3834,0,20
1599,356,2,701,5,3839,0,50
1600,356,2,702,6,3845,0,60
1601,356,2,703,8,3853,0,80
1602,356,2,704,6,3859,0,60
1603,356,2,705,6,3865,0,60
1604,356,2,706,5,3870,0,50
1605,356,2,707,9,3879,0,90
1606,356,2,708,9,3888,0,90
1607,356,2,709,4,3892,0,40
1608,356,2,710,2,3894,0,20
1609,356,2,711,4,3898,0,40
1610,356,2,712,3,3901,0,30
1611,356,2,713,6,3907,0,60
1612,356,2,714,2,3909,0,20
1613,356,2,715,5,3914,0,50
1614,356,2,716,7,3921,0,70
1615,356,2,717,7,3928,0,70
1616,356,2,718,2,3930,0,20
1617,356,2,719,3,3933,0,30
1618,356,2,720,8,3941,0,80
1619,356,2,721,6,3947,0,60
1620,356,2,722,5,3952,0,50
1621,356,2,723,2,3954,0,20
1622,356,2,724,2,3956,0,20
1623,356,2,725,2,3958,0,20
1624,356,2,726,2,3960,0,20
1625,356,2,727,4,3964,0,40
1626,356,2,728,3,3967,0,30
1627,356,2,729,5,3972,0,50
1628,356,2,730,4,3976,0,40
1629,356,2,731,8,3984,0,80
1630,356,2,732,2,3986,0,20
1631,356,2,733,5,3991,0,50
1632,356,2,734,4,3995,0,40
1633,356,2,735,2,3997,0,20
1634,356,2,736,3,4000,0,30
1635,356,2,737,4,4004,0,40
1636,356,2,738,7,4011,0,70
1637,356,2,739,6,4017,0,60
1638,356,2,740,2,4019,0,20
1639,356,2,741,6,4025,0,60
1640,356,2,742,7,4032,0,70
1641,356,2,743,8,4040,0,80
1642,356,2,744,3,4043,0,30
1643,356,2,745,8,4051,0,80
1644,356,2,746,2,4053,0,20
1645,356,2,747,5,4058,0,50
1646,356,2,748,8,4066,0,80
1647,356,2,749,4,4070,0,40
1648,356,2,750,6,4076,0,60
1649,356,2,751,5,4081,0,50
1650,356,2,752,2,4083,0,20
1651,356,2,753,7,4090,0,70
1652,356,2,754,5,4095,0,50
1653,356,2,755,4,4099,0,40
1654,356,2,756,4,4103,0,40
1655,356,2,757,8,4111,149,80
1656,356,2,758,5,4116,0,50
1657,356,2,759,8,4124,0,80
1658,356,2,760,2,4126,0,20
1659,356,2,761,8,4134,0,80
1660,356,2,762,9,4143,0,90
1661,356,2,763,6,4149,0,60
1662,356,2,764,7,4156,0,70
1663,356,2,765,9,4165,0,90
1664,356,2,766,9,4174,0,90
1665,356,2,767,8,4182,0,80
1666,356,2,768,3,4185,0,30
1667,356,2,769,2,4187,0,20
1668,356,2,770,2,4189,44,20
1669,356,2,771,8,4197,0,80
1670,356,2,772,9,4206,0,90
1671,356,2,773,5,4211,0,50
1672,356,2,774,7,4218,0,70
1673,356,2,775,7,4225,0,70
1674,356,2,776,3,4228,0,30
1675,356,2,777,7,4235,0,70
1676,356,2,778,5,4240,0,50
1677,356,2,779,3,4243,0,30
1678,356,2,780,3,4246,0,30
1679,356,2,781,9,4255,0,90
1680,356,2,782,6,4261,0,60
1681,356,2,783,9,4270,32,90
1682,356,2,784,6,4276,0,60
1683,356,2,785,8,4284,0,80
1684,356,2,786,2,4286,0,20
1685,356,2,787,6,4292,0,60
1686,356,2,788,3,4295,0,30
1687,356,2,789,5,4300,0,50
1688,356,2,790,2,4302,0,20
1689,356,2,791,7,4309,0,70
1690,356,2,792,5,4314,0,50
1691,356,2,793,9,4323,0,90
1692,356,2,794,2,4325,0,20
1693,356,2,795,2,4327,0,20
1694,356,2,796,5,4332,0,50
1695,356,2,797,2,4334,0,20
1696,356,2,798,9,4343,0,90
1697,356,2,799,6,4349,0,60
1698,356,2,800,9,4358,0,90
1699,356,2,801,6,4364,0,60
1700,356,2,802,3,4367,0,30
1701,356,2,803,3,4370,0,30
1702,356,2,804,8,4378,0,80
1703,356,2,805,6,4384,0,60
1704,356,2,806,8,4392,0,80
1705,356,2,807,2,4394,0,20
1706,356,2,808,6,4400,0,60
1707,356,2,809,5,4405,0,50
1708,356,2,810,6,4411,0,60
1709,356,2,811,8,4419,0,80
1710,356,2,812,6,4425,0,60
1711,356,2,813,3,4428,0,30
1712,356,2,814,4,4432,0,40
1713,356,2,815,2,4434,0,20
1714,356,2,816,5,4439,0,50
1715,356,2,817,2,4441,0,20
1716,356,2,818,2,4443,0,20
1717,356,2,819,8,4451,0,80
1718,356,2,820,9,4460,0,90
1719,356,2,821,6,4466,0,60
1720,356,2,822,5,4471,0,50
1721,356,2,823,5,4476,0,50
1722,356,2,824,8,4484,0,80
1723,356,2,825,4,4488,0,40
1724,356,2,826,2,4490,0,20
1725,356,2,827,6,4496,0,60
1726,356,2,828,6,4502,0,60
1727,356,2,829,5,4507,0,50
1728,356,2,830,4,4511,0,40
1729,356,2,831,2,4513,0,20
1730,356,2,832,9,4522,0,90
1731,356,2,833,8,4530,0,80
1732,356,2,834,7,4537,0,70
1733,356,2,835,9,4546,0,90
1734,356,2,836,6,4552,0,60
1735,356,2,837,2,4554,0,20
1736,356,2,838,3,4557,0,30
1737,356,2,839,6,4563,0,60
1738,356,2,840,6,4569,0,60
1739,356,2,841,6,4575,0,60
1740,356,2,842,5,4580,0,50
1741,356,2,843,7,4587,0,70
1742,356,2,844,7,4594,0,70
1743,356,2,845,2,4596,0,20
1744,356,2,846,8,4604,0,80
1745,356,2,847,4,4608,0,40
1746,356,2,848,7,4615,0,70
1747,356,2,849,4,4619,0,40
1748,356,2,850,6,4625,0,60
1749,356,2,851,3,4628,0,30
1750,356,2,852,9,4637,0,90
1751,356,2,853,3,4640,207,30
1752,356,2,854,7,4647,0,70
1753,356,2,855,7,4654,0,70
1754,356,2,856,5,4659,0,50
1755,356,2,857,7,4666,0,70
1756,356,2,858,8,4674,0,80
1757,356,2,859,3,4677,23,30
1758,356,2,860,4,4681,0,40
1759,356,2,861,8,4689,7,80
1760,356,2,862,3,4692,0,30
1761,356,2,863,8,4700,0,80
1762,356,2,864,4,4704,0,40
1763,356,2,865,6,4710,0,60
1764,356,2,866,6,4716,0,60
1765,356,2,867,2,4718,0,20
1766,356,2,868,5,4723,0,50
1767,356,2,869,7,4730,0,70
1768,356,2,870,7,4737,0,70
1769,356,2,871,5,4742,35,50
1770,356,2,872,5,4747,0,50
1771,356,2,873,5,4752,0,50
1772,356,2,874,3,4755,0,30
1773,356,2,875,6,4761,0,60
1774,356,2,876,7,4768,0,70
1775,356,2,877,9,4777,0,90
1776,356,2,878,3,4780,0,30
1777,356,2,879,3,4783,0,30
1778,356,2,880,3,4786,0,30
1779,356,2,881,7,4793,0,70
1780,356,2,882,9,4802,0,90
1781,356,2,883,5,4807,0,50
1782,356,2,884,7,4814,0,70
1783,356,2,885,7,4821,34,70
1784,356,2,886,8,4829,0,80
1785,356,2,887,4,4833,0,40
1786,356,2,888,2,4835,0,20
1787,356,2,889,4,4839,0,40
1788,356,2,890,4,4843,0,40
1789,356,2,891,9,4852,0,90
1790,356,2,892,3,4855,0,30
1791,356,2,893,2,4857,13,20
1792,356,2,894,6,4863,0,60
1793,356,2,895,2,4865,0,20
1794,356,2,896,2,4867,0,20
1795,356,2,897,7,4874,6,70
1796,356,2,898,9,4883,0,90
1797,356,2,899,6,4889,0,60
1798,356,2,900,5,4894,0,50
1799,356,2,901,6,4900,0,60
1800,356,2,902,6,4906,0,60
1801,356,2,903,2,4908,0,20
1802,356,2,904,8,4916,0,80
1803,356,2,905,6,4922,0,60
1804,356,2,906,2,4924,0,20
1805,356,2,907,5,4929,0,50
1806,356,2,908,9,4938,30,90
1807,356,2,909,4,4942,0,40
1808,356,2,910,4,4946,0,40
1809,356,2,911,6,4952,0,60
1810,356,2,912,6,4958,0,60
1811,356,2,913,9,4967,0,90
1812,356,2,914,9,4976,0,90
1813,356,2,915,7,4983,0,70
1814,356,2,916,9,4992,0,90
1815,356,2,917,7,4999,0,70
1816,356,3,1,2,2,0,20
1817,356,3,2,9,11,0,90
1818,356,3,3,9,20,0,90
1819,356,3,4,9,29,0,90
1820,356,3,5,6,35,0,60
1821,356,3,6,4,39,0,40
1822,356,3,7,2,41,0,20
1823,356,3,8,2,43,0,20
1824,356,3,9,6,49,0,60
1825,356,3,10,5,54,0,50
1826,356,3,11,6,60,0,60
1827,356,3,12,6,66,0,60
1828,356,3,13,3,69,0,30
1829,356,3,14,4,73,0,40
1830,356,3,15,9,82,0,90
1831,356,3,16,9,91,0,90
1832,356,3,17,3,94,0,30
1833,356,3,18,6,100,58,60
1834,356,3,19,4,104,0,40
1835,356,3,20,8,112,0,80
1836,356,3,21,4,116,0,40
1837,356,3,22,2,118,0,20
1838,356,3,23,3,121,0,30
1839,356,3,24,9,130,0,90
1840,356,3,25,2,132,0,20
1841,356,3,26,3,135,0,30
1842,356,3,27,6,141,0,60
1843,356,3,28,8,149,0,80
1844,356,3,29,9,158,0,90
1845,356,3,30,4,162,0,40
1846,356,3,31,3,165,0,30
1847,356,3,32,2,167,0,20
1848,356,3,33,7,174,0,70
1849,356,3,34,3,177,0,30
1850,356,3,35,5,182,0,50
1851,356,3,36,4,186,0,40
1852,356,3,37,6,192,0,60
1853,356,3,38,3,195,0,30
1854,356,3,39,5,200,0,50
1855,356,3,40,5,205,0,50
1856,356,3,41,3,208,0,30
1857,356,3,42,5,213,0,50
1858,356,3,43,9,222,0,90
1859,356,3,44,4,226,0,40
1860,356,3,45,8,234,0,80
1861,356,3,46,5,239,0,50
1862,356,3,47,7,246,0,70
1863,356,3,48,4,250,0,40
1864,356,3,49,3,253,0,30
1865,356,3,50,6,259,0,60
1866,356,3,51,2,261,0,20
1867,356,3,52,6,267,0,60
1868,356,3,53,6,273,0,60
1869,356,3,54,4,277,0,40
1870,356,3,55,3,280,0,30
1871,356,3,56,4,284,90,40
1872,356,3,57,6,290,0,60
1873,356,3,58,3,293,0,30
1874,356,3,59,9,302,0,90
1875,356,3,60,3,305,0,30
1876,356,3,61,7,312,0,70
1877,356,3,62,3,315,0,30
1878,356,3,63,4,319,0,40
1879,356,3,64,7,326,0,70
1880,356,3,65,4,330,0,40
1881,356,3,66,4,334,0,40
1882,356,3,67,2,336,0,20
1883,356,3,68,9,345,0,90
1884,356,3,69,4,349,0,40
1885,356,3,70,7,356,0,70
1886,356,3,71,8,364,0,80
1887,356,3,72,4,368,0,40
1888,356,3,73,5,373,0,50
1889,356,3,74,9,382,44,90
1890,356,3,75,4,386,0,40
1891,356,3,76,9,395,0,90
1892,356,3,77,8,403,0,80
1893,356,3,78,6,409,0,60
1894,356,3,79,7,416,0,70
1895,356,3,80,2,418,0,20
1896,356,3,81,7,425,0,70
1897,356,3,82,2,427,0,20
1898,356,3,83,7,434,0,70
1899,356,3,84,5,439,0,50
1900,356,3,85,3,442,0,30
1901,356,3,86,6,448,0,60
1902,356,3,87,5,453,0,50
1903,356,3,88,7,460,0,70
1904,356,3,89,9,469,0,90
1905,356,3,90,8,477,0,80
1906,356,3,91,8,485,0,80
1907,356,3,92,6,491,0,60
1908,356,3,93,3,494,0,30
1909,356,3,94,3,497,0,30
1910,356,3,95,2,499,0,20
1911,356,3,96,2,501,0,20
1912,356,3,97,4,505,0,40
1913,356,3,98,5,510,0,50
1914,356,3,99,2,512,0,20
1915,356,3,100,2,514,0,20
1916,356,3,101,5,519,0,50
1917,356,3,102,9,528,0,90
1918,356,3,103,8,536,0,80
1919,356,3,104,5,541,0,50
1920,356,3,105,5,546,0,50
1921,356,3,106,4,550,0,40
1922,356,3,107,3,553,0,30
1923,356,3,108,8,561,0,80
1924,356,3,109,3,564,0,30
1925,356,3,110,6,570,0,60
1926,356,3,111,8,578,0,80
1927,356,3,112,6,584,0,60
1928,356,3,113,4,588,0,40
1929,356,3,114,7,595,0,70
1930,356,3,115,9,604,0,90
1931,356,3,116,7,611,0,70
1932,356,3,117,2,613,0,20
1933,356,3,118,6,619,0,60
1934,356,3,119,2,621,0,20
1935,356,3,120,2,623,0,20
1936,356,3,121,8,631,131,80
1937,356,3,122,2,633,0,20
1938,356,3,123,4,637,0,40
1939,356,3,124,3,640,6,30
1940,356,3,125,8,648,0,80
1941,356,3,126,2,650,0,20
1942,356,3,127,6,656,0,60
1943,356,3,128,8,664,0,80
1944,356,3,129,3,667,0,30
1945,356,3,130,7,674,0,70
1946,356,3,131,3,677,0,30
1947,356,3,132,5,682,0,50
1948,356,3,133,8,690,0,80
1949,356,3,134,5,695,0,50
1950,356,3,135,2,697,0,20
1951,356,3,136,4,701,0,40
1952,356,3,137,6,707,0,60
1953,356,3,138,2,709,0,20
1954,356,3,139,2,711,0,20
1955,356,3,140,8,719,0,80
1956,356,3,141,7,726,0,70
1957,356,3,142,2,728,0,20
1958,356,3,143,3,731,0,30
1959,356,3,144,2,733,0,20
1960,356,3,145,3,736,0,30
1961,356,3,146,9,745,0,90
1962,356,3,147,3,748,0,30
1963,356,3,148,7,755,0,70
1964,356,3,149,4,759,0,40
1965,356,3,150,2,761,0,20
1966,356,3,151,9,770,0,90
1967,356,3,152,8,778,0,80
1968,356,3,153,3,781,0,30
1969,356,3,154,3,784,0,30
1970,356,3,155,9,793,74,90
1971,356,3,156,3,796,0,30
1972,356,3,157,6,802,0,60
1973,356,3,158,7,809,0,70
1974,356,3,159,3,812,0,30
1975,356,3,160,3,815,0,30
1976,356,3,161,4,819,0,40
1977,356,3,162,2,821,0,20
1978,356,3,163,3,824,0,30
1979,356,3,164,3,827,0,30
1980,356,3,165,5,832,0,50
1981,356,3,166,6,838,0,60
1982,356,3,167,2,840,0,20
1983,356,3,168,3,843,0,30
1984,356,3,169,7,850,0,70
1985,356,3,170,7,857,0,70
1986,356,3,171,4,861,0,40
1987,356,3,172,2,863,0,20
1988,356,3,173,4,867,0,40
1989,356,3,174,2,869,0,20
1990,356,3,175,4,873,0,40
1991,356,3,176,4,877,0,40
1992,356,3,177,6,883,0,60
1993,356,3,178,8,891,0,80
1994,356,3,179,2,893,0,20
1995,356,3,180,2,895,0,20
1996,356,3,181,6,901,0,60
1997,356,3,182,8,909,0,80
1998,356,3,183,6,915,0,60
1999,356,3,184,6,921,0,60
2000,356,3,185,3,924,0,30
2001,356,3,186,3,927,0,30
2002,356,3,187,3,930,0,30
2003,356,3,188,6,936,0,60
2004,356,3,189,8,944,0,80
2005,356,3,190,9,953,0,90
2006,356,3,191,8,961,0,80
2007,356,3,192,5,966,0,50
2008,356,3,193,2,968,0,20
2009,356,3,194,8,976,0,80
2010,356,3,195,7,983,0,70
2011,356,3,196,6,989,0,60
2012,356,3,197,6,995,0,60
2013,356,3,198,2,997,0,20
2014,356,3,199,3,1000,0,30
2015,356,3,200,2,1002,0,20
2016,356,3,201,6,1008,0,60
2017,356,3,202,9,1017,0,90
2018,356,3,203,6,1023,0,60
2019,356,3,204,2,1025,0,20
2020,356,3,205,7,1032,0,70
2021,356,3,206,9,1041,0,90
2022,356,3,207,3,1044,0,30
2023,356,3,208,6,1050,0,60
2024,356,3,209,8,1058,0,80
2025,356,3,210,6,1064,0,60
2026,356,3,211,4,1068,0,40
2027,356,3,212,2,1070,143,20
2028,356,3,213,9,1079,0,90
2029,356,3,214,5,1084,0,50
2030,356,3,215,7,1091,0,70
2031,356,3,216,7,1098,0,70
2032,356,3,217,8,1106,0,80
2033,356,3,218,5,1111,25,50
2034,356,3,219,3,1114,0,30
2035,356,3,220,5,1119,2,50
2036,356,3,221,3,1122,0,30
2037,356,3,222,2,1124,0,20
2038,356,3,223,9,1133,0,90
2039,356,3,224,2,1135,0,20
2040,356,3,225,9,1144,0,90
2041,356,3,226,2,1146,0,20
2042,356,3,227,8,1154,0,80
2043,356,3,228,4,1158,0,40
2044,356,3,229,4,1162,0,40
2045,356,3,230,2,1164,0,20
2046,356,3,231,7,1171,0,70
2047,356,3,232,3,1174,0,30
2048,356,3,233,3,1177,0,30
2049,356,3,234,3,1180,0,30
2050,356,3,235,8,1188,0,80
2051,356,3,236,8,1196,0,80
2052,356,3,237,5,1201,0,50
2053,356,3,238,9,1210,0,90
2054,356,3,239,6,1216,0,60
2055,356,3,240,2,1218,0,20
2056,356,3,241,7,1225,0,70
2057,356,3,242,3,1228,0,30
2058,356,3,243,5,1233,0,50
2059,356,3,244,5,1238,0,50
2060,356,3,245,9,1247,0,90
2061,356,3,246,7,1254,0,70
2062,356,3,247,7,1261,71,70
2063,356,3,248,7,1268,0,70
2064,356,3,249,9,1277,0,90
2065,356,3,250,9,1286,0,90
2066,356,3,251,5,1291,0,50
2067,356,3,252,9,1300,0,90
2068,356,3,253,8,1308,0,80
2069,356,3,254,3,1311,0,30
2070,356,3,255,7,1318,0,70
2071,356,3,256,4,1322,0,40
2072,356,3,257,3,1325,0,30
2073,356,3,258,8,1333,0,80
2074,356,3,259,9,1342,0,90
2075,356,3,260,9,1351,0,90
2076,356,3,261,9,1360,0,90
2077,356,3,262,5,1365,0,50
2078,356,3,263,2,1367,0,20
2079,356,3,264,4,1371,0,40
2080,356,3,265,7,1378,0,70
2081,356,3,266,5,1383,0,50
2082,356,3,267,2,1385,0,20
2083,356,3,268,7,1392,0,70
2084,356,3,269,7,1399,0,70
2085,356,3,270,7,1406,0,70
2086,356,3,271,4,1410,0,40
2087,356,3,272,6,1416,0,60
2088,356,3,273,6,1422,0,60
2089,356,3,274,8,1430,0,80
2090,356,3,275,8,1438,0,80
2091,356,3,276,7,1445,0,70
2092,356,3,277,9,1454,0,90
2093,356,3,278,9,1463,0,90
2094,356,3,279,4,1467,0,40
2095,356,3,280,8,1475,0,80
2096,356,3,281,5,1480,0,50
2097,356,3,282,2,1482,0,20
2098,356,3,283,7,1489,0,70
2099,356,3,284,7,1496,0,70
2100,356,3,285,4,1500,0,40
2101,356,3,286,4,1504,0,40
2102,356,3,287,8,1512,146,80
2103,356,3,288,5,1517,0,50
2104,356,3,289,3,1520,0,30
2105,356,3,290,8,1528,0,80
2106,356,3,291,8,1536,0,80
2107,356,3,292,3,1539,0,30
2108,356,3,293,8,1547,0,80
2109,356,3,294,3,1550,0,30
2110,356,3,295,4,1554,18,40
2111,356,3,296,4,1558,0,40
2112,356,3,297,3,1561,0,30
2113,356,3,298,3,1564,0,30
2114,356,3,299,4,1568,0,40
2115,356,3,300,4,1572,0,40
2116,356,3,301,3,1575,0,30
2117,356,3,302,5,1580,0,50
2118,356,3,303,3,1583,0,30
2119,356,3,304,3,1586,0,30
2120,356,3,305,9,1595,0,90
2121,356,3,306,5,1600,0,50
2122,356,3,307,7,1607,0,70
2123,356,3,308,8,1615,0,80
2124,356,3,309,8,1623,0,80
2125,356,3,310,7,1630,0,70
2126,356,3,311,2,1632,0,20
2127,356,3,312,4,1636,0,40
2128,356,3,313,5,1641,0,50
2129,356,3,314,6,1647,0,60
2130,356,3,315,6,1653,0,60
2131,356,3,316,8,1661,0,80
2132,356,3,317,2,1663,0,20
2133,356,3,318,8,1671,0,80
2134,356,3,319,8,1679,60,80
2135,356,3,320,8,1687,0,80
2136,356,3,321,3,1690,0,30
2137,356,3,322,9,1699,0,90
2138,356,3,323,6,1705,0,60
2139,356,3,324,7,1712,0,70
2140,356,3,325,7,1719,0,70
2141,356,3,326,4,1723,0,40
2142,356,3,327,8,1731,0,80
2143,356,3,328,8,1739,0,80
2144,356,3,329,9,1748,0,90
2145,356,3,330,7,1755,0,70
2146,356,3,331,4,1759,0,40
2147,356,3,332,6,1765,0,60
2148,356,3,333,5,1770,0,50
2149,356,3,334,7,1777,0,70
2150,356,3,335,5,1782,0,50
2151,356,3,336,6,1788,0,60
2152,356,3,337,5,1793,0,50
2153,356,3,338,7,1800,0,70
2154,356,3,339,4,1804,0,40
2155,356,3,340,8,1812,0,80
2156,356,3,341,4,1816,0,40
2157,356,3,342,3,1819,0,30
2158,356,3,343,2,1821,0,20
2159,356,3,344,2,1823,0,20
2160,356,3,345,9,1832,0,90
2161,356,3,346,4,1836,0,40
2162,356,3,347,4,1840,0,40
2163,356,3,348,6,1846,0,60
2164,356,3,349,2,1848,76,20
2165,356,3,350,4,1852,0,40
2166,356,3,351,2,1854,0,20
2167,356,3,352,7,1861,0,70
2168,356,3,353,4,1865,0,40
2169,356,3,354,9,1874,0,90
2170,356,3,355,3,1877,0,30
2171,356,3,356,5,1882,0,50
2172,356,3,357,3,1885,0,30
2173,356,3,358,8,1893,0,80
2174,356,3,359,2,1895,0,20
2175,356,3,360,8,1903,0,80
2176,356,3,361,7,1910,0,70
2177,356,3,362,3,1913,0,30
2178,356,3,363,3,1916,0,30
2179,356,3,364,8,1924,0,80
2180,356,3,365,7,1931,0,70
2181,356,3,366,3,1934,0,30
2182,356,3,367,5,1939,0,50
2183,356,3,368,3,1942,0,30
2184,356,3,369,9,1951,0,90
2185,356,3,370,8,1959,0,80
2186,356,3,371,9,1968,0,90
2187,356,3,372,6,1974,0,60
2188,356,3,373,7,1981,0,70
2189,356,3,374,3,1984,0,30
2190,356,3,375,2,1986,0,20
2191,356,3,376,2,1988,0,20
2192,356,3,377,8,1996,0,80
2193,356,3,378,4,2000,0,40
2194,356,3,379,2,2002,0,20
2195,356,3,380,7,2009,0,70
2196,356,3,381,8,2017,0,80
2197,356,3,382,2,2019,0,20
2198,356,3,383,3,2022,0,30
2199,356,3,384,6,2028,0,60
2200,356,3,385,2,2030,0,20
2201,356,3,386,4,2034,0,40
2202,356,3,387,8,2042,0,80
2203,356,3,388,5,2047,0,50
2204,356,3,389,6,2053,0,60
2205,356,3,390,3,2056,0,30
2206,356,3,391,3,2059,0,30
2207,356,3,392,7,2066,0,70
2208,356,3,393,9,2075,0,90
2209,356,3,394,9,2084,0,90
2210,356,3,395,6,2090,0,60
2211,356,3,396,3,2093,0,30
2212,356,3,397,8,2101,0,80
2213,356,3,398,4,2105,0,40
2214,356,3,399,7,2112,0,70
2215,356,3,400,7,2119,0,70
2216,356,3,401,5,2124,0,50
2217,356,3,402,3,2127,0,30
2218,356,3,403,6,2133,0,60
2219,356,3,404,2,2135,0,20
2220,356,3,405,4,2139,0,40
2221,356,3,406,2,2141,0,20
2222,356,3,407,2,2143,0,20
2223,356,3,408,5,2148,0,50
2224,356,3,409,6,2154,0,60
2225,356,3,410,8,2162,0,80
2226,356,3,411,5,2167,0,50
2227,356,3,412,8,2175,0,80
2228,356,3,413,3,2178,0,30
2229,356,3,414,4,2182,0,40
2230,356,3,415,7,2189,0,70
2231,356,3,416,3,2192,0,30
2232,356,3,417,3,2195,0,30
2233,356,3,418,7,2202,0,70
2234,356,3,419,4,2206,0,40
2235,356,3,420,9,2215,0,90
2236,356,3,421,5,2220,0,50
2237,356,3,422,3,2223,0,30
2238,356,3,423,4,2227,0,40
2239,356,3,424,9,2236,0,90
2240,356,3,425,3,2239,0,30
2241,356,3,426,4,2243,0,40
2242,356,3,427,7,2250,0,70
2243,356,3,428,2,2252,0,20
2244,356,3,429,4,2256,0,40
2245,356,3,430,5,2261,0,50
2246,356,3,431,5,2266,0,50
2247,356,3,432,6,2272,0,60
2248,356,3,433,9,2281,0,90
2249,356,3,434,2,2283,0,20
2250,356,3,435,4,2287,0,40
2251,356,3,436,5,2292,0,50
2252,356,3,437,8,2300,0,80
2253,356,3,438,3,2303,0,30
2254,356,3,439,3,2306,0,30
2255,356,3,440,2,2308,0,20
2256,356,3,441,5,2313,0,50
2257,356,3,442,6,2319,0,60
2258,356,3,443,3,2322,0,30
2259,356,3,444,8,2330,0,80
2260,356,3,445,5,2335,0,50
2261,356,3,446,9,2344,254,90
2262,356,3,447,6,2350,0,60
2263,356,3,448,5,2355,0,50
2264,356,3,449,7,2362,0,70
2265,356,3,450,3,2365,9,30
2266,356,3,451,6,2371,0,60
2267,356,3,452,2,2373,0,20
2268,356,3,453,9,2382,0,90
2269,356,3,454,5,2387,0,50
2270,356,3,455,4,2391,0,40
2271,356,3,456,7,2398,0,70
2272,356,3,457,9,2407,0,90
2273,356,3,458,2,2409,0,20
2274,356,3,459,3,2412,0,30
2275,356,3,460,6,2418,0,60
2276,356,3,461,6,2424,36,60
2277,356,3,462,2,2426,0,20
2278,356,3,463,2,2428,0,20
2279,356,3,464,5,2433,3,50
2280,356,3,465,5,2438,0,50
2281,356,3,466,4,2442,0,40
2282,356,3,467,5,2447,0,50
2283,356,3,468,2,2449,0,20
2284,356,3,469,8,2457,0,80
2285,356,3,470,4,2461,0,40
2286,356,3,471,4,2465,0,40
2287,356,3,472,7,2472,0,70
2288,356,3,473,3,2475,0,30
2289,356,3,474,7,2482,21,70
2290,356,3,475,7,2489,0,70
2291,356,3,476,8,2497,0,80
2292,356,3,477,3,2500,0,30
2293,356,3,478,8,2508,0,80
2294,356,3,479,2,2510,0,20
2295,356,3,480,6,2516,0,60
2296,356,3,481,3,2519,0,30
2297,356,3,482,8,2527,0,80
2298,356,3,483,8,2535,0,80
2299,356,3,484,4,2539,0,40
2300,356,3,485,7,2546,0,70
2301,356,3,486,8,2554,34,80
2302,356,3,487,6,2560,0,60
2303,356,3,488,3,2563,0,30
2304,356,3,489,4,2567,0,40
2305,356,3,490,9,2576,0,90
2306,356,3,491,9,2585,0,90
2307,356,3,492,9,2594,0,90
2308,356,3,493,4,2598,31,40
2309,356,3,494,3,2601,0,30
2310,356,3,495,4,2605,0,40
2311,356,3,496,4,2609,0,40
2312,356,3,497,2,2611,0,20
2313,356,3,498,3,2614,0,30
2314,356,3,499,4,2618,0,40
2315,356,3,500,2,2620,0,20
2316,356,3,501,8,2628,17,80
2317,356,3,502,9,2637,0,90
2318,356,3,503,2,2639,0,20
2319,356,3,504,6,2645,0,60
2320,356,3,505,8,2653,0,80
2321,356,3,506,3,2656,0,30
2322,356,3,507,5,2661,0,50
2323,356,3,508,9,2670,0,90
2324,356,3,509,8,2678,0,80
2325,356,3,510,5,2683,0,50
2326,356,3,511,9,2692,0,90
2327,356,3,512,7,2699,0,70
2328,356,3,513,8,2707,0,80
2329,356,3,514,5,2712,0,50
2330,356,3,515,2,2714,0,20
2331,356,3,516,7,2721,30,70
2332,356,3,517,3,2724,0,30
2333,356,3,518,2,2726,0,20
2334,356,3,519,4,2730,0,40
2335,356,3,520,8,2738,0,80
2336,356,3,521,4,2742,0,40
2337,356,3,522,2,2744,0,20
2338,356,3,523,5,2749,0,50
2339,356,3,524,7,2756,0,70
2340,356,3,525,8,2764,26,80
2341,356,3,526,8,2772,0,80
2342,356,3,527,4,2776,6,40
2343,356,3,528,3,2779,0,30
2344,356,3,529,3,2782,0,30
2345,356,3,530,9,2791,0,90
2346,356,3,531,5,2796,0,50
2347,356,3,532,4,2800,0,40
2348,356,3,533,7,2807,0,70
2349,356,3,534,7,2814,0,70
2350,356,3,535,4,2818,0,40
2351,356,3,536,4,2822,0,40
2352,356,3,537,3,2825,0,30
2353,356,3,538,7,2832,0,70
2354,356,3,539,7,2839,0,70
2355,356,3,540,8,2847,0,80
2356,356,3,541,4,2851,0,40
2357,356,3,542,2,2853,0,20
2358,356,3,543,5,2858,0,50
2359,356,3,544,6,2864,0,60
2360,356,3,545,5,2869,0,50
2361,356,3,546,7,2876,0,70
2362,356,3,547,7,2883,0,70
2363,356,3,548,6,2889,0,60
2364,356,3,549,8,2897,0,80
2365,356,3,550,3,2900,0,30
2366,356,3,551,2,2902,0,20
2367,356,3,552,9,2911,0,90
2368,356,3,553,5,2916,0,50
2369,356,3,554,2,2918,0,20
2370,356,3,555,3,2921,0,30
2371,356,3,556,6,2927,0,60
2372,356,3,557,3,2930,66,30
2373,356,3,558,7,2937,0,70
2374,356,3,559,7,2944,0,70
2375,356,3,560,2,2946,0,20
2376,356,3,561,6,2952,0,60
2377,356,3,562,8,2960,0,80
2378,356,3,563,2,2962,0,20
2379,356,3,564,2,2964,0,20
2380,356,3,565,5,2969,0,50
2381,356,3,566,6,2975,0,60
2382,356,3,567,9,2984,0,90
2383,356,3,568,7,2991,0,70
2384,356,3,569,3,2994,0,30
2385,356,3,570,9,3003,0,90
2386,356,3,571,2,3005,0,20
2387,356,3,572,9,3014,0,90
2388,356,3,573,3,3017,0,30
2389,356,3,574,5,3022,0,50
2390,356,3,575,4,3026,0,40
2391,356,3,576,4,3030,0,40
2392,356,3,577,6,3036,0,60
2393,356,3,578,3,3039,0,30
2394,356,3,579,3,3042,0,30
2395,356,3,580,9,3051,0,90
2396,356,3,581,4,3055,0,40
2397,356,3,582,5,3060,0,50
2398,356,3,583,3,3063,67,30
2399,356,3,584,8,3071,0,80
2400,356,3,585,4,3075,0,40
2401,356,3,586,5,3080,0,50
2402,356,3,587,7,3087,0,70
2403,356,3,588,3,3090,0,30
2404,356,3,589,6,3096,0,60
2405,356,3,590,8,3104,0,80
2406,356,3,591,6,3110,0,60
2407,356,3,592,4,3114,0,40
2408,356,3,593,2,3116,0,20
2409,356,3,594,9,3125,0,90
2410,356,3,595,5,3130,0,50
2411,356,3,596,5,3135,0,50
2412,356,3,597,5,3140,0,50
2413,356,3,598,6,3146,0,60
2414,356,3,599,3,3149,0,30
2415,356,3,600,2,3151,0,20
2416,356,3,601,8,3159,0,80
2417,356,3,602,2,3161,0,20
2418,356,3,603,2,3163,0,20
2419,356,3,604,2,3165,0,20
2420,356,3,605,6,3171,0,60
2421,356,3,606,2,3173,0,20
2422,356,3,607,7,3180,0,70
2423,356,3,608,2,3182,0,20
2424,356,3,609,5,3187,0,50
2425,356,3,610,8,3195,0,80
2426,356,3,611,9,3204,0,90
2427,356,3,612,9,3213,0,90
2428,356,3,613,2,3215,0,20
2429,356,3,614,7,3222,0,70
2430,356,3,615,7,3229,0,70
2431,356,3,616,7,3236,0,70
2432,356,3,617,4,3240,82,40
2433,356,3,618,2,3242,0,20
2434,356,3,619,4,3246,1,40
2435,356,3,620,5,3251,0,50
2436,356,3,621,9,3260,0,90
2437,356,3,622,7,3267,0,70
2438,356,3,623,4,3271,0,40
2439,356,3,624,5,3276,0,50
2440,356,3,625,6,3282,0,60
2441,356,3,626,5,3287,0,50
2442,356,3,627,2,3289,0,20
2443,356,3,628,4,3293,0,40
2444,356,3,629,5,3298,0,50
2445,356,3,630,7,3305,0,70
2446,356,3,631,2,3307,0,20
2447,356,3,632,8,3315,0,80
2448,356,3,633,5,3320,0,50
2449,356,3,634,8,3328,0,80
2450,356,3,635,8,3336,0,80
2451,356,3,636,7,3343,0,70
2452,356,3,637,6,3349,50,60
2453,356,3,638,5,3354,0,50
2454,356,3,639,5,3359,0,50
2455,356,3,640,9,3368,0,90
2456,356,3,641,9,3377,0,90
2457,356,3,642,5,3382,0,50
2458,356,3,643,6,3388,0,60
2459,356,3,644,8,3396,0,80
2460,356,3,645,9,3405,0,90
2461,356,3,646,5,3410,0,50
2462,356,3,647,9,3419,29,90
2463,356,3,648,5,3424,0,50
2464,356,3,649,2,3426,0,20
2465,356,3,650,7,3433,0,70
2466,356,3,651,6,3439,0,60
2467,356,3,652,2,3441,0,20
2468,356,3,653,8,3449,0,80
2469,356,3,654,6,3455,0,60
2470,356,3,655,2,3457,0,20
2471,356,3,656,2,3459,0,20
2472,356,3,657,5,3464,0,50
2473,356,3,658,2,3466,0,20
2474,356,3,659,5,3471,0,50
2475,356,3,660,7,3478,0,70
2476,356,3,661,5,3483,0,50
2477,356,3,662,6,3489,0,60
2478,356,3,663,9,3498,0,90
2479,356,3,664,2,3500,0,20
2480,356,3,665,4,3504,0,40
2481,356,3,666,3,3507,0,30
2482,356,3,667,3,3510,0,30
2483,356,3,668,8,3518,0,80
2484,356,3,669,2,3520,0,20
2485,356,3,670,2,3522,0,20
2486,356,3,671,7,3529,0,70
2487,356,3,672,8,3537,50,80
2488,356,3,673,8,3545,0,80
2489,356,3,674,9,3554,0,90
2490,356,3,675,6,3560,0,60
2491,356,3,676,6,3566,0,60
2492,356,3,677,5,3571,0,50
2493,356,3,678,8,3579,0,80
2494,356,3,679,8,3587,0,80
2495,356,3,680,8,3595,0,80
2496,356,3,681,3,3598,0,30
2497,356,3,682,5,3603,0,50
2498,356,3,683,4,3607,0,40
2499,356,3,684,9,3616,0,90
2500,356,3,685,3,3619,0,30
2501,356,3,686,3,3622,0,30
2502,356,3,687,9,3631,0,90
2503,356,3,688,3,3634,0,30
2504,356,3,689,8,3642,0,80
2505,356,3,690,6,3648,0,60
2506,356,3,691,8,3656,0,80
2507,356,3,692,4,3660,0,40
2508,356,3,693,5,3665,0,50
2509,356,3,694,2,3667,0,20
2510,356,3,695,7,3674,0,70
2511,356,3,696,7,3681,0,70
2512,356,3,697,4,3685,0,40
2513,356,3,698,4,3689,0,40
2514,356,3,699,8,3697,0,80
2515,356,3,700,3,3700,0,30
2516,356,3,701,5,3705,0,50
2517,356,3,702,4,3709,0,40
2518,356,3,703,2,3711,0,20
2519,356,3,704,3,3714,0,30
2520,356,3,705,2,3716,0,20
2521,356,3,706,2,3718,0,20
2522,356,3,707,8,3726,0,80
2523,356,3,708,6,3732,0,60
2524,356,3,709,2,3734,0,20
2525,356,3,710,9,3743,0,90
2526,356,3,711,7,3750,0,70
2527,356,3,712,2,3752,0,20
2528,356,3,713,2,3754,0,20
2529,356,3,714,8,3762,0,80
2530,356,3,715,9,3771,0,90
2531,356,3,716,8,3779,0,80
2532,356,3,717,8,3787,0,80
2533,356,3,718,7,3794,110,70
2534,356,3,719,2,3796,0,20
2535,356,3,720,5,3801,0,50
2536,356,3,721,6,3807,0,60
2537,356,3,722,3,3810,0,30
2538,356,3,723,9,3819,0,90
2539,356,3,724,4,3823,0,40
2540,356,3,725,6,3829,0,60
2541,356,3,726,8,3837,0,80
2542,356,3,727,4,3841,0,40
2543,356,3,728,6,3847,0,60
2544,356,3,729,3,3850,0,30
2545,356,3,730,3,3853,0,30
2546,356,3,731,2,3855,0,20
2547,356,3,732,9,3864,0,90
2548,356,3,733,7,3871,0,70
2549,356,3,734,7,3878,0,70
2550,356,3,735,8,3886,0,80
2551,356,3,736,4,3890,0,40
2552,356,3,737,2,3892,0,20
2553,356,3,738,5,3897,0,50
2554,356,3,739,3,3900,0,30
2555,356,3,740,3,3903,0,30
2556,356,3,741,7,3910,0,70
2557,356,3,742,8,3918,0,80
2558,356,3,743,9,3927,0,90
2559,356,3,744,2,3929,0,20
2560,356,3,745,4,3933,0,40
2561,356,3,746,2,3935,0,20
2562,356,3,747,3,3938,0,30
2563,356,3,748,3,3941,0,30
2564,356,3,749,3,3944,0,30
2565,356,3,750,9,3953,0,90
2566,356,3,751,3,3956,0,30
2567,356,3,752,9,3965,0,90
2568,356,3,753,4,3969,0,40
2569,356,3,754,5,3974,0,50
2570,356,3,755,6,3980,0,60
2571,356,3,756,7,3987,0,70
2572,356,3,757,5,3992,0,50
2573,356,3,758,6,3998,0,60
2574,356,3,759,2,4000,0,20
2575,356,3,760,2,4002,0,20
2576,356,3,761,5,4007,0,50
2577,356,3,762,4,4011,0,40
2578,356,3,763,3,4014,0,30
2579,356,3,764,2,4016,0,20
2580,356,3,765,3,4019,0,30
2581,356,3,766,2,4021,0,20
2582,356,3,767,3,4024,0,30
2583,356,3,768,6,4030,0,60
2584,356,3,769,8,4038,107,80
2585,356,3,770,2,4040,0,20
2586,356,3,771,4,4044,0,40
2587,356,3,772,4,4048,0,40
2588,356,3,773,6,4054,0,60
2589,356,3,774,3,4057,0,30
2590,356,3,775,2,4059,0,20
2591,356,3,776,3,4062,0,30
2592,356,3,777,8,4070,0,80
2593,356,3,778,5,4075,0,50
2594,356,3,779,2,4077,0,20
2595,356,3,780,8,4085,0,80
2596,356,3,781,8,4093,0,80
2597,356,3,782,9,4102,0,90
2598,356,3,783,3,4105,0,30
2599,356,3,784,4,4109,0,40
2600,356,3,785,3,4112,0,30
2601,356,3,786,5,4117,0,50
2602,356,3,787,2,4119,0,20
2603,356,3,788,2,4121,0,20
2604,356,3,789,9,4130,0,90
2605,356,3,790,6,4136,0,60
2606,356,3,791,4,4140,0,40
2607,356,3,792,3,4143,0,30
2608,356,3,793,9,4152,0,90
2609,356,3,794,2,4154,0,20
2610,356,3,795,6,4160,0,60
2611,356,3,796,7,4167,0,70
2612,356,3,797,3,4170,0,30
2613,356,3,798,5,4175,0,50
2614,356,3,799,2,4177,0,20
2615,356,3,800,3,4180,0,30
2616,356,3,801,6,4186,72,60
2617,356,3,802,5,4191,0,50
2618,356,3,803,8,4199,0,80
2619,356,3,804,3,4202,0,30
2620,356,3,805,8,4210,0,80
2621,356,3,806,2,4212,0,20
2622,356,3,807,8,4220,28,80
2623,356,3,808,2,4222,0,20
2624,356,3,809,5,4227,0,50
2625,356,3,810,4,4231,0,40
2626,356,3,811,7,4238,0,70
2627,356,3,812,7,4245,0,70
2628,356,3,813,3,4248,0,30
2629,356,3,814,8,4256,0,80
2630,356,3,815,2,4258,0,20
2631,356,3,816,8,4266,0,80
2632,356,3,817,8,4274,0,80
2633,356,3,818,7,4281,0,70
2634,356,3,819,9,4290,0,90
2635,356,3,820,8,4298,37,80
2636,356,3,821,6,4304,0,60
2637,356,3,822,5,4309,0,50
2638,356,3,823,9,4318,0,90
2639,356,3,824,6,4324,0,60
2640,356,3,825,3,4327,0,30
2641,356,3,826,2,4329,0,20
2642,356,3,827,2,4331,15,20
2643,356,3,828,3,4334,0,30
2644,356,3,829,6,4340,0,60
2645,356,3,830,2,4342,0,20
2646,356,3,831,6,4348,0,60
2647,356,3,832,8,4356,0,80
2648,356,3,833,7,4363,0,70
2649,356,3,834,8,4371,0,80
2650,356,3,835,2,4373,0,20
2651,356,3,836,5,4378,0,50
2652,356,3,837,4,4382,0,40
2653,356,3,838,4,4386,0,40
2654,356,3,839,9,4395,0,90
2655,356,3,840,8,4403,0,80
2656,356,3,841,8,4411,0,80
2657,356,3,842,3,4414,0,30
2658,356,3,843,3,4417,0,30
2659,356,3,844,6,4423,0,60
2660,356,3,845,2,4425,0,20
2661,356,3,846,6,4431,0,60
2662,356,3,847,5,4436,0,50
2663,356,3,848,5,4441,0,50
2664,356,3,849,6,4447,0,60
2665,356,3,850,2,4449,0,20
2666,356,3,851,2,4451,0,20
2667,356,3,852,8,4459,0,80
2668,356,3,853,4,4463,0,40
2669,356,3,854,3,4466,0,30
2670,356,3,855,9,4475,0,90
2671,356,3,856,2,4477,0,20
2672,356,3,857,6,4483,0,60
2673,356,3,858,3,4486,0,30
2674,356,3,859,8,4494,0,80
2675,356,3,860,4,4498,0,40
2676,356,3,861,9,4507,0,90
2677,356,3,862,5,4512,0,50
2678,356,3,863,2,4514,0,20
2679,356,3,864,3,4517,0,30
2680,356,3,865,3,4520,0,30
2681,356,3,866,8,4528,0,80
2682,356,3,867,4,4532,0,40
2683,356,3,868,2,4534,0,20
2684,356,3,869,6,4540,104,60
2685,356,3,870,5,4545,0,50
2686,356,3,871,4,4549,0,40
2687,356,3,872,9,4558,0,90
2688,356,3,873,6,4564,0,60
2689,356,3,874,4,4568,0,40
2690,356,3,875,4,4572,11,40
2691,356,3,876,6,4578,0,60
2692,356,3,877,3,4581,0,30
2693,356,3,878,8,4589,0,80
2694,356,3,879,6,4595,0,60
2695,356,3,880,4,4599,0,40
2696,356,3,881,6,4605,0,60
2697,356,3,882,9,4614,0,90
2698,356,3,883,3,4617,0,30
2699,356,3,884,3,4620,0,30
2700,356,3,885,8,4628,0,80
2701,356,3,886,7,4635,0,70
2702,356,3,887,8,4643,0,80
2703,356,3,888,3,4646,0,30
2704,356,3,889,9,4655,0,90
2705,356,3,890,7,4662,0,70
2706,356,3,891,4,4666,0,40
2707,356,3,892,8,4674,0,80
2708,356,3,893,8,4682,0,80
2709,356,3,894,9,4691,0,90
2710,356,3,895,7,4698,0,70
2711,356,3,896,4,4702,0,40
2712,356,3,897,9,4711,0,90
2713,356,3,898,4,4715,0,40
2714,356,3,899,6,4721,80,60
2715,356,3,900,4,4725,0,40
2716,356,3,901,5,4730,0,50
2717,356,3,902,8,4738,0,80
2718,356,3,903,6,4744,0,60
2719,356,3,904,3,4747,0,30
2720,356,3,905,4,4751,15,40
2721,356,3,906,3,4754,0,30
2722,356,3,907,7,4761,0,70
2723,356,3,908,8,4769,0,80
2724,356,3,909,7,4776,0,70
2725,356,3,910,9,4785,0,90
2726,356,3,911,4,4789,0,40
2727,356,3,912,7,4796,0,70
2728,356,3,913,3,4799,0,30
2729,356,3,914,3,4802,0,30
2730,356,3,915,4,4806,0,40
2731,356,3,916,9,4815,0,90
2732,356,3,917,7,4822,0,70
2733,356,3,918,7,4829,0,70
2734,356,3,919,5,4834,0,50
2735,356,3,920,2,4836,0,20
2736,356,3,921,3,4839,0,30
2737,356,3,922,4,4843,0,40
2738,356,3,923,8,4851,0,80
2739,356,3,924,7,4858,0,70
2740,356,3,925,2,4860,0,20
2741,356,3,926,2,4862,0,20
2742,356,3,927,4,4866,0,40
2743,356,3,928,9,4875,0,90
2744,356,3,929,7,4882,0,70
2745,356,3,930,9,4891,0,90
2746,356,3,931,9,4900,0,90
2747,356,3,932,6,4906,0,60
2748,356,3,933,7,4913,0,70
2749,356,3,934,2,4915,0,20
2750,356,3,935,7,4922,0,70
2751,356,3,936,3,4925,0,30
2752,356,3,937,9,4934,0,90
2753,356,3,938,2,4936,0,20
2754,356,3,939,7,4943,0,70
2755,356,3,940,7,4950,0,70
2756,356,3,941,8,4958,0,80
2757,356,3,942,7,4965,0,70
2758,356,3,943,3,4968,0,30
2759,356,3,944,4,4972,0,40
2760,356,3,945,6,4978,0,60
2761,356,3,946,7,4985,0,70
2762,356,3,947,3,4988,0,30
2763,356,3,948,5,4993,0,50
2764,356,3,949,5,4998,0,50
