,Scenario,Trial,Inspection,Interval,Time,Defects,Rate
0,110,1,1,9,9,3,90
1,110,1,2,5,14,2,50
2,110,1,3,2,16,0,20
3,110,1,4,4,20,0,40
4,110,1,5,4,24,5,40
5,110,1,6,3,27,1,30
6,110,1,7,2,29,2,20
7,110,1,8,3,32,2,30
8,110,1,9,3,35,1,30
9,110,1,10,4,39,0,40
10,110,1,11,8,47,4,80
11,110,1,12,9,56,0,90
12,110,1,13,8,64,0,80
13,110,1,14,3,67,0,30
14,110,1,15,5,72,0,50
15,110,1,16,6,78,16,60
16,110,1,17,8,86,6,80
17,110,1,18,3,89,0,30
18,110,1,19,3,92,0,30
19,110,1,20,3,95,5,30
20,110,1,21,3,98,2,30
21,110,1,22,8,106,3,80
22,110,1,23,2,108,0,20
23,110,1,24,9,117,7,90
24,110,1,25,9,126,6,90
25,110,1,26,6,132,5,60
26,110,1,27,4,136,1,40
27,110,1,28,2,138,0,20
28,110,1,29,3,141,1,30
29,110,1,30,7,148,5,70
30,110,1,31,2,150,0,20
31,110,1,32,4,154,3,40
32,110,1,33,5,159,1,50
33,110,1,34,5,164,0,50
34,110,1,35,8,172,4,80
35,110,1,36,5,177,0,50
36,110,1,37,9,186,2,90
37,110,1,38,9,195,7,90
38,110,1,39,6,201,3,60
39,110,1,40,8,209,5,80
40,110,1,41,7,216,1,70
41,110,1,42,9,225,0,90
42,110,1,43,7,232,5,70
43,110,1,44,9,241,0,90
44,110,1,45,5,246,0,50
45,110,1,46,6,252,9,60
46,110,1,47,4,256,0,40
47,110,1,48,7,263,3,70
48,110,1,49,7,270,4,70
49,110,1,50,9,279,0,90
50,110,1,51,9,288,8,90
51,110,1,52,5,293,4,50
52,110,1,53,9,302,0,90
53,110,1,54,3,305,0,30
54,110,1,55,5,310,8,50
55,110,1,56,5,315,0,50
56,110,1,57,8,323,4,80
57,110,1,58,7,330,3,70
58,110,1,59,3,333,2,30
59,110,1,60,2,335,0,20
60,110,1,61,6,341,0,60
61,110,1,62,5,346,2,50
62,110,1,63,5,351,0,50
63,110,1,64,9,360,0,90
64,110,1,65,9,369,7,90
65,110,1,66,4,373,1,40
66,110,1,67,8,381,2,80
67,110,1,68,6,387,2,60
68,110,1,69,4,391,1,40
69,110,1,70,3,394,0,30
70,110,1,71,2,396,2,20
71,110,1,72,3,399,0,30
72,110,1,73,6,405,2,60
73,110,1,74,5,410,6,50
74,110,1,75,6,416,0,60
75,110,1,76,7,423,0,70
76,110,1,77,7,430,12,70
77,110,1,78,5,435,3,50
78,110,1,79,9,444,0,90
79,110,1,80,5,449,0,50
80,110,1,81,9,458,10,90
81,110,1,82,4,462,4,40
82,110,1,83,6,468,0,60
83,110,1,84,9,477,4,90
84,110,1,85,3,480,0,30
85,110,1,86,6,486,5,60
86,110,1,87,3,489,1,30
87,110,1,88,7,496,0,70
88,110,1,89,3,499,4,30
89,110,1,90,3,502,3,30
90,110,1,91,3,505,0,30
91,110,1,92,7,512,3,70
92,110,1,93,2,514,0,20
93,110,1,94,4,518,4,40
94,110,1,95,5,523,3,50
95,110,1,96,5,528,6,50
96,110,1,97,2,530,0,20
97,110,1,98,7,537,6,70
98,110,1,99,7,544,5,70
99,110,1,100,3,547,1,30
100,110,1,101,4,551,2,40
101,110,1,102,2,553,2,20
102,110,1,103,3,556,1,30
103,110,1,104,4,560,0,40
104,110,1,105,6,566,0,60
105,110,1,106,2,568,0,20
106,110,1,107,8,576,13,80
107,110,1,108,2,578,0,20
108,110,1,109,8,586,0,80
109,110,1,110,7,593,10,70
110,110,1,111,3,596,0,30
111,110,1,112,8,604,0,80
112,110,1,113,9,613,0,90
113,110,1,114,9,622,6,90
114,110,1,115,3,625,0,30
115,110,1,116,4,629,2,40
116,110,1,117,8,637,3,80
117,110,1,118,8,645,5,80
118,110,1,119,7,652,0,70
119,110,1,120,6,658,8,60
120,110,1,121,7,665,4,70
121,110,1,122,9,674,8,90
122,110,1,123,9,683,0,90
123,110,1,124,9,692,12,90
124,110,1,125,3,695,1,30
125,110,1,126,6,701,4,60
126,110,1,127,5,706,0,50
127,110,1,128,9,715,8,90
128,110,1,129,7,722,2,70
129,110,1,130,7,729,5,70
130,110,1,131,7,736,0,70
131,110,1,132,6,742,7,60
132,110,1,133,4,746,0,40
133,110,1,134,7,753,0,70
134,110,1,135,8,761,0,80
135,110,1,136,9,770,17,90
136,110,1,137,4,774,2,40
137,110,1,138,5,779,1,50
138,110,1,139,8,787,1,80
139,110,1,140,6,793,2,60
140,110,1,141,3,796,0,30
141,110,1,142,4,800,5,40
142,110,1,143,3,803,3,30
143,110,1,144,3,806,1,30
144,110,1,145,4,810,1,40
145,110,1,146,4,814,1,40
146,110,1,147,9,823,4,90
147,110,1,148,4,827,3,40
148,110,1,149,5,832,3,50
149,110,1,150,6,838,6,60
150,110,1,151,9,847,6,90
151,110,1,152,9,856,6,90
152,110,1,153,7,863,3,70
153,110,1,154,8,871,0,80
154,110,1,155,7,878,0,70
155,110,1,156,8,886,8,80
156,110,1,157,3,889,2,30
157,110,1,158,9,898,7,90
158,110,1,159,7,905,4,70
159,110,1,160,8,913,0,80
160,110,1,161,8,921,7,80
161,110,1,162,7,928,4,70
162,110,1,163,6,934,2,60
163,110,1,164,3,937,0,30
164,110,1,165,4,941,0,40
165,110,1,166,5,946,2,50
166,110,1,167,5,951,0,50
167,110,1,168,8,959,5,80
168,110,1,169,9,968,0,90
169,110,1,170,5,973,4,50
170,110,1,171,4,977,0,40
171,110,1,172,2,979,0,20
172,110,1,173,8,987,5,80
173,110,1,174,5,992,3,50
174,110,1,175,8,1000,0,80
175,110,1,176,3,1003,0,30
176,110,1,177,8,1011,6,80
177,110,1,178,8,1019,0,80
178,110,1,179,4,1023,6,40
179,110,1,180,7,1030,4,70
180,110,1,181,4,1034,3,40
181,110,1,182,4,1038,1,40
182,110,1,183,9,1047,2,90
183,110,1,184,6,1053,7,60
184,110,1,185,3,1056,3,30
185,110,1,186,8,1064,5,80
186,110,1,187,8,1072,0,80
187,110,1,188,8,1080,6,80
188,110,1,189,2,1082,0,20
189,110,1,190,3,1085,3,30
190,110,1,191,3,1088,0,30
191,110,1,192,3,1091,3,30
192,110,1,193,2,1093,2,20
193,110,1,194,3,1096,0,30
194,110,1,195,4,1100,0,40
195,110,1,196,8,1108,0,80
196,110,1,197,5,1113,5,50
197,110,1,198,3,1116,1,30
198,110,1,199,3,1119,1,30
199,110,1,200,6,1125,2,60
200,110,1,201,3,1128,0,30
201,110,1,202,8,1136,7,80
202,110,1,203,2,1138,1,20
203,110,1,204,3,1141,1,30
204,110,1,205,9,1150,4,90
205,110,1,206,7,1157,1,70
206,110,1,207,4,1161,0,40
207,110,1,208,6,1167,0,60
208,110,1,209,8,1175,0,80
209,110,1,210,8,1183,13,80
210,110,1,211,9,1192,3,90
211,110,1,212,5,1197,2,50
212,110,1,213,4,1201,0,40
213,110,1,214,4,1205,4,40
214,110,1,215,7,1212,0,70
215,110,1,216,8,1220,0,80
216,110,1,217,9,1229,0,90
217,110,1,218,3,1232,11,30
218,110,1,219,2,1234,0,20
219,110,1,220,6,1240,3,60
220,110,1,221,9,1249,6,90
221,110,1,222,3,1252,4,30
222,110,1,223,9,1261,5,90
223,110,1,224,2,1263,1,20
224,110,1,225,6,1269,5,60
225,110,1,226,8,1277,0,80
226,110,1,227,3,1280,3,30
227,110,1,228,5,1285,2,50
228,110,1,229,8,1293,4,80
229,110,1,230,6,1299,2,60
230,110,1,231,6,1305,0,60
231,110,1,232,4,1309,2,40
232,110,1,233,2,1311,0,20
233,110,1,234,5,1316,3,50
234,110,1,235,8,1324,0,80
235,110,1,236,8,1332,6,80
236,110,1,237,9,1341,5,90
237,110,1,238,8,1349,3,80
238,110,1,239,8,1357,5,80
239,110,1,240,3,1360,0,30
240,110,1,241,4,1364,0,40
241,110,1,242,8,1372,3,80
242,110,1,243,2,1374,0,20
243,110,1,244,2,1376,2,20
244,110,1,245,5,1381,2,50
245,110,1,246,8,1389,5,80
246,110,1,247,2,1391,1,20
247,110,1,248,3,1394,2,30
248,110,1,249,2,1396,3,20
249,110,1,250,7,1403,0,70
250,110,1,251,5,1408,8,50
251,110,1,252,9,1417,2,90
252,110,1,253,9,1426,6,90
253,110,1,254,8,1434,0,80
254,110,1,255,4,1438,4,40
255,110,1,256,9,1447,7,90
256,110,1,257,2,1449,1,20
257,110,1,258,7,1456,3,70
258,110,1,259,4,1460,3,40
259,110,1,260,3,1463,0,30
260,110,1,261,8,1471,0,80
261,110,1,262,8,1479,9,80
262,110,1,263,2,1481,0,20
263,110,1,264,4,1485,2,40
264,110,1,265,5,1490,0,50
265,110,1,266,3,1493,1,30
266,110,1,267,4,1497,1,40
267,110,1,268,7,1504,5,70
268,110,1,269,8,1512,5,80
269,110,1,270,7,1519,7,70
270,110,1,271,8,1527,2,80
271,110,1,272,4,1531,3,40
272,110,1,273,2,1533,1,20
273,110,1,274,5,1538,1,50
274,110,1,275,6,1544,0,60
275,110,1,276,6,1550,4,60
276,110,1,277,9,1559,3,90
277,110,1,278,8,1567,1,80
278,110,1,279,3,1570,1,30
279,110,1,280,2,1572,1,20
280,110,1,281,8,1580,0,80
281,110,1,282,2,1582,0,20
282,110,1,283,7,1589,15,70
283,110,1,284,4,1593,6,40
284,110,1,285,7,1600,0,70
285,110,1,286,5,1605,2,50
286,110,1,287,5,1610,2,50
287,110,1,288,6,1616,2,60
288,110,1,289,2,1618,0,20
289,110,1,290,7,1625,4,70
290,110,1,291,6,1631,3,60
291,110,1,292,3,1634,2,30
292,110,1,293,2,1636,1,20
293,110,1,294,5,1641,3,50
294,110,1,295,3,1644,1,30
295,110,1,296,5,1649,1,50
296,110,1,297,6,1655,6,60
297,110,1,298,8,1663,0,80
298,110,1,299,7,1670,7,70
299,110,1,300,9,1679,0,90
300,110,1,301,2,1681,4,20
301,110,1,302,5,1686,0,50
302,110,1,303,4,1690,0,40
303,110,1,304,2,1692,2,20
304,110,1,305,7,1699,5,70
305,110,1,306,2,1701,0,20
306,110,1,307,4,1705,0,40
307,110,1,308,9,1714,4,90
308,110,1,309,5,1719,0,50
309,110,1,310,9,1728,10,90
310,110,1,311,4,1732,0,40
311,110,1,312,5,1737,4,50
312,110,1,313,4,1741,2,40
313,110,1,314,8,1749,2,80
314,110,1,315,9,1758,0,90
315,110,1,316,3,1761,5,30
316,110,1,317,8,1769,0,80
317,110,1,318,5,1774,6,50
318,110,1,319,3,1777,1,30
319,110,1,320,3,1780,0,30
320,110,1,321,3,1783,1,30
321,110,1,322,5,1788,2,50
322,110,1,323,6,1794,4,60
323,110,1,324,6,1800,4,60
324,110,1,325,3,1803,0,30
325,110,1,326,4,1807,2,40
326,110,1,327,3,1810,0,30
327,110,1,328,8,1818,0,80
328,110,1,329,6,1824,0,60
329,110,1,330,2,1826,13,20
330,110,1,331,9,1835,9,90
331,110,1,332,5,1840,2,50
332,110,1,333,7,1847,1,70
333,110,1,334,8,1855,4,80
334,110,1,335,2,1857,1,20
335,110,1,336,4,1861,5,40
336,110,1,337,8,1869,0,80
337,110,1,338,8,1877,0,80
338,110,1,339,7,1884,6,70
339,110,1,340,7,1891,0,70
340,110,1,341,9,1900,8,90
341,110,1,342,6,1906,1,60
342,110,1,343,6,1912,0,60
343,110,1,344,8,1920,7,80
344,110,1,345,3,1923,1,30
345,110,1,346,3,1926,2,30
346,110,1,347,6,1932,4,60
347,110,1,348,9,1941,2,90
348,110,1,349,3,1944,0,30
349,110,1,350,8,1952,9,80
350,110,1,351,5,1957,0,50
351,110,1,352,5,1962,5,50
352,110,1,353,7,1969,4,70
353,110,1,354,9,1978,5,90
354,110,1,355,6,1984,4,60
355,110,1,356,2,1986,0,20
356,110,1,357,9,1995,8,90
357,110,1,358,5,2000,2,50
358,110,1,359,3,2003,0,30
359,110,1,360,9,2012,0,90
360,110,1,361,8,2020,8,80
361,110,1,362,2,2022,1,20
362,110,1,363,7,2029,1,70
363,110,1,364,8,2037,6,80
364,110,1,365,5,2042,3,50
365,110,1,366,7,2049,0,70
366,110,1,367,9,2058,10,90
367,110,1,368,5,2063,3,50
368,110,1,369,9,2072,0,90
369,110,1,370,3,2075,0,30
370,110,1,371,8,2083,13,80
371,110,1,372,5,2088,1,50
372,110,1,373,8,2096,6,80
373,110,1,374,3,2099,4,30
374,110,1,375,4,2103,3,40
375,110,1,376,9,2112,1,90
376,110,1,377,2,2114,0,20
377,110,1,378,5,2119,0,50
378,110,1,379,6,2125,1,60
379,110,1,380,4,2129,2,40
380,110,1,381,9,2138,7,90
381,110,1,382,2,2140,1,20
382,110,1,383,7,2147,0,70
383,110,1,384,5,2152,4,50
384,110,1,385,8,2160,0,80
385,110,1,386,8,2168,0,80
386,110,1,387,9,2177,11,90
387,110,1,388,3,2180,1,30
388,110,1,389,6,2186,6,60
389,110,1,390,2,2188,0,20
390,110,1,391,8,2196,3,80
391,110,1,392,6,2202,4,60
392,110,1,393,6,2208,4,60
393,110,1,394,3,2211,0,30
394,110,1,395,9,2220,5,90
395,110,1,396,9,2229,3,90
396,110,1,397,2,2231,1,20
397,110,1,398,3,2234,3,30
398,110,1,399,8,2242,0,80
399,110,1,400,2,2244,0,20
400,110,1,401,2,2246,0,20
401,110,1,402,8,2254,10,80
402,110,1,403,2,2256,1,20
403,110,1,404,6,2262,4,60
404,110,1,405,9,2271,6,90
405,110,1,406,8,2279,5,80
406,110,1,407,3,2282,0,30
407,110,1,408,6,2288,0,60
408,110,1,409,8,2296,0,80
409,110,1,410,7,2303,0,70
410,110,1,411,7,2310,8,70
411,110,1,412,9,2319,4,90
412,110,1,413,3,2322,0,30
413,110,1,414,7,2329,0,70
414,110,1,415,7,2336,0,70
415,110,1,416,2,2338,10,20
416,110,1,417,9,2347,0,90
417,110,1,418,2,2349,5,20
418,110,1,419,7,2356,0,70
419,110,1,420,7,2363,0,70
420,110,1,421,2,2365,7,20
421,110,1,422,9,2374,6,90
422,110,1,423,8,2382,5,80
423,110,1,424,6,2388,3,60
424,110,1,425,2,2390,0,20
425,110,1,426,4,2394,0,40
426,110,1,427,6,2400,7,60
427,110,1,428,7,2407,5,70
428,110,1,429,8,2415,6,80
429,110,1,430,9,2424,2,90
430,110,1,431,2,2426,0,20
431,110,1,432,7,2433,6,70
432,110,1,433,5,2438,3,50
433,110,1,434,9,2447,0,90
434,110,1,435,4,2451,7,40
435,110,1,436,5,2456,1,50
436,110,1,437,7,2463,0,70
437,110,1,438,8,2471,7,80
438,110,1,439,6,2477,7,60
439,110,1,440,6,2483,2,60
440,110,1,441,5,2488,5,50
441,110,1,442,9,2497,0,90
442,110,1,443,9,2506,0,90
443,110,1,444,8,2514,16,80
444,110,1,445,9,2523,10,90
445,110,1,446,3,2526,0,30
446,110,1,447,2,2528,0,20
447,110,1,448,7,2535,4,70
448,110,1,449,7,2542,2,70
449,110,1,450,2,2544,0,20
450,110,1,451,9,2553,0,90
451,110,1,452,8,2561,0,80
452,110,1,453,8,2569,16,80
453,110,1,454,4,2573,2,40
454,110,1,455,5,2578,1,50
455,110,1,456,2,2580,0,20
456,110,1,457,9,2589,5,90
457,110,1,458,7,2596,2,70
458,110,1,459,4,2600,3,40
459,110,1,460,3,2603,1,30
460,110,1,461,5,2608,2,50
461,110,1,462,6,2614,5,60
462,110,1,463,4,2618,3,40
463,110,1,464,6,2624,3,60
464,110,1,465,6,2630,3,60
465,110,1,466,8,2638,5,80
466,110,1,467,6,2644,5,60
467,110,1,468,4,2648,2,40
468,110,1,469,9,2657,6,90
469,110,1,470,5,2662,1,50
470,110,1,471,2,2664,1,20
471,110,1,472,6,2670,2,60
472,110,1,473,2,2672,0,20
473,110,1,474,2,2674,0,20
474,110,1,475,5,2679,4,50
475,110,1,476,5,2684,0,50
476,110,1,477,3,2687,3,30
477,110,1,478,3,2690,0,30
478,110,1,479,6,2696,4,60
479,110,1,480,8,2704,0,80
480,110,1,481,7,2711,0,70
481,110,1,482,9,2720,10,90
482,110,1,483,5,2725,6,50
483,110,1,484,5,2730,0,50
484,110,1,485,5,2735,5,50
485,110,1,486,5,2740,4,50
486,110,1,487,7,2747,4,70
487,110,1,488,4,2751,2,40
488,110,1,489,2,2753,1,20
489,110,1,490,2,2755,0,20
490,110,1,491,6,2761,0,60
491,110,1,492,9,2770,10,90
492,110,1,493,4,2774,0,40
493,110,1,494,2,2776,4,20
494,110,1,495,8,2784,0,80
495,110,1,496,3,2787,4,30
496,110,1,497,9,2796,4,90
497,110,1,498,3,2799,0,30
498,110,1,499,7,2806,3,70
499,110,1,500,3,2809,1,30
500,110,1,501,2,2811,0,20
501,110,1,502,2,2813,0,20
502,110,1,503,2,2815,2,20
503,110,1,504,4,2819,0,40
504,110,1,505,2,2821,1,20
505,110,1,506,4,2825,6,40
506,110,1,507,3,2828,0,30
507,110,1,508,3,2831,1,30
508,110,1,509,4,2835,4,40
509,110,1,510,4,2839,0,40
510,110,1,511,4,2843,2,40
511,110,1,512,9,2852,4,90
512,110,1,513,6,2858,6,60
513,110,1,514,6,2864,2,60
514,110,1,515,7,2871,0,70
515,110,1,516,9,2880,0,90
516,110,1,517,7,2887,10,70
517,110,1,518,4,2891,1,40
518,110,1,519,4,2895,2,40
519,110,1,520,3,2898,0,30
520,110,1,521,2,2900,0,20
521,110,1,522,9,2909,8,90
522,110,1,523,2,2911,2,20
523,110,1,524,6,2917,1,60
524,110,1,525,5,2922,0,50
525,110,1,526,8,2930,3,80
526,110,1,527,8,2938,6,80
527,110,1,528,5,2943,3,50
528,110,1,529,3,2946,1,30
529,110,1,530,7,2953,0,70
530,110,1,531,5,2958,7,50
531,110,1,532,7,2965,5,70
532,110,1,533,3,2968,3,30
533,110,1,534,7,2975,5,70
534,110,1,535,9,2984,3,90
535,110,1,536,9,2993,2,90
536,110,1,537,5,2998,2,50
537,110,1,538,3,3001,1,30
538,110,1,539,6,3007,4,60
539,110,1,540,5,3012,2,50
540,110,1,541,5,3017,0,50
541,110,1,542,2,3019,2,20
542,110,1,543,2,3021,1,20
543,110,1,544,8,3029,0,80
544,110,1,545,9,3038,9,90
545,110,1,546,2,3040,0,20
546,110,1,547,8,3048,3,80
547,110,1,548,6,3054,2,60
548,110,1,549,5,3059,3,50
549,110,1,550,6,3065,0,60
550,110,1,551,2,3067,8,20
551,110,1,552,3,3070,3,30
552,110,1,553,5,3075,2,50
553,110,1,554,3,3078,2,30
554,110,1,555,9,3087,5,90
555,110,1,556,6,3093,4,60
556,110,1,557,3,3096,1,30
557,110,1,558,7,3103,2,70
558,110,1,559,9,3112,2,90
559,110,1,560,6,3118,0,60
560,110,1,561,5,3123,0,50
561,110,1,562,6,3129,0,60
562,110,1,563,3,3132,6,30
563,110,1,564,7,3139,3,70
564,110,1,565,2,3141,3,20
565,110,1,566,2,3143,2,20
566,110,1,567,3,3146,0,30
567,110,1,568,2,3148,1,20
568,110,1,569,7,3155,0,70
569,110,1,570,7,3162,7,70
570,110,1,571,3,3165,1,30
571,110,1,572,8,3173,8,80
572,110,1,573,4,3177,0,40
573,110,1,574,9,3186,0,90
574,110,1,575,9,3195,0,90
575,110,1,576,4,3199,12,40
576,110,1,577,6,3205,0,60
577,110,1,578,5,3210,2,50
578,110,1,579,4,3214,1,40
579,110,1,580,5,3219,0,50
580,110,1,581,9,3228,0,90
581,110,1,582,5,3233,10,50
582,110,1,583,4,3237,1,40
583,110,1,584,3,3240,1,30
584,110,1,585,9,3249,7,90
585,110,1,586,2,3251,0,20
586,110,1,587,4,3255,0,40
587,110,1,588,3,3258,3,30
588,110,1,589,4,3262,0,40
589,110,1,590,9,3271,3,90
590,110,1,591,7,3278,3,70
591,110,1,592,7,3285,4,70
592,110,1,593,2,3287,3,20
593,110,1,594,3,3290,0,30
594,110,1,595,7,3297,4,70
595,110,1,596,7,3304,0,70
596,110,1,597,7,3311,13,70
597,110,1,598,6,3317,5,60
598,110,1,599,7,3324,2,70
599,110,1,600,2,3326,0,20
600,110,1,601,3,3329,6,30
601,110,1,602,2,3331,0,20
602,110,1,603,7,3338,1,70
603,110,1,604,7,3345,0,70
604,110,1,605,7,3352,7,70
605,110,1,606,2,3354,0,20
606,110,1,607,6,3360,7,60
607,110,1,608,9,3369,2,90
608,110,1,609,9,3378,3,90
609,110,1,610,6,3384,3,60
610,110,1,611,7,3391,7,70
611,110,1,612,6,3397,0,60
612,110,1,613,6,3403,0,60
613,110,1,614,4,3407,4,40
614,110,1,615,7,3414,0,70
615,110,1,616,4,3418,3,40
616,110,1,617,7,3425,2,70
617,110,1,618,7,3432,4,70
618,110,1,619,4,3436,3,40
619,110,1,620,7,3443,0,70
620,110,1,621,2,3445,0,20
621,110,1,622,2,3447,7,20
622,110,1,623,5,3452,3,50
623,110,1,624,4,3456,5,40
624,110,1,625,8,3464,2,80
625,110,1,626,3,3467,0,30
626,110,1,627,2,3469,0,20
627,110,1,628,3,3472,2,30
628,110,1,629,2,3474,0,20
629,110,1,630,6,3480,3,60
630,110,1,631,8,3488,3,80
631,110,1,632,7,3495,5,70
632,110,1,633,8,3503,4,80
633,110,1,634,3,3506,2,30
634,110,1,635,9,3515,0,90
635,110,1,636,7,3522,0,70
636,110,1,637,2,3524,11,20
637,110,1,638,6,3530,2,60
638,110,1,639,6,3536,4,60
639,110,1,640,8,3544,2,80
640,110,1,641,6,3550,0,60
641,110,1,642,4,3554,5,40
642,110,1,643,7,3561,3,70
643,110,1,644,4,3565,0,40
644,110,1,645,9,3574,8,90
645,110,1,646,7,3581,5,70
646,110,1,647,9,3590,4,90
647,110,1,648,8,3598,0,80
648,110,1,649,6,3604,0,60
649,110,1,650,9,3613,0,90
650,110,1,651,6,3619,6,60
651,110,1,652,8,3627,1,80
652,110,1,653,4,3631,0,40
653,110,1,654,8,3639,8,80
654,110,1,655,3,3642,1,30
655,110,1,656,9,3651,0,90
656,110,1,657,7,3658,4,70
657,110,1,658,8,3666,0,80
658,110,1,659,6,3672,0,60
659,110,1,660,6,3678,13,60
660,110,1,661,9,3687,1,90
661,110,1,662,2,3689,1,20
662,110,1,663,4,3693,2,40
663,110,1,664,8,3701,7,80
664,110,1,665,2,3703,0,20
665,110,1,666,7,3710,0,70
666,110,1,667,9,3719,6,90
667,110,1,668,2,3721,0,20
668,110,1,669,4,3725,0,40
669,110,1,670,9,3734,7,90
670,110,1,671,9,3743,4,90
671,110,1,672,7,3750,3,70
672,110,1,673,6,3756,5,60
673,110,1,674,6,3762,4,60
674,110,1,675,6,3768,2,60
675,110,1,676,2,3770,0,20
676,110,1,677,8,3778,4,80
677,110,1,678,2,3780,0,20
678,110,1,679,6,3786,0,60
679,110,1,680,6,3792,8,60
680,110,1,681,9,3801,0,90
681,110,1,682,9,3810,8,90
682,110,1,683,7,3817,0,70
683,110,1,684,9,3826,6,90
684,110,1,685,9,3835,0,90
685,110,1,686,3,3838,4,30
686,110,1,687,2,3840,0,20
687,110,1,688,9,3849,3,90
688,110,1,689,4,3853,1,40
689,110,1,690,4,3857,0,40
690,110,1,691,4,3861,0,40
691,110,1,692,6,3867,7,60
692,110,1,693,9,3876,4,90
693,110,1,694,6,3882,0,60
694,110,1,695,2,3884,0,20
695,110,1,696,4,3888,6,40
696,110,1,697,2,3890,0,20
697,110,1,698,6,3896,5,60
698,110,1,699,7,3903,6,70
699,110,1,700,9,3912,3,90
700,110,1,701,7,3919,4,70
701,110,1,702,7,3926,3,70
702,110,1,703,6,3932,0,60
703,110,1,704,8,3940,0,80
704,110,1,705,5,3945,0,50
705,110,1,706,3,3948,9,30
706,110,1,707,3,3951,0,30
707,110,1,708,7,3958,3,70
708,110,1,709,4,3962,1,40
709,110,1,710,9,3971,9,90
710,110,1,711,4,3975,1,40
711,110,1,712,2,3977,2,20
712,110,1,713,9,3986,0,90
713,110,1,714,2,3988,3,20
714,110,1,715,7,3995,0,70
715,110,1,716,8,4003,8,80
716,110,1,717,5,4008,1,50
717,110,1,718,2,4010,0,20
718,110,1,719,5,4015,1,50
719,110,1,720,6,4021,6,60
720,110,1,721,4,4025,6,40
721,110,1,722,2,4027,2,20
722,110,1,723,4,4031,1,40
723,110,1,724,8,4039,4,80
724,110,1,725,3,4042,2,30
725,110,1,726,2,4044,0,20
726,110,1,727,4,4048,4,40
727,110,1,728,8,4056,4,80
728,110,1,729,2,4058,0,20
729,110,1,730,3,4061,0,30
730,110,1,731,2,4063,5,20
731,110,1,732,6,4069,0,60
732,110,1,733,5,4074,7,50
733,110,1,734,6,4080,1,60
734,110,1,735,5,4085,0,50
735,110,1,736,3,4088,0,30
736,110,1,737,6,4094,8,60
737,110,1,738,9,4103,3,90
738,110,1,739,2,4105,2,20
739,110,1,740,2,4107,0,20
740,110,1,741,4,4111,0,40
741,110,1,742,4,4115,2,40
742,110,1,743,4,4119,3,40
743,110,1,744,6,4125,2,60
744,110,1,745,5,4130,2,50
745,110,1,746,8,4138,5,80
746,110,1,747,4,4142,0,40
747,110,1,748,3,4145,0,30
748,110,1,749,8,4153,9,80
749,110,1,750,2,4155,2,20
750,110,1,751,9,4164,0,90
751,110,1,752,4,4168,2,40
752,110,1,753,9,4177,0,90
753,110,1,754,6,4183,11,60
754,110,1,755,8,4191,2,80
755,110,1,756,8,4199,3,80
756,110,1,757,4,4203,1,40
757,110,1,758,2,4205,0,20
758,110,1,759,5,4210,0,50
759,110,1,760,4,4214,5,40
760,110,1,761,8,4222,0,80
761,110,1,762,4,4226,2,40
762,110,1,763,6,4232,0,60
763,110,1,764,8,4240,0,80
764,110,1,765,6,4246,0,60
765,110,1,766,2,4248,11,20
766,110,1,767,2,4250,0,20
767,110,1,768,2,4252,0,20
768,110,1,769,5,4257,0,50
769,110,1,770,5,4262,0,50
770,110,1,771,5,4267,6,50
771,110,1,772,6,4273,0,60
772,110,1,773,8,4281,5,80
773,110,1,774,3,4284,3,30
774,110,1,775,3,4287,0,30
775,110,1,776,4,4291,2,40
776,110,1,777,5,4296,0,50
777,110,1,778,2,4298,5,20
778,110,1,779,6,4304,0,60
779,110,1,780,9,4313,5,90
780,110,1,781,8,4321,2,80
781,110,1,782,2,4323,2,20
782,110,1,783,4,4327,2,40
783,110,1,784,3,4330,1,30
784,110,1,785,2,4332,0,20
785,110,1,786,3,4335,0,30
786,110,1,787,7,4342,3,70
787,110,1,788,8,4350,5,80
788,110,1,789,6,4356,3,60
789,110,1,790,3,4359,0,30
790,110,1,791,2,4361,8,20
791,110,1,792,7,4368,1,70
792,110,1,793,4,4372,2,40
793,110,1,794,9,4381,6,90
794,110,1,795,4,4385,0,40
795,110,1,796,7,4392,0,70
796,110,1,797,7,4399,9,70
797,110,1,798,9,4408,5,90
798,110,1,799,9,4417,0,90
799,110,1,800,3,4420,6,30
800,110,1,801,4,4424,2,40
801,110,1,802,8,4432,4,80
802,110,1,803,3,4435,0,30
803,110,1,804,2,4437,1,20
804,110,1,805,3,4440,0,30
805,110,1,806,3,4443,0,30
806,110,1,807,6,4449,8,60
807,110,1,808,8,4457,4,80
808,110,1,809,4,4461,2,40
809,110,1,810,5,4466,4,50
810,110,1,811,9,4475,5,90
811,110,1,812,9,4484,8,90
812,110,1,813,4,4488,3,40
813,110,1,814,9,4497,3,90
814,110,1,815,8,4505,4,80
815,110,1,816,6,4511,0,60
816,110,1,817,9,4520,11,90
817,110,1,818,3,4523,2,30
818,110,1,819,5,4528,0,50
819,110,1,820,5,4533,7,50
820,110,1,821,9,4542,4,90
821,110,1,822,4,4546,1,40
822,110,1,823,4,4550,5,40
823,110,1,824,2,4552,0,20
824,110,1,825,7,4559,1,70
825,110,1,826,3,4562,1,30
826,110,1,827,5,4567,0,50
827,110,1,828,4,4571,2,40
828,110,1,829,6,4577,4,60
829,110,1,830,6,4583,8,60
830,110,1,831,5,4588,3,50
831,110,1,832,7,4595,2,70
832,110,1,833,7,4602,3,70
833,110,1,834,3,4605,1,30
834,110,1,835,4,4609,0,40
835,110,1,836,5,4614,2,50
836,110,1,837,6,4620,2,60
837,110,1,838,5,4625,1,50
838,110,1,839,5,4630,1,50
839,110,1,840,8,4638,4,80
840,110,1,841,8,4646,0,80
841,110,1,842,9,4655,14,90
842,110,1,843,2,4657,0,20
843,110,1,844,4,4661,2,40
844,110,1,845,4,4665,3,40
845,110,1,846,5,4670,4,50
846,110,1,847,7,4677,0,70
847,110,1,848,5,4682,0,50
848,110,1,849,5,4687,3,50
849,110,1,850,3,4690,3,30
850,110,1,851,9,4699,4,90
851,110,1,852,2,4701,1,20
852,110,1,853,4,4705,3,40
853,110,1,854,9,4714,0,90
854,110,1,855,2,4716,0,20
855,110,1,856,4,4720,0,40
856,110,1,857,3,4723,16,30
857,110,1,858,3,4726,0,30
858,110,1,859,2,4728,2,20
859,110,1,860,9,4737,0,90
860,110,1,861,9,4746,10,90
861,110,1,862,5,4751,3,50
862,110,1,863,4,4755,0,40
863,110,1,864,6,4761,0,60
864,110,1,865,2,4763,4,20
865,110,1,866,4,4767,0,40
866,110,1,867,4,4771,4,40
867,110,1,868,5,4776,0,50
868,110,1,869,3,4779,7,30
869,110,1,870,3,4782,3,30
870,110,1,871,4,4786,1,40
871,110,1,872,5,4791,2,50
872,110,1,873,8,4799,4,80
873,110,1,874,3,4802,2,30
874,110,1,875,9,4811,6,90
875,110,1,876,9,4820,4,90
876,110,1,877,4,4824,0,40
877,110,1,878,6,4830,1,60
878,110,1,879,3,4833,0,30
879,110,1,880,4,4837,6,40
880,110,1,881,3,4840,0,30
881,110,1,882,4,4844,5,40
882,110,1,883,2,4846,0,20
883,110,1,884,5,4851,0,50
884,110,1,885,4,4855,0,40
885,110,1,886,9,4864,10,90
886,110,1,887,5,4869,0,50
887,110,1,888,3,4872,2,30
888,110,1,889,5,4877,0,50
889,110,1,890,8,4885,0,80
890,110,1,891,2,4887,0,20
891,110,1,892,6,4893,8,60
892,110,1,893,7,4900,4,70
893,110,1,894,3,4903,4,30
894,110,1,895,5,4908,0,50
895,110,1,896,4,4912,0,40
896,110,1,897,3,4915,4,30
897,110,1,898,7,4922,7,70
898,110,1,899,9,4931,0,90
899,110,1,900,8,4939,4,80
900,110,1,901,3,4942,4,30
901,110,1,902,6,4948,0,60
902,110,1,903,4,4952,4,40
903,110,1,904,9,4961,3,90
904,110,1,905,2,4963,2,20
905,110,1,906,7,4970,2,70
906,110,1,907,7,4977,4,70
907,110,1,908,4,4981,0,40
908,110,1,909,5,4986,3,50
909,110,1,910,6,4992,2,60
910,110,1,911,3,4995,0,30
911,110,2,1,6,6,4,60
912,110,2,2,6,12,3,60
913,110,2,3,3,15,0,30
914,110,2,4,6,21,4,60
915,110,2,5,5,26,1,50
916,110,2,6,9,35,7,90
917,110,2,7,9,44,6,90
918,110,2,8,7,51,0,70
919,110,2,9,2,53,6,20
920,110,2,10,6,59,0,60
921,110,2,11,4,63,0,40
922,110,2,12,2,65,6,20
923,110,2,13,7,72,3,70
924,110,2,14,7,79,7,70
925,110,2,15,5,84,0,50
926,110,2,16,8,92,0,80
927,110,2,17,7,99,13,70
928,110,2,18,4,103,3,40
929,110,2,19,2,105,0,20
930,110,2,20,9,114,3,90
931,110,2,21,6,120,2,60
932,110,2,22,5,125,0,50
933,110,2,23,9,134,4,90
934,110,2,24,6,140,0,60
935,110,2,25,6,146,6,60
936,110,2,26,3,149,3,30
937,110,2,27,5,154,5,50
938,110,2,28,8,162,7,80
939,110,2,29,6,168,0,60
940,110,2,30,6,174,0,60
941,110,2,31,7,181,0,70
942,110,2,32,9,190,3,90
943,110,2,33,8,198,3,80
944,110,2,34,6,204,2,60
945,110,2,35,2,206,1,20
946,110,2,36,7,213,3,70
947,110,2,37,2,215,2,20
948,110,2,38,6,221,5,60
949,110,2,39,8,229,0,80
950,110,2,40,7,236,0,70
951,110,2,41,5,241,0,50
952,110,2,42,6,247,0,60
953,110,2,43,7,254,18,70
954,110,2,44,2,256,1,20
955,110,2,45,4,260,3,40
956,110,2,46,3,263,0,30
957,110,2,47,9,272,0,90
958,110,2,48,6,278,0,60
959,110,2,49,5,283,10,50
960,110,2,50,9,292,0,90
961,110,2,51,9,301,12,90
962,110,2,52,6,307,5,60
963,110,2,53,2,309,0,20
964,110,2,54,8,317,0,80
965,110,2,55,5,322,7,50
966,110,2,56,9,331,3,90
967,110,2,57,2,333,0,20
968,110,2,58,6,339,5,60
969,110,2,59,5,344,1,50
970,110,2,60,8,352,2,80
971,110,2,61,6,358,3,60
972,110,2,62,8,366,0,80
973,110,2,63,3,369,5,30
974,110,2,64,5,374,0,50
975,110,2,65,6,380,2,60
976,110,2,66,4,384,3,40
977,110,2,67,8,392,5,80
978,110,2,68,8,400,7,80
979,110,2,69,4,404,2,40
980,110,2,70,7,411,1,70
981,110,2,71,2,413,0,20
982,110,2,72,5,418,5,50
983,110,2,73,5,423,2,50
984,110,2,74,7,430,3,70
985,110,2,75,6,436,3,60
986,110,2,76,5,441,4,50
987,110,2,77,4,445,2,40
988,110,2,78,6,451,3,60
989,110,2,79,5,456,0,50
990,110,2,80,7,463,0,70
991,110,2,81,3,466,6,30
992,110,2,82,9,475,4,90
993,110,2,83,9,484,7,90
994,110,2,84,2,486,0,20
995,110,2,85,8,494,0,80
996,110,2,86,4,498,5,40
997,110,2,87,2,500,1,20
998,110,2,88,6,506,3,60
999,110,2,89,7,513,2,70
1000,110,2,90,9,522,0,90
1001,110,2,91,4,526,9,40
1002,110,2,92,3,529,0,30
1003,110,2,93,4,533,5,40
1004,110,2,94,3,536,0,30
1005,110,2,95,8,544,5,80
1006,110,2,96,9,553,7,90
1007,110,2,97,3,556,1,30
1008,110,2,98,6,562,0,60
1009,110,2,99,8,570,0,80
1010,110,2,100,6,576,7,60
1011,110,2,101,8,584,4,80
1012,110,2,102,5,589,0,50
1013,110,2,103,6,595,2,60
1014,110,2,104,9,604,4,90
1015,110,2,105,6,610,3,60
1016,110,2,106,3,613,0,30
1017,110,2,107,6,619,5,60
1018,110,2,108,2,621,2,20
1019,110,2,109,5,626,5,50
1020,110,2,110,2,628,0,20
1021,110,2,111,7,635,3,70
1022,110,2,112,6,641,3,60
1023,110,2,113,9,650,3,90
1024,110,2,114,4,654,2,40
1025,110,2,115,4,658,3,40
1026,110,2,116,6,664,1,60
1027,110,2,117,4,668,2,40
1028,110,2,118,7,675,2,70
1029,110,2,119,4,679,3,40
1030,110,2,120,3,682,1,30
1031,110,2,121,2,684,1,20
1032,110,2,122,7,691,3,70
1033,110,2,123,4,695,0,40
1034,110,2,124,8,703,3,80
1035,110,2,125,5,708,2,50
1036,110,2,126,8,716,3,80
1037,110,2,127,8,724,6,80
1038,110,2,128,2,726,0,20
1039,110,2,129,6,732,2,60
1040,110,2,130,6,738,1,60
1041,110,2,131,9,747,6,90
1042,110,2,132,4,751,0,40
1043,110,2,133,4,755,0,40
1044,110,2,134,2,757,5,20
1045,110,2,135,9,766,3,90
1046,110,2,136,2,768,1,20
1047,110,2,137,3,771,1,30
1048,110,2,138,9,780,0,90
1049,110,2,139,3,783,4,30
1050,110,2,140,6,789,2,60
1051,110,2,141,4,793,1,40
1052,110,2,142,6,799,3,60
1053,110,2,143,4,803,0,40
1054,110,2,144,4,807,0,40
1055,110,2,145,3,810,1,30
1056,110,2,146,9,819,6,90
1057,110,2,147,3,822,0,30
1058,110,2,148,2,824,1,20
1059,110,2,149,5,829,1,50
1060,110,2,150,3,832,2,30
1061,110,2,151,4,836,2,40
1062,110,2,152,5,841,0,50
1063,110,2,153,2,843,0,20
1064,110,2,154,4,847,0,40
1065,110,2,155,5,852,4,50
1066,110,2,156,8,860,3,80
1067,110,2,157,4,864,0,40
1068,110,2,158,9,873,5,90
1069,110,2,159,6,879,2,60
1070,110,2,160,8,887,1,80
1071,110,2,161,5,892,2,50
1072,110,2,162,3,895,3,30
1073,110,2,163,6,901,1,60
1074,110,2,164,4,905,3,40
1075,110,2,165,3,908,0,30
1076,110,2,166,5,913,9,50
1077,110,2,167,8,921,5,80
1078,110,2,168,6,927,0,60
1079,110,2,169,5,932,5,50
1080,110,2,170,7,939,8,70
1081,110,2,171,8,947,0,80
1082,110,2,172,3,950,2,30
1083,110,2,173,3,953,4,30
1084,110,2,174,6,959,2,60
1085,110,2,175,6,965,0,60
1086,110,2,176,2,967,1,20
1087,110,2,177,3,970,2,30
1088,110,2,178,3,973,1,30
1089,110,2,179,4,977,0,40
1090,110,2,180,8,985,5,80
1091,110,2,181,4,989,2,40
1092,110,2,182,6,995,0,60
1093,110,2,183,4,999,11,40
1094,110,2,184,3,1002,0,30
1095,110,2,185,4,1006,4,40
1096,110,2,186,9,1015,4,90
1097,110,2,187,2,1017,1,20
1098,110,2,188,5,1022,2,50
1099,110,2,189,3,1025,2,30
1100,110,2,190,8,1033,0,80
1101,110,2,191,5,1038,8,50
1102,110,2,192,7,1045,1,70
1103,110,2,193,9,1054,5,90
1104,110,2,194,2,1056,0,20
1105,110,2,195,4,1060,4,40
1106,110,2,196,7,1067,2,70
1107,110,2,197,4,1071,0,40
1108,110,2,198,8,1079,0,80
1109,110,2,199,9,1088,7,90
1110,110,2,200,3,1091,2,30
1111,110,2,201,7,1098,4,70
1112,110,2,202,5,1103,3,50
1113,110,2,203,5,1108,1,50
1114,110,2,204,7,1115,4,70
1115,110,2,205,3,1118,0,30
1116,110,2,206,4,1122,1,40
1117,110,2,207,5,1127,3,50
1118,110,2,208,8,1135,1,80
1119,110,2,209,3,1138,3,30
1120,110,2,210,7,1145,0,70
1121,110,2,211,8,1153,0,80
1122,110,2,212,5,1158,7,50
1123,110,2,213,5,1163,0,50
1124,110,2,214,9,1172,0,90
1125,110,2,215,2,1174,0,20
1126,110,2,216,8,1182,14,80
1127,110,2,217,6,1188,0,60
1128,110,2,218,9,1197,13,90
1129,110,2,219,7,1204,0,70
1130,110,2,220,7,1211,0,70
1131,110,2,221,6,1217,10,60
1132,110,2,222,8,1225,0,80
1133,110,2,223,6,1231,6,60
1134,110,2,224,6,1237,3,60
1135,110,2,225,6,1243,1,60
1136,110,2,226,5,1248,6,50
1137,110,2,227,5,1253,2,50
1138,110,2,228,3,1256,3,30
1139,110,2,229,3,1259,0,30
1140,110,2,230,7,1266,3,70
1141,110,2,231,8,1274,3,80
1142,110,2,232,2,1276,2,20
1143,110,2,233,9,1285,7,90
1144,110,2,234,9,1294,4,90
1145,110,2,235,9,1303,7,90
1146,110,2,236,7,1310,3,70
1147,110,2,237,4,1314,2,40
1148,110,2,238,5,1319,1,50
1149,110,2,239,8,1327,1,80
1150,110,2,240,5,1332,4,50
1151,110,2,241,7,1339,0,70
1152,110,2,242,4,1343,8,40
1153,110,2,243,7,1350,3,70
1154,110,2,244,9,1359,0,90
1155,110,2,245,3,1362,2,30
1156,110,2,246,9,1371,0,90
1157,110,2,247,9,1380,8,90
1158,110,2,248,6,1386,6,60
1159,110,2,249,8,1394,5,80
1160,110,2,250,4,1398,1,40
1161,110,2,251,8,1406,3,80
1162,110,2,252,8,1414,0,80
1163,110,2,253,4,1418,9,40
1164,110,2,254,9,1427,4,90
1165,110,2,255,4,1431,0,40
1166,110,2,256,6,1437,2,60
1167,110,2,257,3,1440,2,30
1168,110,2,258,3,1443,2,30
1169,110,2,259,8,1451,6,80
1170,110,2,260,6,1457,3,60
1171,110,2,261,7,1464,5,70
1172,110,2,262,2,1466,0,20
1173,110,2,263,3,1469,0,30
1174,110,2,264,6,1475,10,60
1175,110,2,265,8,1483,3,80
1176,110,2,266,4,1487,3,40
1177,110,2,267,2,1489,0,20
1178,110,2,268,7,1496,3,70
1179,110,2,269,8,1504,6,80
1180,110,2,270,5,1509,0,50
1181,110,2,271,4,1513,0,40
1182,110,2,272,6,1519,3,60
1183,110,2,273,2,1521,0,20
1184,110,2,274,4,1525,1,40
1185,110,2,275,8,1533,4,80
1186,110,2,276,4,1537,1,40
1187,110,2,277,6,1543,4,60
1188,110,2,278,4,1547,3,40
1189,110,2,279,5,1552,3,50
1190,110,2,280,4,1556,2,40
1191,110,2,281,4,1560,2,40
1192,110,2,282,2,1562,0,20
1193,110,2,283,8,1570,7,80
1194,110,2,284,7,1577,0,70
1195,110,2,285,3,1580,5,30
1196,110,2,286,4,1584,0,40
1197,110,2,287,5,1589,2,50
1198,110,2,288,4,1593,2,40
1199,110,2,289,3,1596,0,30
1200,110,2,290,9,1605,0,90
1201,110,2,291,2,1607,9,20
1202,110,2,292,2,1609,1,20
1203,110,2,293,8,1617,5,80
1204,110,2,294,8,1625,0,80
1205,110,2,295,2,1627,4,20
1206,110,2,296,4,1631,1,40
1207,110,2,297,7,1638,6,70
1208,110,2,298,7,1645,0,70
1209,110,2,299,4,1649,0,40
1210,110,2,300,8,1657,11,80
1211,110,2,301,3,1660,0,30
1212,110,2,302,3,1663,0,30
1213,110,2,303,7,1670,0,70
1214,110,2,304,5,1675,9,50
1215,110,2,305,8,1683,4,80
1216,110,2,306,5,1688,4,50
1217,110,2,307,5,1693,1,50
1218,110,2,308,7,1700,2,70
1219,110,2,309,9,1709,0,90
1220,110,2,310,9,1718,9,90
1221,110,2,311,4,1722,0,40
1222,110,2,312,5,1727,5,50
1223,110,2,313,5,1732,3,50
1224,110,2,314,7,1739,3,70
1225,110,2,315,3,1742,1,30
1226,110,2,316,3,1745,2,30
1227,110,2,317,8,1753,6,80
1228,110,2,318,4,1757,0,40
1229,110,2,319,6,1763,3,60
1230,110,2,320,8,1771,4,80
1231,110,2,321,8,1779,3,80
1232,110,2,322,3,1782,1,30
1233,110,2,323,3,1785,0,30
1234,110,2,324,7,1792,8,70
1235,110,2,325,7,1799,3,70
1236,110,2,326,3,1802,0,30
1237,110,2,327,9,1811,1,90
1238,110,2,328,8,1819,0,80
1239,110,2,329,9,1828,0,90
1240,110,2,330,2,1830,0,20
1241,110,2,331,7,1837,16,70
1242,110,2,332,6,1843,0,60
1243,110,2,333,3,1846,5,30
1244,110,2,334,5,1851,0,50
1245,110,2,335,6,1857,0,60
1246,110,2,336,6,1863,0,60
1247,110,2,337,3,1866,4,30
1248,110,2,338,9,1875,6,90
1249,110,2,339,6,1881,1,60
1250,110,2,340,3,1884,1,30
1251,110,2,341,6,1890,6,60
1252,110,2,342,2,1892,0,20
1253,110,2,343,8,1900,9,80
1254,110,2,344,8,1908,0,80
1255,110,2,345,2,1910,3,20
1256,110,2,346,3,1913,1,30
1257,110,2,347,5,1918,2,50
1258,110,2,348,8,1926,0,80
1259,110,2,349,9,1935,0,90
1260,110,2,350,3,1938,0,30
1261,110,2,351,8,1946,14,80
1262,110,2,352,5,1951,0,50
1263,110,2,353,5,1956,3,50
1264,110,2,354,6,1962,3,60
1265,110,2,355,4,1966,2,40
1266,110,2,356,6,1972,1,60
1267,110,2,357,6,1978,0,60
1268,110,2,358,6,1984,10,60
1269,110,2,359,7,1991,0,70
1270,110,2,360,3,1994,4,30
1271,110,2,361,8,2002,3,80
1272,110,2,362,2,2004,0,20
1273,110,2,363,4,2008,3,40
1274,110,2,364,6,2014,3,60
1275,110,2,365,9,2023,4,90
1276,110,2,366,4,2027,2,40
1277,110,2,367,4,2031,0,40
1278,110,2,368,7,2038,9,70
1279,110,2,369,4,2042,3,40
1280,110,2,370,2,2044,1,20
1281,110,2,371,2,2046,0,20
1282,110,2,372,5,2051,4,50
1283,110,2,373,9,2060,4,90
1284,110,2,374,7,2067,3,70
1285,110,2,375,5,2072,0,50
1286,110,2,376,7,2079,3,70
1287,110,2,377,2,2081,1,20
1288,110,2,378,2,2083,0,20
1289,110,2,379,3,2086,0,30
1290,110,2,380,3,2089,0,30
1291,110,2,381,5,2094,6,50
1292,110,2,382,2,2096,3,20
1293,110,2,383,7,2103,0,70
1294,110,2,384,8,2111,4,80
1295,110,2,385,7,2118,5,70
1296,110,2,386,9,2127,5,90
1297,110,2,387,5,2132,5,50
1298,110,2,388,5,2137,0,50
1299,110,2,389,3,2140,2,30
1300,110,2,390,9,2149,0,90
1301,110,2,391,6,2155,7,60
1302,110,2,392,4,2159,3,40
1303,110,2,393,6,2165,2,60
1304,110,2,394,4,2169,0,40
1305,110,2,395,9,2178,5,90
1306,110,2,396,4,2182,4,40
1307,110,2,397,8,2190,4,80
1308,110,2,398,9,2199,1,90
1309,110,2,399,9,2208,6,90
1310,110,2,400,9,2217,2,90
1311,110,2,401,6,2223,3,60
1312,110,2,402,8,2231,3,80
1313,110,2,403,9,2240,4,90
1314,110,2,404,8,2248,3,80
1315,110,2,405,9,2257,0,90
1316,110,2,406,6,2263,6,60
1317,110,2,407,9,2272,5,90
1318,110,2,408,7,2279,0,70
1319,110,2,409,9,2288,10,90
1320,110,2,410,6,2294,5,60
1321,110,2,411,7,2301,3,70
1322,110,2,412,3,2304,1,30
1323,110,2,413,7,2311,2,70
1324,110,2,414,4,2315,0,40
1325,110,2,415,7,2322,0,70
1326,110,2,416,8,2330,15,80
1327,110,2,417,5,2335,2,50
1328,110,2,418,7,2342,0,70
1329,110,2,419,4,2346,0,40
1330,110,2,420,7,2353,7,70
1331,110,2,421,4,2357,0,40
1332,110,2,422,6,2363,0,60
1333,110,2,423,5,2368,9,50
1334,110,2,424,4,2372,1,40
1335,110,2,425,5,2377,2,50
1336,110,2,426,9,2386,0,90
1337,110,2,427,2,2388,2,20
1338,110,2,428,6,2394,0,60
1339,110,2,429,5,2399,0,50
1340,110,2,430,3,2402,0,30
1341,110,2,431,4,2406,0,40
1342,110,2,432,4,2410,8,40
1343,110,2,433,4,2414,0,40
1344,110,2,434,7,2421,2,70
1345,110,2,435,9,2430,7,90
1346,110,2,436,3,2433,4,30
1347,110,2,437,8,2441,5,80
1348,110,2,438,9,2450,5,90
1349,110,2,439,7,2457,8,70
1350,110,2,440,3,2460,1,30
1351,110,2,441,9,2469,4,90
1352,110,2,442,3,2472,4,30
1353,110,2,443,9,2481,0,90
1354,110,2,444,9,2490,10,90
1355,110,2,445,7,2497,0,70
1356,110,2,446,4,2501,0,40
1357,110,2,447,6,2507,6,60
1358,110,2,448,9,2516,4,90
1359,110,2,449,9,2525,5,90
1360,110,2,450,4,2529,3,40
1361,110,2,451,8,2537,4,80
1362,110,2,452,4,2541,0,40
1363,110,2,453,4,2545,2,40
1364,110,2,454,9,2554,4,90
1365,110,2,455,5,2559,0,50
1366,110,2,456,8,2567,7,80
1367,110,2,457,7,2574,1,70
1368,110,2,458,7,2581,3,70
1369,110,2,459,3,2584,2,30
1370,110,2,460,8,2592,9,80
1371,110,2,461,8,2600,3,80
1372,110,2,462,8,2608,4,80
1373,110,2,463,5,2613,4,50
1374,110,2,464,9,2622,7,90
1375,110,2,465,4,2626,0,40
1376,110,2,466,6,2632,4,60
1377,110,2,467,7,2639,4,70
1378,110,2,468,8,2647,4,80
1379,110,2,469,9,2656,6,90
1380,110,2,470,6,2662,2,60
1381,110,2,471,2,2664,1,20
1382,110,2,472,7,2671,0,70
1383,110,2,473,8,2679,1,80
1384,110,2,474,9,2688,7,90
1385,110,2,475,4,2692,1,40
1386,110,2,476,3,2695,0,30
1387,110,2,477,5,2700,0,50
1388,110,2,478,5,2705,7,50
1389,110,2,479,8,2713,4,80
1390,110,2,480,5,2718,7,50
1391,110,2,481,6,2724,0,60
1392,110,2,482,4,2728,4,40
1393,110,2,483,4,2732,0,40
1394,110,2,484,2,2734,0,20
1395,110,2,485,7,2741,1,70
1396,110,2,486,6,2747,7,60
1397,110,2,487,5,2752,5,50
1398,110,2,488,6,2758,1,60
1399,110,2,489,4,2762,0,40
1400,110,2,490,7,2769,0,70
1401,110,2,491,5,2774,0,50
1402,110,2,492,6,2780,13,60
1403,110,2,493,3,2783,3,30
1404,110,2,494,5,2788,0,50
1405,110,2,495,3,2791,2,30
1406,110,2,496,4,2795,0,40
1407,110,2,497,3,2798,4,30
1408,110,2,498,7,2805,0,70
1409,110,2,499,3,2808,0,30
1410,110,2,500,9,2817,7,90
1411,110,2,501,2,2819,0,20
1412,110,2,502,3,2822,0,30
1413,110,2,503,5,2827,5,50
1414,110,2,504,9,2836,0,90
1415,110,2,505,9,2845,10,90
1416,110,2,506,9,2854,4,90
1417,110,2,507,4,2858,3,40
1418,110,2,508,7,2865,2,70
1419,110,2,509,8,2873,6,80
1420,110,2,510,7,2880,3,70
1421,110,2,511,5,2885,0,50
1422,110,2,512,7,2892,0,70
1423,110,2,513,6,2898,0,60
1424,110,2,514,7,2905,14,70
1425,110,2,515,4,2909,0,40
1426,110,2,516,9,2918,9,90
1427,110,2,517,7,2925,5,70
1428,110,2,518,8,2933,5,80
1429,110,2,519,4,2937,3,40
1430,110,2,520,6,2943,6,60
1431,110,2,521,4,2947,1,40
1432,110,2,522,9,2956,3,90
1433,110,2,523,9,2965,1,90
1434,110,2,524,3,2968,3,30
1435,110,2,525,7,2975,1,70
1436,110,2,526,4,2979,0,40
1437,110,2,527,7,2986,3,70
1438,110,2,528,7,2993,4,70
1439,110,2,529,3,2996,0,30
1440,110,2,530,6,3002,5,60
1441,110,2,531,5,3007,6,50
1442,110,2,532,3,3010,2,30
1443,110,2,533,7,3017,3,70
1444,110,2,534,7,3024,4,70
1445,110,2,535,6,3030,0,60
1446,110,2,536,3,3033,8,30
1447,110,2,537,2,3035,0,20
1448,110,2,538,6,3041,3,60
1449,110,2,539,6,3047,0,60
1450,110,2,540,7,3054,4,70
1451,110,2,541,5,3059,3,50
1452,110,2,542,9,3068,1,90
1453,110,2,543,7,3075,0,70
1454,110,2,544,8,3083,7,80
1455,110,2,545,6,3089,1,60
1456,110,2,546,8,3097,7,80
1457,110,2,547,5,3102,2,50
1458,110,2,548,7,3109,0,70
1459,110,2,549,2,3111,5,20
1460,110,2,550,2,3113,2,20
1461,110,2,551,6,3119,0,60
1462,110,2,552,3,3122,1,30
1463,110,2,553,5,3127,2,50
1464,110,2,554,7,3134,0,70
1465,110,2,555,2,3136,2,20
1466,110,2,556,7,3143,6,70
1467,110,2,557,3,3146,0,30
1468,110,2,558,7,3153,3,70
1469,110,2,559,6,3159,5,60
1470,110,2,560,4,3163,2,40
1471,110,2,561,8,3171,0,80
1472,110,2,562,7,3178,1,70
1473,110,2,563,9,3187,0,90
1474,110,2,564,4,3191,3,40
1475,110,2,565,9,3200,0,90
1476,110,2,566,4,3204,0,40
1477,110,2,567,6,3210,13,60
1478,110,2,568,8,3218,0,80
1479,110,2,569,7,3225,5,70
1480,110,2,570,4,3229,0,40
1481,110,2,571,3,3232,5,30
1482,110,2,572,7,3239,3,70
1483,110,2,573,4,3243,0,40
1484,110,2,574,9,3252,6,90
1485,110,2,575,5,3257,2,50
1486,110,2,576,7,3264,0,70
1487,110,2,577,3,3267,14,30
1488,110,2,578,3,3270,2,30
1489,110,2,579,4,3274,2,40
1490,110,2,580,6,3280,0,60
1491,110,2,581,9,3289,0,90
1492,110,2,582,9,3298,12,90
1493,110,2,583,9,3307,2,90
1494,110,2,584,4,3311,2,40
1495,110,2,585,7,3318,4,70
1496,110,2,586,3,3321,0,30
1497,110,2,587,3,3324,0,30
1498,110,2,588,9,3333,4,90
1499,110,2,589,3,3336,0,30
1500,110,2,590,7,3343,0,70
1501,110,2,591,2,3345,5,20
1502,110,2,592,9,3354,3,90
1503,110,2,593,7,3361,0,70
1504,110,2,594,4,3365,0,40
1505,110,2,595,4,3369,7,40
1506,110,2,596,3,3372,6,30
1507,110,2,597,8,3380,4,80
1508,110,2,598,2,3382,0,20
1509,110,2,599,5,3387,0,50
1510,110,2,600,3,3390,0,30
1511,110,2,601,9,3399,9,90
1512,110,2,602,5,3404,0,50
1513,110,2,603,2,3406,0,20
1514,110,2,604,4,3410,4,40
1515,110,2,605,8,3418,4,80
1516,110,2,606,2,3420,0,20
1517,110,2,607,8,3428,3,80
1518,110,2,608,9,3437,7,90
1519,110,2,609,7,3444,6,70
1520,110,2,610,2,3446,0,20
1521,110,2,611,6,3452,4,60
1522,110,2,612,5,3457,1,50
1523,110,2,613,8,3465,6,80
1524,110,2,614,7,3472,0,70
1525,110,2,615,7,3479,0,70
1526,110,2,616,9,3488,10,90
1527,110,2,617,5,3493,0,50
1528,110,2,618,5,3498,5,50
1529,110,2,619,2,3500,0,20
1530,110,2,620,3,3503,1,30
1531,110,2,621,5,3508,0,50
1532,110,2,622,8,3516,7,80
1533,110,2,623,7,3523,4,70
1534,110,2,624,9,3532,6,90
1535,110,2,625,7,3539,1,70
1536,110,2,626,5,3544,0,50
1537,110,2,627,4,3548,2,40
1538,110,2,628,2,3550,2,20
1539,110,2,629,9,3559,6,90
1540,110,2,630,6,3565,2,60
1541,110,2,631,9,3574,0,90
1542,110,2,632,2,3576,6,20
1543,110,2,633,5,3581,2,50
1544,110,2,634,8,3589,0,80
1545,110,2,635,9,3598,4,90
1546,110,2,636,2,3600,0,20
1547,110,2,637,3,3603,0,30
1548,110,2,638,3,3606,5,30
1549,110,2,639,9,3615,2,90
1550,110,2,640,7,3622,2,70
1551,110,2,641,9,3631,7,90
1552,110,2,642,6,3637,7,60
1553,110,2,643,9,3646,3,90
1554,110,2,644,6,3652,0,60
1555,110,2,645,3,3655,0,30
1556,110,2,646,4,3659,4,40
1557,110,2,647,4,3663,0,40
1558,110,2,648,6,3669,4,60
1559,110,2,649,3,3672,1,30
1560,110,2,650,7,3679,3,70
1561,110,2,651,9,3688,8,90
1562,110,2,652,4,3692,0,40
1563,110,2,653,4,3696,4,40
1564,110,2,654,8,3704,4,80
1565,110,2,655,7,3711,2,70
1566,110,2,656,2,3713,2,20
1567,110,2,657,3,3716,4,30
1568,110,2,658,4,3720,4,40
1569,110,2,659,2,3722,0,20
1570,110,2,660,5,3727,0,50
1571,110,2,661,5,3732,0,50
1572,110,2,662,3,3735,6,30
1573,110,2,663,2,3737,1,20
1574,110,2,664,2,3739,0,20
1575,110,2,665,4,3743,0,40
1576,110,2,666,9,3752,4,90
1577,110,2,667,6,3758,0,60
1578,110,2,668,7,3765,9,70
1579,110,2,669,9,3774,2,90
1580,110,2,670,5,3779,4,50
1581,110,2,671,3,3782,2,30
1582,110,2,672,6,3788,0,60
1583,110,2,673,4,3792,8,40
1584,110,2,674,2,3794,0,20
1585,110,2,675,7,3801,7,70
1586,110,2,676,6,3807,4,60
1587,110,2,677,4,3811,0,40
1588,110,2,678,3,3814,1,30
1589,110,2,679,2,3816,1,20
1590,110,2,680,4,3820,5,40
1591,110,2,681,2,3822,0,20
1592,110,2,682,7,3829,5,70
1593,110,2,683,6,3835,8,60
1594,110,2,684,5,3840,3,50
1595,110,2,685,7,3847,0,70
1596,110,2,686,7,3854,0,70
1597,110,2,687,4,3858,6,40
1598,110,2,688,7,3865,0,70
1599,110,2,689,2,3867,0,20
1600,110,2,690,4,3871,0,40
1601,110,2,691,6,3877,0,60
1602,110,2,692,7,3884,0,70
1603,110,2,693,9,3893,16,90
1604,110,2,694,3,3896,2,30
1605,110,2,695,6,3902,1,60
1606,110,2,696,9,3911,5,90
1607,110,2,697,7,3918,3,70
1608,110,2,698,2,3920,1,20
1609,110,2,699,7,3927,2,70
1610,110,2,700,5,3932,4,50
1611,110,2,701,8,3940,2,80
1612,110,2,702,2,3942,0,20
1613,110,2,703,5,3947,3,50
1614,110,2,704,5,3952,2,50
1615,110,2,705,2,3954,1,20
1616,110,2,706,6,3960,1,60
1617,110,2,707,8,3968,3,80
1618,110,2,708,3,3971,1,30
1619,110,2,709,5,3976,3,50
1620,110,2,710,4,3980,4,40
1621,110,2,711,5,3985,0,50
1622,110,2,712,2,3987,5,20
1623,110,2,713,2,3989,1,20
1624,110,2,714,6,3995,1,60
1625,110,2,715,2,3997,0,20
1626,110,2,716,7,4004,0,70
1627,110,2,717,5,4009,12,50
1628,110,2,718,7,4016,0,70
1629,110,2,719,8,4024,9,80
1630,110,2,720,7,4031,0,70
1631,110,2,721,3,4034,9,30
1632,110,2,722,3,4037,2,30
1633,110,2,723,4,4041,0,40
1634,110,2,724,3,4044,7,30
1635,110,2,725,3,4047,0,30
1636,110,2,726,9,4056,7,90
1637,110,2,727,2,4058,0,20
1638,110,2,728,2,4060,1,20
1639,110,2,729,5,4065,2,50
1640,110,2,730,8,4073,4,80
1641,110,2,731,2,4075,1,20
1642,110,2,732,8,4083,4,80
1643,110,2,733,6,4089,4,60
1644,110,2,734,9,4098,3,90
1645,110,2,735,7,4105,2,70
1646,110,2,736,9,4114,10,90
1647,110,2,737,5,4119,0,50
1648,110,2,738,5,4124,4,50
1649,110,2,739,6,4130,4,60
1650,110,2,740,4,4134,2,40
1651,110,2,741,7,4141,0,70
1652,110,2,742,3,4144,6,30
1653,110,2,743,2,4146,0,20
1654,110,2,744,9,4155,10,90
1655,110,2,745,7,4162,0,70
1656,110,2,746,5,4167,0,50
1657,110,2,747,9,4176,11,90
1658,110,2,748,2,4178,1,20
1659,110,2,749,5,4183,2,50
1660,110,2,750,5,4188,0,50
1661,110,2,751,8,4196,4,80
1662,110,2,752,5,4201,0,50
1663,110,2,753,8,4209,0,80
1664,110,2,754,5,4214,13,50
1665,110,2,755,2,4216,0,20
1666,110,2,756,5,4221,4,50
1667,110,2,757,3,4224,0,30
1668,110,2,758,2,4226,2,20
1669,110,2,759,6,4232,4,60
1670,110,2,760,3,4235,0,30
1671,110,2,761,3,4238,3,30
1672,110,2,762,2,4240,1,20
1673,110,2,763,2,4242,3,20
1674,110,2,764,4,4246,0,40
1675,110,2,765,7,4253,0,70
1676,110,2,766,6,4259,4,60
1677,110,2,767,4,4263,1,40
1678,110,2,768,2,4265,0,20
1679,110,2,769,8,4273,6,80
1680,110,2,770,9,4282,0,90
1681,110,2,771,2,4284,5,20
1682,110,2,772,5,4289,6,50
1683,110,2,773,5,4294,1,50
1684,110,2,774,6,4300,3,60
1685,110,2,775,2,4302,0,20
1686,110,2,776,8,4310,4,80
1687,110,2,777,8,4318,8,80
1688,110,2,778,3,4321,0,30
1689,110,2,779,6,4327,0,60
1690,110,2,780,5,4332,10,50
1691,110,2,781,6,4338,7,60
1692,110,2,782,6,4344,3,60
1693,110,2,783,2,4346,0,20
1694,110,2,784,8,4354,0,80
1695,110,2,785,9,4363,9,90
1696,110,2,786,4,4367,0,40
1697,110,2,787,3,4370,4,30
1698,110,2,788,8,4378,0,80
1699,110,2,789,6,4384,0,60
1700,110,2,790,2,4386,8,20
1701,110,2,791,3,4389,0,30
1702,110,2,792,8,4397,1,80
1703,110,2,793,5,4402,0,50
1704,110,2,794,5,4407,3,50
1705,110,2,795,7,4414,0,70
1706,110,2,796,7,4421,9,70
1707,110,2,797,6,4427,0,60
1708,110,2,798,6,4433,6,60
1709,110,2,799,6,4439,0,60
1710,110,2,800,4,4443,0,40
1711,110,2,801,8,4451,0,80
1712,110,2,802,4,4455,10,40
1713,110,2,803,8,4463,0,80
1714,110,2,804,7,4470,0,70
1715,110,2,805,2,4472,6,20
1716,110,2,806,8,4480,2,80
1717,110,2,807,4,4484,5,40
1718,110,2,808,5,4489,2,50
1719,110,2,809,5,4494,0,50
1720,110,2,810,9,4503,0,90
1721,110,2,811,2,4505,0,20
1722,110,2,812,5,4510,0,50
1723,110,2,813,7,4517,9,70
1724,110,2,814,8,4525,0,80
1725,110,2,815,5,4530,0,50
1726,110,2,816,4,4534,0,40
1727,110,2,817,7,4541,9,70
1728,110,2,818,5,4546,0,50
1729,110,2,819,9,4555,0,90
1730,110,2,820,5,4560,8,50
1731,110,2,821,8,4568,0,80
1732,110,2,822,2,4570,4,20
1733,110,2,823,5,4575,4,50
1734,110,2,824,9,4584,5,90
1735,110,2,825,3,4587,0,30
1736,110,2,826,6,4593,4,60
1737,110,2,827,2,4595,1,20
1738,110,2,828,3,4598,2,30
1739,110,2,829,5,4603,0,50
1740,110,2,830,5,4608,6,50
1741,110,2,831,7,4615,5,70
1742,110,2,832,8,4623,0,80
1743,110,2,833,4,4627,4,40
1744,110,2,834,4,4631,2,40
1745,110,2,835,4,4635,1,40
1746,110,2,836,9,4644,5,90
1747,110,2,837,3,4647,0,30
1748,110,2,838,5,4652,2,50
1749,110,2,839,9,4661,5,90
1750,110,2,840,5,4666,3,50
1751,110,2,841,4,4670,4,40
1752,110,2,842,3,4673,2,30
1753,110,2,843,2,4675,2,20
1754,110,2,844,8,4683,4,80
1755,110,2,845,7,4690,5,70
1756,110,2,846,5,4695,4,50
1757,110,2,847,2,4697,3,20
1758,110,2,848,5,4702,3,50
1759,110,2,849,4,4706,0,40
1760,110,2,850,9,4715,6,90
1761,110,2,851,9,4724,7,90
1762,110,2,852,3,4727,1,30
1763,110,2,853,3,4730,0,30
1764,110,2,854,9,4739,4,90
1765,110,2,855,5,4744,0,50
1766,110,2,856,9,4753,0,90
1767,110,2,857,8,4761,10,80
1768,110,2,858,3,4764,1,30
1769,110,2,859,7,4771,2,70
1770,110,2,860,9,4780,0,90
1771,110,2,861,5,4785,0,50
1772,110,2,862,9,4794,0,90
1773,110,2,863,7,4801,11,70
1774,110,2,864,4,4805,3,40
1775,110,2,865,6,4811,0,60
1776,110,2,866,5,4816,11,50
1777,110,2,867,6,4822,0,60
1778,110,2,868,3,4825,0,30
1779,110,2,869,7,4832,0,70
1780,110,2,870,6,4838,14,60
1781,110,2,871,6,4844,0,60
1782,110,2,872,3,4847,3,30
1783,110,2,873,8,4855,5,80
1784,110,2,874,6,4861,4,60
1785,110,2,875,6,4867,6,60
1786,110,2,876,3,4870,2,30
1787,110,2,877,6,4876,5,60
1788,110,2,878,7,4883,0,70
1789,110,2,879,3,4886,6,30
1790,110,2,880,4,4890,2,40
1791,110,2,881,3,4893,2,30
1792,110,2,882,7,4900,6,70
1793,110,2,883,3,4903,1,30
1794,110,2,884,8,4911,2,80
1795,110,2,885,7,4918,7,70
1796,110,2,886,3,4921,2,30
1797,110,2,887,7,4928,1,70
1798,110,2,888,2,4930,0,20
1799,110,2,889,3,4933,2,30
1800,110,2,890,5,4938,4,50
1801,110,2,891,2,4940,0,20
1802,110,2,892,6,4946,2,60
1803,110,2,893,9,4955,5,90
1804,110,2,894,5,4960,6,50
1805,110,2,895,4,4964,1,40
1806,110,2,896,3,4967,0,30
1807,110,2,897,4,4971,2,40
1808,110,2,898,9,4980,0,90
1809,110,2,899,7,4987,13,70
1810,110,2,900,4,4991,2,40
1811,110,2,901,7,4998,5,70
1812,110,3,1,5,5,3,50
1813,110,3,2,9,14,0,90
1814,110,3,3,6,20,9,60
1815,110,3,4,3,23,1,30
1816,110,3,5,7,30,0,70
1817,110,3,6,2,32,0,20
1818,110,3,7,4,36,1,40
1819,110,3,8,7,43,5,70
1820,110,3,9,7,50,4,70
1821,110,3,10,6,56,5,60
1822,110,3,11,4,60,0,40
1823,110,3,12,8,68,0,80
1824,110,3,13,5,73,0,50
1825,110,3,14,3,76,6,30
1826,110,3,15,7,83,0,70
1827,110,3,16,5,88,6,50
1828,110,3,17,2,90,0,20
1829,110,3,18,6,96,0,60
1830,110,3,19,3,99,0,30
1831,110,3,20,9,108,14,90
1832,110,3,21,9,117,4,90
1833,110,3,22,9,126,9,90
1834,110,3,23,7,133,4,70
1835,110,3,24,8,141,6,80
1836,110,3,25,6,147,1,60
1837,110,3,26,7,154,0,70
1838,110,3,27,9,163,5,90
1839,110,3,28,4,167,0,40
1840,110,3,29,5,172,4,50
1841,110,3,30,8,180,3,80
1842,110,3,31,7,187,2,70
1843,110,3,32,7,194,7,70
1844,110,3,33,4,198,3,40
1845,110,3,34,4,202,3,40
1846,110,3,35,3,205,1,30
1847,110,3,36,6,211,0,60
1848,110,3,37,5,216,1,50
1849,110,3,38,4,220,3,40
1850,110,3,39,8,228,4,80
1851,110,3,40,9,237,8,90
1852,110,3,41,2,239,0,20
1853,110,3,42,3,242,3,30
1854,110,3,43,8,250,6,80
1855,110,3,44,8,258,0,80
1856,110,3,45,4,262,6,40
1857,110,3,46,2,264,0,20
1858,110,3,47,3,267,0,30
1859,110,3,48,7,274,3,70
1860,110,3,49,3,277,0,30
1861,110,3,50,6,283,0,60
1862,110,3,51,7,290,0,70
1863,110,3,52,5,295,0,50
1864,110,3,53,4,299,0,40
1865,110,3,54,8,307,16,80
1866,110,3,55,4,311,2,40
1867,110,3,56,3,314,0,30
1868,110,3,57,5,319,0,50
1869,110,3,58,6,325,12,60
1870,110,3,59,4,329,0,40
1871,110,3,60,9,338,0,90
1872,110,3,61,4,342,0,40
1873,110,3,62,9,351,13,90
1874,110,3,63,8,359,3,80
1875,110,3,64,6,365,2,60
1876,110,3,65,5,370,5,50
1877,110,3,66,6,376,1,60
1878,110,3,67,9,385,5,90
1879,110,3,68,6,391,0,60
1880,110,3,69,8,399,4,80
1881,110,3,70,5,404,0,50
1882,110,3,71,5,409,5,50
1883,110,3,72,3,412,1,30
1884,110,3,73,7,419,0,70
1885,110,3,74,3,422,0,30
1886,110,3,75,2,424,6,20
1887,110,3,76,5,429,1,50
1888,110,3,77,2,431,0,20
1889,110,3,78,8,439,8,80
1890,110,3,79,2,441,1,20
1891,110,3,80,5,446,2,50
1892,110,3,81,4,450,1,40
1893,110,3,82,6,456,4,60
1894,110,3,83,8,464,5,80
1895,110,3,84,2,466,1,20
1896,110,3,85,9,475,0,90
1897,110,3,86,3,478,0,30
1898,110,3,87,3,481,9,30
1899,110,3,88,2,483,0,20
1900,110,3,89,3,486,1,30
1901,110,3,90,6,492,4,60
1902,110,3,91,5,497,2,50
1903,110,3,92,3,500,1,30
1904,110,3,93,3,503,0,30
1905,110,3,94,7,510,4,70
1906,110,3,95,5,515,0,50
1907,110,3,96,8,523,0,80
1908,110,3,97,3,526,0,30
1909,110,3,98,7,533,11,70
1910,110,3,99,8,541,8,80
1911,110,3,100,2,543,0,20
1912,110,3,101,2,545,0,20
1913,110,3,102,3,548,0,30
1914,110,3,103,9,557,5,90
1915,110,3,104,3,560,0,30
1916,110,3,105,9,569,0,90
1917,110,3,106,7,576,13,70
1918,110,3,107,4,580,0,40
1919,110,3,108,9,589,15,90
1920,110,3,109,3,592,1,30
1921,110,3,110,4,596,1,40
1922,110,3,111,3,599,1,30
1923,110,3,112,8,607,4,80
1924,110,3,113,3,610,4,30
1925,110,3,114,9,619,3,90
1926,110,3,115,8,627,0,80
1927,110,3,116,9,636,8,90
1928,110,3,117,4,640,0,40
1929,110,3,118,2,642,0,20
1930,110,3,119,2,644,0,20
1931,110,3,120,2,646,2,20
1932,110,3,121,8,654,4,80
1933,110,3,122,8,662,0,80
1934,110,3,123,2,664,5,20
1935,110,3,124,9,673,5,90
1936,110,3,125,3,676,1,30
1937,110,3,126,6,682,1,60
1938,110,3,127,9,691,5,90
1939,110,3,128,5,696,2,50
1940,110,3,129,9,705,2,90
1941,110,3,130,4,709,1,40
1942,110,3,131,2,711,0,20
1943,110,3,132,8,719,7,80
1944,110,3,133,8,727,0,80
1945,110,3,134,5,732,9,50
1946,110,3,135,5,737,0,50
1947,110,3,136,4,741,0,40
1948,110,3,137,8,749,11,80
1949,110,3,138,5,754,3,50
1950,110,3,139,2,756,0,20
1951,110,3,140,5,761,2,50
1952,110,3,141,9,770,4,90
1953,110,3,142,6,776,2,60
1954,110,3,143,2,778,0,20
1955,110,3,144,7,785,0,70
1956,110,3,145,2,787,0,20
1957,110,3,146,9,796,12,90
1958,110,3,147,7,803,0,70
1959,110,3,148,9,812,8,90
1960,110,3,149,2,814,0,20
1961,110,3,150,9,823,0,90
1962,110,3,151,6,829,16,60
1963,110,3,152,5,834,1,50
1964,110,3,153,3,837,2,30
1965,110,3,154,9,846,0,90
1966,110,3,155,6,852,4,60
1967,110,3,156,7,859,3,70
1968,110,3,157,2,861,3,20
1969,110,3,158,4,865,1,40
1970,110,3,159,2,867,0,20
1971,110,3,160,7,874,1,70
1972,110,3,161,8,882,0,80
1973,110,3,162,5,887,0,50
1974,110,3,163,3,890,0,30
1975,110,3,164,2,892,7,20
1976,110,3,165,2,894,0,20
1977,110,3,166,8,902,0,80
1978,110,3,167,4,906,10,40
1979,110,3,168,4,910,1,40
1980,110,3,169,7,917,0,70
1981,110,3,170,5,922,6,50
1982,110,3,171,3,925,2,30
1983,110,3,172,2,927,1,20
1984,110,3,173,9,936,3,90
1985,110,3,174,7,943,4,70
1986,110,3,175,7,950,0,70
1987,110,3,176,9,959,5,90
1988,110,3,177,5,964,4,50
1989,110,3,178,4,968,2,40
1990,110,3,179,3,971,0,30
1991,110,3,180,3,974,4,30
1992,110,3,181,7,981,0,70
1993,110,3,182,3,984,5,30
1994,110,3,183,5,989,0,50
1995,110,3,184,9,998,0,90
1996,110,3,185,6,1004,0,60
1997,110,3,186,3,1007,8,30
1998,110,3,187,6,1013,5,60
1999,110,3,188,8,1021,4,80
2000,110,3,189,8,1029,0,80
2001,110,3,190,5,1034,11,50
2002,110,3,191,6,1040,1,60
2003,110,3,192,6,1046,2,60
2004,110,3,193,7,1053,4,70
2005,110,3,194,6,1059,3,60
2006,110,3,195,5,1064,0,50
2007,110,3,196,3,1067,4,30
2008,110,3,197,7,1074,0,70
2009,110,3,198,7,1081,6,70
2010,110,3,199,2,1083,0,20
2011,110,3,200,3,1086,0,30
2012,110,3,201,9,1095,4,90
2013,110,3,202,7,1102,5,70
2014,110,3,203,5,1107,1,50
2015,110,3,204,8,1115,5,80
2016,110,3,205,5,1120,1,50
2017,110,3,206,7,1127,0,70
2018,110,3,207,5,1132,11,50
2019,110,3,208,4,1136,0,40
2020,110,3,209,9,1145,0,90
2021,110,3,210,3,1148,9,30
2022,110,3,211,4,1152,0,40
2023,110,3,212,5,1157,4,50
2024,110,3,213,8,1165,0,80
2025,110,3,214,9,1174,4,90
2026,110,3,215,4,1178,4,40
2027,110,3,216,4,1182,0,40
2028,110,3,217,8,1190,1,80
2029,110,3,218,2,1192,0,20
2030,110,3,219,2,1194,2,20
2031,110,3,220,6,1200,6,60
2032,110,3,221,3,1203,2,30
2033,110,3,222,9,1212,4,90
2034,110,3,223,2,1214,1,20
2035,110,3,224,2,1216,0,20
2036,110,3,225,7,1223,4,70
2037,110,3,226,6,1229,4,60
2038,110,3,227,5,1234,0,50
2039,110,3,228,8,1242,4,80
2040,110,3,229,2,1244,1,20
2041,110,3,230,2,1246,0,20
2042,110,3,231,8,1254,0,80
2043,110,3,232,2,1256,4,20
2044,110,3,233,2,1258,0,20
2045,110,3,234,6,1264,0,60
2046,110,3,235,3,1267,3,30
2047,110,3,236,5,1272,0,50
2048,110,3,237,8,1280,5,80
2049,110,3,238,8,1288,0,80
2050,110,3,239,9,1297,9,90
2051,110,3,240,9,1306,4,90
2052,110,3,241,6,1312,0,60
2053,110,3,242,8,1320,10,80
2054,110,3,243,2,1322,1,20
2055,110,3,244,7,1329,3,70
2056,110,3,245,5,1334,1,50
2057,110,3,246,7,1341,0,70
2058,110,3,247,3,1344,0,30
2059,110,3,248,6,1350,0,60
2060,110,3,249,4,1354,5,40
2061,110,3,250,6,1360,0,60
2062,110,3,251,2,1362,5,20
2063,110,3,252,2,1364,0,20
2064,110,3,253,2,1366,0,20
2065,110,3,254,9,1375,5,90
2066,110,3,255,7,1382,2,70
2067,110,3,256,8,1390,5,80
2068,110,3,257,7,1397,0,70
2069,110,3,258,5,1402,5,50
2070,110,3,259,3,1405,0,30
2071,110,3,260,2,1407,0,20
2072,110,3,261,2,1409,3,20
2073,110,3,262,2,1411,1,20
2074,110,3,263,8,1419,0,80
2075,110,3,264,8,1427,0,80
2076,110,3,265,2,1429,0,20
2077,110,3,266,6,1435,0,60
2078,110,3,267,3,1438,13,30
2079,110,3,268,5,1443,3,50
2080,110,3,269,8,1451,5,80
2081,110,3,270,3,1454,0,30
2082,110,3,271,7,1461,0,70
2083,110,3,272,7,1468,0,70
2084,110,3,273,4,1472,5,40
2085,110,3,274,5,1477,4,50
2086,110,3,275,5,1482,3,50
2087,110,3,276,6,1488,3,60
2088,110,3,277,4,1492,2,40
2089,110,3,278,4,1496,0,40
2090,110,3,279,2,1498,0,20
2091,110,3,280,4,1502,6,40
2092,110,3,281,3,1505,0,30
2093,110,3,282,6,1511,0,60
2094,110,3,283,6,1517,0,60
2095,110,3,284,4,1521,0,40
2096,110,3,285,9,1530,15,90
2097,110,3,286,4,1534,0,40
2098,110,3,287,3,1537,0,30
2099,110,3,288,9,1546,0,90
2100,110,3,289,4,1550,5,40
2101,110,3,290,6,1556,2,60
2102,110,3,291,9,1565,0,90
2103,110,3,292,9,1574,8,90
2104,110,3,293,3,1577,3,30
2105,110,3,294,3,1580,2,30
2106,110,3,295,3,1583,0,30
2107,110,3,296,6,1589,4,60
2108,110,3,297,2,1591,0,20
2109,110,3,298,8,1599,5,80
2110,110,3,299,3,1602,3,30
2111,110,3,300,5,1607,1,50
2112,110,3,301,4,1611,0,40
2113,110,3,302,2,1613,3,20
2114,110,3,303,3,1616,0,30
2115,110,3,304,4,1620,0,40
2116,110,3,305,3,1623,2,30
2117,110,3,306,7,1630,2,70
2118,110,3,307,2,1632,1,20
2119,110,3,308,9,1641,0,90
2120,110,3,309,3,1644,2,30
2121,110,3,310,9,1653,5,90
2122,110,3,311,7,1660,3,70
2123,110,3,312,5,1665,3,50
2124,110,3,313,8,1673,5,80
2125,110,3,314,2,1675,0,20
2126,110,3,315,6,1681,5,60
2127,110,3,316,4,1685,1,40
2128,110,3,317,8,1693,4,80
2129,110,3,318,6,1699,2,60
2130,110,3,319,5,1704,0,50
2131,110,3,320,7,1711,0,70
2132,110,3,321,8,1719,8,80
2133,110,3,322,6,1725,3,60
2134,110,3,323,2,1727,1,20
2135,110,3,324,7,1734,1,70
2136,110,3,325,9,1743,4,90
2137,110,3,326,8,1751,6,80
2138,110,3,327,2,1753,0,20
2139,110,3,328,2,1755,0,20
2140,110,3,329,9,1764,4,90
2141,110,3,330,6,1770,2,60
2142,110,3,331,4,1774,1,40
2143,110,3,332,9,1783,1,90
2144,110,3,333,5,1788,3,50
2145,110,3,334,3,1791,2,30
2146,110,3,335,6,1797,0,60
2147,110,3,336,3,1800,6,30
2148,110,3,337,4,1804,0,40
2149,110,3,338,2,1806,2,20
2150,110,3,339,6,1812,4,60
2151,110,3,340,3,1815,0,30
2152,110,3,341,9,1824,4,90
2153,110,3,342,4,1828,0,40
2154,110,3,343,2,1830,2,20
2155,110,3,344,8,1838,0,80
2156,110,3,345,3,1841,5,30
2157,110,3,346,2,1843,1,20
2158,110,3,347,9,1852,1,90
2159,110,3,348,6,1858,0,60
2160,110,3,349,3,1861,0,30
2161,110,3,350,8,1869,8,80
2162,110,3,351,3,1872,0,30
2163,110,3,352,8,1880,0,80
2164,110,3,353,2,1882,8,20
2165,110,3,354,9,1891,0,90
2166,110,3,355,9,1900,8,90
2167,110,3,356,5,1905,2,50
2168,110,3,357,2,1907,0,20
2169,110,3,358,6,1913,0,60
2170,110,3,359,3,1916,0,30
2171,110,3,360,6,1922,8,60
2172,110,3,361,4,1926,1,40
2173,110,3,362,9,1935,0,90
2174,110,3,363,5,1940,0,50
2175,110,3,364,5,1945,0,50
2176,110,3,365,7,1952,8,70
2177,110,3,366,4,1956,3,40
2178,110,3,367,7,1963,5,70
2179,110,3,368,8,1971,3,80
2180,110,3,369,3,1974,0,30
2181,110,3,370,4,1978,0,40
2182,110,3,371,6,1984,0,60
2183,110,3,372,9,1993,16,90
2184,110,3,373,6,1999,0,60
2185,110,3,374,3,2002,2,30
2186,110,3,375,4,2006,0,40
2187,110,3,376,8,2014,6,80
2188,110,3,377,3,2017,0,30
2189,110,3,378,2,2019,1,20
2190,110,3,379,3,2022,0,30
2191,110,3,380,9,2031,0,90
2192,110,3,381,7,2038,0,70
2193,110,3,382,6,2044,14,60
2194,110,3,383,8,2052,0,80
2195,110,3,384,2,2054,0,20
2196,110,3,385,6,2060,0,60
2197,110,3,386,6,2066,17,60
2198,110,3,387,2,2068,1,20
2199,110,3,388,5,2073,0,50
2200,110,3,389,5,2078,4,50
2201,110,3,390,8,2086,1,80
2202,110,3,391,9,2095,3,90
2203,110,3,392,7,2102,6,70
2204,110,3,393,5,2107,0,50
2205,110,3,394,6,2113,4,60
2206,110,3,395,5,2118,1,50
2207,110,3,396,6,2124,3,60
2208,110,3,397,6,2130,0,60
2209,110,3,398,3,2133,0,30
2210,110,3,399,2,2135,0,20
2211,110,3,400,3,2138,8,30
2212,110,3,401,3,2141,2,30
2213,110,3,402,7,2148,5,70
2214,110,3,403,3,2151,2,30
2215,110,3,404,2,2153,0,20
2216,110,3,405,7,2160,3,70
2217,110,3,406,7,2167,8,70
2218,110,3,407,2,2169,0,20
2219,110,3,408,2,2171,1,20
2220,110,3,409,4,2175,4,40
2221,110,3,410,2,2177,0,20
2222,110,3,411,3,2180,1,30
2223,110,3,412,4,2184,0,40
2224,110,3,413,2,2186,0,20
2225,110,3,414,3,2189,6,30
2226,110,3,415,4,2193,4,40
2227,110,3,416,4,2197,2,40
2228,110,3,417,9,2206,0,90
2229,110,3,418,9,2215,5,90
2230,110,3,419,6,2221,3,60
2231,110,3,420,8,2229,4,80
2232,110,3,421,9,2238,7,90
2233,110,3,422,9,2247,0,90
2234,110,3,423,8,2255,13,80
2235,110,3,424,6,2261,2,60
2236,110,3,425,3,2264,0,30
2237,110,3,426,4,2268,2,40
2238,110,3,427,3,2271,2,30
2239,110,3,428,4,2275,1,40
2240,110,3,429,2,2277,1,20
2241,110,3,430,2,2279,0,20
2242,110,3,431,9,2288,0,90
2243,110,3,432,9,2297,14,90
2244,110,3,433,8,2305,0,80
2245,110,3,434,4,2309,8,40
2246,110,3,435,9,2318,0,90
2247,110,3,436,9,2327,0,90
2248,110,3,437,6,2333,8,60
2249,110,3,438,5,2338,0,50
2250,110,3,439,5,2343,5,50
2251,110,3,440,2,2345,3,20
2252,110,3,441,3,2348,1,30
2253,110,3,442,6,2354,1,60
2254,110,3,443,5,2359,0,50
2255,110,3,444,8,2367,7,80
2256,110,3,445,8,2375,2,80
2257,110,3,446,8,2383,2,80
2258,110,3,447,6,2389,1,60
2259,110,3,448,9,2398,3,90
2260,110,3,449,3,2401,0,30
2261,110,3,450,3,2404,4,30
2262,110,3,451,6,2410,0,60
2263,110,3,452,6,2416,3,60
2264,110,3,453,9,2425,2,90
2265,110,3,454,7,2432,0,70
2266,110,3,455,7,2439,13,70
2267,110,3,456,8,2447,5,80
2268,110,3,457,5,2452,0,50
2269,110,3,458,5,2457,4,50
2270,110,3,459,6,2463,4,60
2271,110,3,460,9,2472,4,90
2272,110,3,461,9,2481,7,90
2273,110,3,462,2,2483,0,20
2274,110,3,463,8,2491,0,80
2275,110,3,464,6,2497,12,60
2276,110,3,465,6,2503,4,60
2277,110,3,466,3,2506,1,30
2278,110,3,467,6,2512,0,60
2279,110,3,468,5,2517,5,50
2280,110,3,469,8,2525,0,80
2281,110,3,470,2,2527,6,20
2282,110,3,471,6,2533,0,60
2283,110,3,472,4,2537,5,40
2284,110,3,473,5,2542,3,50
2285,110,3,474,2,2544,0,20
2286,110,3,475,8,2552,7,80
2287,110,3,476,7,2559,2,70
2288,110,3,477,9,2568,5,90
2289,110,3,478,5,2573,0,50
2290,110,3,479,4,2577,0,40
2291,110,3,480,6,2583,8,60
2292,110,3,481,6,2589,1,60
2293,110,3,482,7,2596,0,70
2294,110,3,483,4,2600,9,40
2295,110,3,484,8,2608,2,80
2296,110,3,485,2,2610,2,20
2297,110,3,486,7,2617,2,70
2298,110,3,487,2,2619,1,20
2299,110,3,488,4,2623,2,40
2300,110,3,489,3,2626,0,30
2301,110,3,490,7,2633,0,70
2302,110,3,491,6,2639,0,60
2303,110,3,492,8,2647,10,80
2304,110,3,493,5,2652,0,50
2305,110,3,494,6,2658,4,60
2306,110,3,495,9,2667,4,90
2307,110,3,496,6,2673,0,60
2308,110,3,497,6,2679,6,60
2309,110,3,498,7,2686,3,70
2310,110,3,499,7,2693,0,70
2311,110,3,500,3,2696,4,30
2312,110,3,501,9,2705,5,90
2313,110,3,502,4,2709,0,40
2314,110,3,503,2,2711,2,20
2315,110,3,504,6,2717,3,60
2316,110,3,505,2,2719,0,20
2317,110,3,506,3,2722,1,30
2318,110,3,507,6,2728,3,60
2319,110,3,508,7,2735,0,70
2320,110,3,509,8,2743,9,80
2321,110,3,510,3,2746,0,30
2322,110,3,511,9,2755,0,90
2323,110,3,512,8,2763,8,80
2324,110,3,513,5,2768,0,50
2325,110,3,514,9,2777,6,90
2326,110,3,515,3,2780,0,30
2327,110,3,516,3,2783,4,30
2328,110,3,517,5,2788,3,50
2329,110,3,518,6,2794,0,60
2330,110,3,519,5,2799,5,50
2331,110,3,520,9,2808,7,90
2332,110,3,521,3,2811,2,30
2333,110,3,522,5,2816,0,50
2334,110,3,523,8,2824,16,80
2335,110,3,524,5,2829,2,50
2336,110,3,525,8,2837,5,80
2337,110,3,526,9,2846,6,90
2338,110,3,527,6,2852,3,60
2339,110,3,528,2,2854,2,20
2340,110,3,529,2,2856,1,20
2341,110,3,530,2,2858,1,20
2342,110,3,531,7,2865,1,70
2343,110,3,532,8,2873,3,80
2344,110,3,533,6,2879,2,60
2345,110,3,534,5,2884,2,50
2346,110,3,535,8,2892,0,80
2347,110,3,536,8,2900,0,80
2348,110,3,537,8,2908,1,80
2349,110,3,538,6,2914,0,60
2350,110,3,539,4,2918,10,40
2351,110,3,540,2,2920,2,20
2352,110,3,541,2,2922,2,20
2353,110,3,542,7,2929,3,70
2354,110,3,543,4,2933,0,40
2355,110,3,544,4,2937,0,40
2356,110,3,545,4,2941,5,40
2357,110,3,546,9,2950,3,90
2358,110,3,547,3,2953,3,30
2359,110,3,548,2,2955,0,20
2360,110,3,549,3,2958,1,30
2361,110,3,550,4,2962,0,40
2362,110,3,551,9,2971,8,90
2363,110,3,552,6,2977,2,60
2364,110,3,553,8,2985,2,80
2365,110,3,554,2,2987,0,20
2366,110,3,555,2,2989,4,20
2367,110,3,556,7,2996,4,70
2368,110,3,557,5,3001,0,50
2369,110,3,558,3,3004,5,30
2370,110,3,559,3,3007,0,30
2371,110,3,560,6,3013,0,60
2372,110,3,561,2,3015,0,20
2373,110,3,562,8,3023,7,80
2374,110,3,563,9,3032,8,90
2375,110,3,564,3,3035,0,30
2376,110,3,565,2,3037,0,20
2377,110,3,566,9,3046,0,90
2378,110,3,567,7,3053,0,70
2379,110,3,568,7,3060,0,70
2380,110,3,569,5,3065,12,50
2381,110,3,570,8,3073,6,80
2382,110,3,571,5,3078,7,50
2383,110,3,572,9,3087,2,90
2384,110,3,573,5,3092,1,50
2385,110,3,574,5,3097,3,50
2386,110,3,575,3,3100,0,30
2387,110,3,576,6,3106,4,60
2388,110,3,577,6,3112,2,60
2389,110,3,578,7,3119,3,70
2390,110,3,579,3,3122,4,30
2391,110,3,580,2,3124,2,20
2392,110,3,581,3,3127,4,30
2393,110,3,582,2,3129,1,20
2394,110,3,583,3,3132,1,30
2395,110,3,584,4,3136,1,40
2396,110,3,585,2,3138,0,20
2397,110,3,586,5,3143,4,50
2398,110,3,587,8,3151,12,80
2399,110,3,588,6,3157,0,60
2400,110,3,589,8,3165,8,80
2401,110,3,590,4,3169,0,40
2402,110,3,591,2,3171,3,20
2403,110,3,592,4,3175,1,40
2404,110,3,593,6,3181,4,60
2405,110,3,594,6,3187,0,60
2406,110,3,595,6,3193,8,60
2407,110,3,596,3,3196,0,30
2408,110,3,597,4,3200,4,40
2409,110,3,598,3,3203,0,30
2410,110,3,599,8,3211,0,80
2411,110,3,600,4,3215,10,40
2412,110,3,601,9,3224,4,90
2413,110,3,602,6,3230,2,60
2414,110,3,603,7,3237,0,70
2415,110,3,604,2,3239,7,20
2416,110,3,605,9,3248,0,90
2417,110,3,606,9,3257,0,90
2418,110,3,607,9,3266,10,90
2419,110,3,608,6,3272,4,60
2420,110,3,609,2,3274,1,20
2421,110,3,610,5,3279,0,50
2422,110,3,611,3,3282,1,30
2423,110,3,612,5,3287,0,50
2424,110,3,613,4,3291,3,40
2425,110,3,614,7,3298,3,70
2426,110,3,615,2,3300,0,20
2427,110,3,616,9,3309,6,90
2428,110,3,617,2,3311,0,20
2429,110,3,618,7,3318,2,70
2430,110,3,619,4,3322,0,40
2431,110,3,620,3,3325,0,30
2432,110,3,621,7,3332,0,70
2433,110,3,622,7,3339,0,70
2434,110,3,623,5,3344,17,50
2435,110,3,624,6,3350,0,60
2436,110,3,625,8,3358,5,80
2437,110,3,626,9,3367,6,90
2438,110,3,627,8,3375,0,80
2439,110,3,628,8,3383,10,80
2440,110,3,629,6,3389,2,60
2441,110,3,630,9,3398,3,90
2442,110,3,631,3,3401,0,30
2443,110,3,632,4,3405,0,40
2444,110,3,633,4,3409,5,40
2445,110,3,634,3,3412,1,30
2446,110,3,635,3,3415,0,30
2447,110,3,636,2,3417,1,20
2448,110,3,637,2,3419,1,20
2449,110,3,638,2,3421,1,20
2450,110,3,639,6,3427,3,60
2451,110,3,640,7,3434,0,70
2452,110,3,641,8,3442,13,80
2453,110,3,642,5,3447,2,50
2454,110,3,643,4,3451,0,40
2455,110,3,644,6,3457,3,60
2456,110,3,645,4,3461,1,40
2457,110,3,646,4,3465,0,40
2458,110,3,647,4,3469,0,40
2459,110,3,648,9,3478,7,90
2460,110,3,649,4,3482,0,40
2461,110,3,650,6,3488,5,60
2462,110,3,651,7,3495,0,70
2463,110,3,652,9,3504,11,90
2464,110,3,653,5,3509,2,50
2465,110,3,654,7,3516,5,70
2466,110,3,655,9,3525,5,90
2467,110,3,656,2,3527,0,20
2468,110,3,657,9,3536,0,90
2469,110,3,658,4,3540,2,40
2470,110,3,659,7,3547,4,70
2471,110,3,660,5,3552,2,50
2472,110,3,661,9,3561,4,90
2473,110,3,662,2,3563,1,20
2474,110,3,663,4,3567,0,40
2475,110,3,664,9,3576,0,90
2476,110,3,665,7,3583,0,70
2477,110,3,666,6,3589,0,60
2478,110,3,667,5,3594,17,50
2479,110,3,668,8,3602,0,80
2480,110,3,669,8,3610,14,80
2481,110,3,670,5,3615,6,50
2482,110,3,671,7,3622,5,70
2483,110,3,672,7,3629,0,70
2484,110,3,673,6,3635,10,60
2485,110,3,674,8,3643,5,80
2486,110,3,675,2,3645,0,20
2487,110,3,676,6,3651,3,60
2488,110,3,677,2,3653,2,20
2489,110,3,678,7,3660,0,70
2490,110,3,679,9,3669,9,90
2491,110,3,680,3,3672,0,30
2492,110,3,681,7,3679,4,70
2493,110,3,682,3,3682,0,30
2494,110,3,683,2,3684,0,20
2495,110,3,684,9,3693,7,90
2496,110,3,685,7,3700,0,70
2497,110,3,686,9,3709,3,90
2498,110,3,687,2,3711,0,20
2499,110,3,688,2,3713,0,20
2500,110,3,689,2,3715,8,20
2501,110,3,690,3,3718,1,30
2502,110,3,691,7,3725,5,70
2503,110,3,692,3,3728,0,30
2504,110,3,693,8,3736,4,80
2505,110,3,694,2,3738,1,20
2506,110,3,695,5,3743,4,50
2507,110,3,696,2,3745,0,20
2508,110,3,697,6,3751,0,60
2509,110,3,698,8,3759,0,80
2510,110,3,699,6,3765,0,60
2511,110,3,700,3,3768,11,30
2512,110,3,701,7,3775,7,70
2513,110,3,702,2,3777,0,20
2514,110,3,703,3,3780,1,30
2515,110,3,704,4,3784,3,40
2516,110,3,705,9,3793,0,90
2517,110,3,706,5,3798,7,50
2518,110,3,707,5,3803,3,50
2519,110,3,708,6,3809,1,60
2520,110,3,709,8,3817,4,80
2521,110,3,710,6,3823,4,60
2522,110,3,711,8,3831,0,80
2523,110,3,712,2,3833,5,20
2524,110,3,713,9,3842,4,90
2525,110,3,714,4,3846,0,40
2526,110,3,715,3,3849,0,30
2527,110,3,716,3,3852,6,30
2528,110,3,717,9,3861,0,90
2529,110,3,718,2,3863,6,20
2530,110,3,719,3,3866,1,30
2531,110,3,720,4,3870,1,40
2532,110,3,721,4,3874,3,40
2533,110,3,722,3,3877,3,30
2534,110,3,723,3,3880,2,30
2535,110,3,724,8,3888,7,80
2536,110,3,725,9,3897,3,90
2537,110,3,726,9,3906,0,90
2538,110,3,727,9,3915,7,90
2539,110,3,728,5,3920,0,50
2540,110,3,729,8,3928,8,80
2541,110,3,730,3,3931,3,30
2542,110,3,731,2,3933,0,20
2543,110,3,732,6,3939,3,60
2544,110,3,733,4,3943,2,40
2545,110,3,734,8,3951,4,80
2546,110,3,735,3,3954,0,30
2547,110,3,736,4,3958,0,40
2548,110,3,737,6,3964,8,60
2549,110,3,738,8,3972,4,80
2550,110,3,739,2,3974,0,20
2551,110,3,740,2,3976,0,20
2552,110,3,741,6,3982,4,60
2553,110,3,742,7,3989,0,70
2554,110,3,743,2,3991,2,20
2555,110,3,744,5,3996,1,50
2556,110,3,745,2,3998,1,20
2557,110,3,746,6,4004,0,60
2558,110,3,747,4,4008,2,40
2559,110,3,748,3,4011,0,30
2560,110,3,749,6,4017,0,60
2561,110,3,750,3,4020,5,30
2562,110,3,751,6,4026,3,60
2563,110,3,752,8,4034,3,80
2564,110,3,753,5,4039,1,50
2565,110,3,754,9,4048,0,90
2566,110,3,755,5,4053,0,50
2567,110,3,756,8,4061,3,80
2568,110,3,757,5,4066,7,50
2569,110,3,758,6,4072,0,60
2570,110,3,759,7,4079,3,70
2571,110,3,760,6,4085,0,60
2572,110,3,761,5,4090,10,50
2573,110,3,762,5,4095,1,50
2574,110,3,763,4,4099,0,40
2575,110,3,764,2,4101,0,20
2576,110,3,765,9,4110,6,90
2577,110,3,766,9,4119,0,90
2578,110,3,767,4,4123,0,40
2579,110,3,768,2,4125,6,20
2580,110,3,769,2,4127,0,20
2581,110,3,770,4,4131,0,40
2582,110,3,771,5,4136,0,50
2583,110,3,772,6,4142,9,60
2584,110,3,773,4,4146,1,40
2585,110,3,774,8,4154,4,80
2586,110,3,775,9,4163,4,90
2587,110,3,776,2,4165,1,20
2588,110,3,777,3,4168,1,30
2589,110,3,778,3,4171,0,30
2590,110,3,779,6,4177,0,60
2591,110,3,780,6,4183,0,60
2592,110,3,781,2,4185,0,20
2593,110,3,782,2,4187,11,20
2594,110,3,783,7,4194,4,70
2595,110,3,784,2,4196,2,20
2596,110,3,785,2,4198,0,20
2597,110,3,786,8,4206,0,80
2598,110,3,787,2,4208,3,20
2599,110,3,788,3,4211,0,30
2600,110,3,789,4,4215,6,40
2601,110,3,790,2,4217,0,20
2602,110,3,791,8,4225,6,80
2603,110,3,792,5,4230,0,50
2604,110,3,793,2,4232,3,20
2605,110,3,794,8,4240,3,80
2606,110,3,795,9,4249,6,90
2607,110,3,796,8,4257,0,80
2608,110,3,797,2,4259,5,20
2609,110,3,798,5,4264,0,50
2610,110,3,799,9,4273,7,90
2611,110,3,800,8,4281,2,80
2612,110,3,801,5,4286,1,50
2613,110,3,802,7,4293,0,70
2614,110,3,803,8,4301,10,80
2615,110,3,804,6,4307,0,60
2616,110,3,805,2,4309,4,20
2617,110,3,806,3,4312,0,30
2618,110,3,807,7,4319,0,70
2619,110,3,808,6,4325,7,60
2620,110,3,809,3,4328,2,30
2621,110,3,810,7,4335,3,70
2622,110,3,811,3,4338,0,30
2623,110,3,812,4,4342,5,40
2624,110,3,813,5,4347,3,50
2625,110,3,814,5,4352,0,50
2626,110,3,815,9,4361,7,90
2627,110,3,816,8,4369,4,80
2628,110,3,817,2,4371,1,20
2629,110,3,818,8,4379,3,80
2630,110,3,819,5,4384,0,50
2631,110,3,820,2,4386,3,20
2632,110,3,821,3,4389,1,30
2633,110,3,822,2,4391,0,20
2634,110,3,823,4,4395,3,40
2635,110,3,824,5,4400,0,50
2636,110,3,825,6,4406,3,60
2637,110,3,826,6,4412,0,60
2638,110,3,827,7,4419,9,70
2639,110,3,828,5,4424,2,50
2640,110,3,829,3,4427,1,30
2641,110,3,830,7,4434,5,70
2642,110,3,831,2,4436,1,20
2643,110,3,832,5,4441,0,50
2644,110,3,833,7,4448,1,70
2645,110,3,834,7,4455,3,70
2646,110,3,835,9,4464,6,90
2647,110,3,836,3,4467,2,30
2648,110,3,837,4,4471,0,40
2649,110,3,838,2,4473,1,20
2650,110,3,839,8,4481,2,80
2651,110,3,840,4,4485,3,40
2652,110,3,841,7,4492,0,70
2653,110,3,842,4,4496,0,40
2654,110,3,843,4,4500,0,40
2655,110,3,844,6,4506,4,60
2656,110,3,845,3,4509,0,30
2657,110,3,846,4,4513,5,40
2658,110,3,847,6,4519,3,60
2659,110,3,848,9,4528,0,90
2660,110,3,849,7,4535,0,70
2661,110,3,850,4,4539,8,40
2662,110,3,851,3,4542,0,30
2663,110,3,852,2,4544,1,20
2664,110,3,853,6,4550,5,60
2665,110,3,854,6,4556,0,60
2666,110,3,855,3,4559,0,30
2667,110,3,856,7,4566,0,70
2668,110,3,857,9,4575,7,90
2669,110,3,858,3,4578,0,30
2670,110,3,859,5,4583,0,50
2671,110,3,860,5,4588,0,50
2672,110,3,861,8,4596,8,80
2673,110,3,862,5,4601,0,50
2674,110,3,863,4,4605,2,40
2675,110,3,864,7,4612,0,70
2676,110,3,865,6,4618,7,60
2677,110,3,866,6,4624,3,60
2678,110,3,867,8,4632,2,80
2679,110,3,868,3,4635,2,30
2680,110,3,869,2,4637,0,20
2681,110,3,870,7,4644,5,70
2682,110,3,871,2,4646,2,20
2683,110,3,872,8,4654,6,80
2684,110,3,873,2,4656,0,20
2685,110,3,874,3,4659,3,30
2686,110,3,875,4,4663,0,40
2687,110,3,876,5,4668,4,50
2688,110,3,877,2,4670,0,20
2689,110,3,878,9,4679,0,90
2690,110,3,879,3,4682,0,30
2691,110,3,880,2,4684,0,20
2692,110,3,881,4,4688,11,40
2693,110,3,882,7,4695,3,70
2694,110,3,883,7,4702,3,70
2695,110,3,884,5,4707,6,50
2696,110,3,885,8,4715,4,80
2697,110,3,886,6,4721,5,60
2698,110,3,887,3,4724,3,30
2699,110,3,888,3,4727,0,30
2700,110,3,889,7,4734,0,70
2701,110,3,890,7,4741,4,70
2702,110,3,891,8,4749,1,80
2703,110,3,892,3,4752,2,30
2704,110,3,893,4,4756,0,40
2705,110,3,894,8,4764,9,80
2706,110,3,895,7,4771,4,70
2707,110,3,896,9,4780,5,90
2708,110,3,897,5,4785,3,50
2709,110,3,898,2,4787,0,20
2710,110,3,899,4,4791,0,40
2711,110,3,900,7,4798,2,70
2712,110,3,901,8,4806,0,80
2713,110,3,902,9,4815,0,90
2714,110,3,903,3,4818,7,30
2715,110,3,904,2,4820,0,20
2716,110,3,905,9,4829,4,90
2717,110,3,906,5,4834,1,50
2718,110,3,907,2,4836,1,20
2719,110,3,908,8,4844,6,80
2720,110,3,909,3,4847,0,30
2721,110,3,910,8,4855,2,80
2722,110,3,911,7,4862,4,70
2723,110,3,912,2,4864,0,20
2724,110,3,913,6,4870,2,60
2725,110,3,914,6,4876,3,60
2726,110,3,915,9,4885,7,90
2727,110,3,916,2,4887,0,20
2728,110,3,917,2,4889,1,20
2729,110,3,918,3,4892,2,30
2730,110,3,919,3,4895,2,30
2731,110,3,920,5,4900,4,50
2732,110,3,921,6,4906,0,60
2733,110,3,922,6,4912,0,60
2734,110,3,923,6,4918,0,60
2735,110,3,924,2,4920,0,20
2736,110,3,925,3,4923,11,30
2737,110,3,926,7,4930,2,70
2738,110,3,927,9,4939,6,90
2739,110,3,928,8,4947,1,80
2740,110,3,929,9,4956,6,90
2741,110,3,930,2,4958,1,20
2742,110,3,931,5,4963,3,50
2743,110,3,932,6,4969,2,60
2744,110,3,933,9,4978,5,90
2745,110,3,934,2,4980,0,20
2746,110,3,935,6,4986,8,60
2747,110,3,936,6,4992,0,60
2748,110,3,937,6,4998,7,60
