,Scenario,Trial,Inspection,Interval,Time,Accumulation,Defects,Rate
0,78,1,1,5,5,2,0,50
1,78,1,2,7,12,4,1,70
2,78,1,3,7,19,8,1,70
3,78,1,4,2,21,8,2,20
4,78,1,5,5,26,12,1,50
5,78,1,6,5,31,12,1,50
6,78,1,7,3,34,11,0,30
7,78,1,8,7,41,15,2,70
8,78,1,9,9,50,18,1,90
9,78,1,10,7,57,19,0,70
10,78,1,11,7,64,20,2,70
11,78,1,12,6,70,20,1,60
12,78,1,13,9,79,21,3,90
13,78,1,14,8,87,25,3,80
14,78,1,15,9,96,27,27,90
15,78,1,16,5,101,2,0,50
16,78,1,17,7,108,9,9,70
17,78,1,18,3,111,2,0,30
18,78,1,19,6,117,7,7,60
19,78,1,20,9,126,3,0,90
20,78,1,21,8,134,8,0,80
21,78,1,22,3,137,10,1,30
22,78,1,23,4,141,14,14,40
23,78,1,24,5,146,1,0,50
24,78,1,25,8,154,5,1,80
25,78,1,26,5,159,8,0,50
26,78,1,27,3,162,9,0,30
27,78,1,28,5,167,11,1,50
28,78,1,29,8,175,15,1,80
29,78,1,30,3,178,16,3,30
30,78,1,31,2,180,14,2,20
31,78,1,32,5,185,16,1,50
32,78,1,33,3,188,15,0,30
33,78,1,34,7,195,21,2,70
34,78,1,35,8,203,23,23,80
35,78,1,36,8,211,6,6,80
36,78,1,37,4,215,0,0,40
37,78,1,38,2,217,1,0,20
38,78,1,39,6,223,7,7,60
39,78,1,40,9,232,5,0,90
40,78,1,41,3,235,6,1,30
41,78,1,42,8,243,7,1,80
42,78,1,43,4,247,9,9,40
43,78,1,44,9,256,3,3,90
44,78,1,45,6,262,2,0,60
45,78,1,46,9,271,11,1,90
46,78,1,47,5,276,13,2,50
47,78,1,48,7,283,16,3,70
48,78,1,49,2,285,15,15,20
49,78,1,50,6,291,5,0,60
50,78,1,51,8,299,6,6,80
51,78,1,52,5,304,0,0,50
52,78,1,53,3,307,1,0,30
53,78,1,54,8,315,8,8,80
54,78,1,55,7,322,3,0,70
55,78,1,56,4,326,4,4,40
56,78,1,57,7,333,5,5,70
57,78,1,58,3,336,1,1,30
58,78,1,59,8,344,5,1,80
59,78,1,60,9,353,6,6,90
60,78,1,61,3,356,2,0,30
61,78,1,62,8,364,6,2,80
62,78,1,63,8,372,6,2,80
63,78,1,64,8,380,4,1,80
64,78,1,65,7,387,5,0,70
65,78,1,66,7,394,7,7,70
66,78,1,67,2,396,2,0,20
67,78,1,68,2,398,4,0,20
68,78,1,69,8,406,10,1,80
69,78,1,70,9,415,13,13,90
70,78,1,71,9,424,5,0,90
71,78,1,72,3,427,9,9,30
72,78,1,73,8,435,5,5,80
73,78,1,74,6,441,1,0,60
74,78,1,75,2,443,1,1,20
75,78,1,76,4,447,1,1,40
76,78,1,77,4,451,3,0,40
77,78,1,78,8,459,8,0,80
78,78,1,79,3,462,13,13,30
79,78,1,80,2,464,0,0,20
80,78,1,81,4,468,4,0,40
81,78,1,82,9,477,8,0,90
82,78,1,83,8,485,16,2,80
83,78,1,84,8,493,17,17,80
84,78,1,85,9,502,2,1,90
85,78,1,86,9,511,4,0,90
86,78,1,87,3,514,5,0,30
87,78,1,88,4,518,8,0,40
88,78,1,89,6,524,9,0,60
89,78,1,90,5,529,11,11,50
90,78,1,91,8,537,1,0,80
91,78,1,92,7,544,1,0,70
92,78,1,93,4,548,7,0,40
93,78,1,94,3,551,8,0,30
94,78,1,95,3,554,14,1,30
95,78,1,96,6,560,16,16,60
96,78,1,97,5,565,4,0,50
97,78,1,98,8,573,6,6,80
98,78,1,99,6,579,5,0,60
99,78,1,100,5,584,11,1,50
100,78,1,101,4,588,11,11,40
101,78,1,102,7,595,1,0,70
102,78,1,103,9,604,5,0,90
103,78,1,104,3,607,6,1,30
104,78,1,105,3,610,7,7,30
105,78,1,106,6,616,6,6,60
106,78,1,107,4,620,1,1,40
107,78,1,108,5,625,5,0,50
108,78,1,109,4,629,9,1,40
109,78,1,110,8,637,11,1,80
110,78,1,111,6,643,14,2,60
111,78,1,112,3,646,12,1,30
112,78,1,113,9,655,15,1,90
113,78,1,114,5,660,16,16,50
114,78,1,115,4,664,1,0,40
115,78,1,116,6,670,4,4,60
116,78,1,117,7,677,5,0,70
117,78,1,118,7,684,8,0,70
118,78,1,119,9,693,16,1,90
119,78,1,120,7,700,22,22,70
120,78,1,121,9,709,3,3,90
121,78,1,122,8,717,3,1,80
122,78,1,123,3,720,2,2,30
123,78,1,124,9,729,3,0,90
124,78,1,125,3,732,4,0,30
125,78,1,126,9,741,7,1,90
126,78,1,127,8,749,9,9,80
127,78,1,128,2,751,0,0,20
128,78,1,129,2,753,0,0,20
129,78,1,130,6,759,1,0,60
130,78,1,131,9,768,8,1,90
131,78,1,132,7,775,10,3,70
132,78,1,133,7,782,12,0,70
133,78,1,134,8,790,13,3,80
134,78,1,135,2,792,10,0,20
135,78,1,136,2,794,10,0,20
136,78,1,137,7,801,11,2,70
137,78,1,138,2,803,11,1,20
138,78,1,139,3,806,11,1,30
139,78,1,140,6,812,14,0,60
140,78,1,141,6,818,19,19,60
141,78,1,142,8,826,3,0,80
142,78,1,143,7,833,4,0,70
143,78,1,144,8,841,8,2,80
144,78,1,145,4,845,8,0,40
145,78,1,146,5,850,11,1,50
146,78,1,147,8,858,13,0,80
147,78,1,148,5,863,13,3,50
148,78,1,149,5,868,13,0,50
149,78,1,150,4,872,18,1,40
150,78,1,151,3,875,19,6,30
151,78,1,152,8,883,18,2,80
152,78,1,153,3,886,19,3,30
153,78,1,154,9,895,19,1,90
154,78,1,155,4,899,21,3,40
155,78,1,156,5,904,19,2,50
156,78,1,157,6,910,17,17,60
157,78,1,158,3,913,2,2,30
158,78,1,159,4,917,2,2,40
159,78,1,160,7,924,6,0,70
160,78,1,161,2,926,6,1,20
161,78,1,162,9,935,12,1,90
162,78,1,163,2,937,14,2,20
163,78,1,164,3,940,15,15,30
164,78,1,165,9,949,2,0,90
165,78,1,166,8,957,9,9,80
166,78,1,167,4,961,3,0,40
167,78,1,168,5,966,4,0,50
168,78,1,169,9,975,7,1,90
169,78,1,170,4,979,8,0,40
170,78,1,171,3,982,9,1,30
171,78,1,172,6,988,9,0,60
172,78,1,173,3,991,10,0,30
173,78,1,174,8,999,16,1,80
174,78,1,175,7,1006,22,22,70
175,78,1,176,9,1015,5,5,90
176,78,1,177,9,1024,3,0,90
177,78,1,178,5,1029,5,5,50
178,78,1,179,4,1033,2,0,40
179,78,1,180,6,1039,4,0,60
180,78,1,181,3,1042,5,5,30
181,78,1,182,4,1046,2,0,40
182,78,1,183,3,1049,6,1,30
183,78,1,184,6,1055,6,0,60
184,78,1,185,5,1060,6,0,50
185,78,1,186,6,1066,9,9,60
186,78,1,187,6,1072,3,0,60
187,78,1,188,5,1077,3,0,50
188,78,1,189,4,1081,3,0,40
189,78,1,190,5,1086,6,0,50
190,78,1,191,3,1089,7,0,30
191,78,1,192,3,1092,9,0,30
192,78,1,193,7,1099,11,1,70
193,78,1,194,6,1105,12,12,60
194,78,1,195,5,1110,2,0,50
195,78,1,196,7,1117,5,0,70
196,78,1,197,6,1123,6,1,60
197,78,1,198,8,1131,7,1,80
198,78,1,199,2,1133,7,0,20
199,78,1,200,9,1142,11,1,90
200,78,1,201,3,1145,10,10,30
201,78,1,202,5,1150,1,1,50
202,78,1,203,9,1159,4,0,90
203,78,1,204,2,1161,5,5,20
204,78,1,205,2,1163,1,0,20
205,78,1,206,6,1169,1,1,60
206,78,1,207,5,1174,4,0,50
207,78,1,208,7,1181,11,2,70
208,78,1,209,7,1188,11,0,70
209,78,1,210,3,1191,14,0,30
210,78,1,211,5,1196,15,0,50
211,78,1,212,7,1203,16,2,70
212,78,1,213,2,1205,14,1,20
213,78,1,214,5,1210,13,3,50
214,78,1,215,5,1215,15,0,50
215,78,1,216,2,1217,15,3,20
216,78,1,217,5,1222,14,2,50
217,78,1,218,5,1227,15,1,50
218,78,1,219,3,1230,15,1,30
219,78,1,220,2,1232,16,0,20
220,78,1,221,3,1235,17,17,30
221,78,1,222,2,1237,3,3,20
222,78,1,223,7,1244,4,0,70
223,78,1,224,4,1248,5,5,40
224,78,1,225,5,1253,5,0,50
225,78,1,226,8,1261,11,0,80
226,78,1,227,3,1264,11,2,30
227,78,1,228,6,1270,13,2,60
228,78,1,229,6,1276,14,14,60
229,78,1,230,2,1278,0,0,20
230,78,1,231,5,1283,1,0,50
231,78,1,232,9,1292,2,0,90
232,78,1,233,3,1295,6,0,30
233,78,1,234,5,1300,11,11,50
234,78,1,235,3,1303,0,0,30
235,78,1,236,5,1308,1,0,50
236,78,1,237,7,1315,3,0,70
237,78,1,238,6,1321,8,1,60
238,78,1,239,3,1324,8,0,30
239,78,1,240,7,1331,14,1,70
240,78,1,241,3,1334,16,5,30
241,78,1,242,2,1336,14,1,20
242,78,1,243,5,1341,17,2,50
243,78,1,244,6,1347,15,1,60
244,78,1,245,3,1350,15,15,30
245,78,1,246,5,1355,3,0,50
246,78,1,247,2,1357,4,0,20
247,78,1,248,6,1363,7,0,60
248,78,1,249,7,1370,12,12,70
249,78,1,250,4,1374,1,0,40
250,78,1,251,5,1379,7,2,50
251,78,1,252,3,1382,7,7,30
252,78,1,253,2,1384,1,0,20
253,78,1,254,2,1386,2,0,20
254,78,1,255,9,1395,7,0,90
255,78,1,256,8,1403,12,1,80
256,78,1,257,5,1408,13,0,50
257,78,1,258,6,1414,14,1,60
258,78,1,259,2,1416,13,0,20
259,78,1,260,9,1425,21,5,90
260,78,1,261,8,1433,18,18,80
261,78,1,262,5,1438,3,0,50
262,78,1,263,5,1443,7,1,50
263,78,1,264,4,1447,9,1,40
264,78,1,265,4,1451,10,1,40
265,78,1,266,3,1454,10,0,30
266,78,1,267,4,1458,11,11,40
267,78,1,268,7,1465,1,0,70
268,78,1,269,6,1471,6,6,60
269,78,1,270,5,1476,4,0,50
270,78,1,271,5,1481,7,1,50
271,78,1,272,3,1484,8,0,30
272,78,1,273,4,1488,8,1,40
273,78,1,274,5,1493,7,0,50
274,78,1,275,3,1496,10,1,30
275,78,1,276,9,1505,14,3,90
276,78,1,277,4,1509,11,1,40
277,78,1,278,3,1512,11,2,30
278,78,1,279,4,1516,11,1,40
279,78,1,280,4,1520,14,3,40
280,78,1,281,3,1523,16,16,30
281,78,1,282,6,1529,3,1,60
282,78,1,283,4,1533,2,2,40
283,78,1,284,6,1539,3,0,60
284,78,1,285,3,1542,5,0,30
285,78,1,286,2,1544,6,1,20
286,78,1,287,6,1550,7,7,60
287,78,1,288,2,1552,1,0,20
288,78,1,289,5,1557,4,1,50
289,78,1,290,2,1559,4,0,20
290,78,1,291,6,1565,4,0,60
291,78,1,292,8,1573,6,0,80
292,78,1,293,5,1578,7,0,50
293,78,1,294,9,1587,12,4,90
294,78,1,295,5,1592,8,0,50
295,78,1,296,3,1595,11,11,30
296,78,1,297,3,1598,1,0,30
297,78,1,298,4,1602,2,0,40
298,78,1,299,3,1605,5,0,30
299,78,1,300,3,1608,7,7,30
300,78,1,301,5,1613,2,0,50
301,78,1,302,9,1622,6,6,90
302,78,1,303,8,1630,7,1,80
303,78,1,304,5,1635,8,8,50
304,78,1,305,6,1641,1,0,60
305,78,1,306,3,1644,3,0,30
306,78,1,307,6,1650,7,3,60
307,78,1,308,9,1659,4,1,90
308,78,1,309,6,1665,6,0,60
309,78,1,310,6,1671,7,1,60
310,78,1,311,8,1679,11,11,80
311,78,1,312,4,1683,3,0,40
312,78,1,313,4,1687,4,4,40
313,78,1,314,7,1694,3,0,70
314,78,1,315,8,1702,5,0,80
315,78,1,316,8,1710,8,8,80
316,78,1,317,9,1719,1,0,90
317,78,1,318,7,1726,3,1,70
318,78,1,319,8,1734,7,0,80
319,78,1,320,4,1738,8,8,40
320,78,1,321,6,1744,3,0,60
321,78,1,322,6,1750,6,1,60
322,78,1,323,2,1752,6,0,20
323,78,1,324,6,1758,9,1,60
324,78,1,325,7,1765,9,0,70
325,78,1,326,3,1768,9,2,30
326,78,1,327,6,1774,8,1,60
327,78,1,328,2,1776,8,1,20
328,78,1,329,6,1782,9,0,60
329,78,1,330,6,1788,13,0,60
330,78,1,331,3,1791,17,1,30
331,78,1,332,8,1799,17,2,80
332,78,1,333,5,1804,17,3,50
333,78,1,334,6,1810,16,1,60
334,78,1,335,5,1815,17,17,50
335,78,1,336,8,1823,3,0,80
336,78,1,337,3,1826,4,0,30
337,78,1,338,5,1831,6,0,50
338,78,1,339,5,1836,8,0,50
339,78,1,340,7,1843,10,10,70
340,78,1,341,6,1849,1,1,60
341,78,1,342,4,1853,2,2,40
342,78,1,343,3,1856,0,0,30
343,78,1,344,2,1858,1,0,20
344,78,1,345,6,1864,5,5,60
345,78,1,346,5,1869,5,0,50
346,78,1,347,3,1872,6,6,30
347,78,1,348,8,1880,2,0,80
348,78,1,349,5,1885,4,4,50
349,78,1,350,6,1891,9,2,60
350,78,1,351,6,1897,9,9,60
351,78,1,352,5,1902,3,0,50
352,78,1,353,4,1906,5,0,40
353,78,1,354,9,1915,17,3,90
354,78,1,355,8,1923,16,1,80
355,78,1,356,3,1926,18,2,30
356,78,1,357,5,1931,19,2,50
357,78,1,358,8,1939,23,23,80
358,78,1,359,5,1944,4,0,50
359,78,1,360,3,1947,9,9,30
360,78,1,361,9,1956,6,0,90
361,78,1,362,9,1965,10,0,90
362,78,1,363,2,1967,12,0,20
363,78,1,364,5,1972,14,0,50
364,78,1,365,6,1978,20,0,60
365,78,1,366,2,1980,20,3,20
366,78,1,367,9,1989,20,2,90
367,78,1,368,4,1993,19,3,40
368,78,1,369,6,1999,19,19,60
369,78,1,370,9,2008,6,6,90
370,78,1,371,9,2017,5,5,90
371,78,1,372,8,2025,9,1,80
372,78,1,373,2,2027,10,0,20
373,78,1,374,4,2031,12,4,40
374,78,1,375,9,2040,12,1,90
375,78,1,376,8,2048,15,0,80
376,78,1,377,2,2050,19,4,20
377,78,1,378,6,2056,22,0,60
378,78,1,379,6,2062,26,1,60
379,78,1,380,7,2069,27,27,70
380,78,1,381,6,2075,4,1,60
381,78,1,382,5,2080,4,0,50
382,78,1,383,3,2083,6,1,30
383,78,1,384,7,2090,9,0,70
384,78,1,385,7,2097,10,1,70
385,78,1,386,7,2104,12,1,70
386,78,1,387,5,2109,13,2,50
387,78,1,388,3,2112,11,1,30
388,78,1,389,4,2116,13,1,40
389,78,1,390,4,2120,13,13,40
390,78,1,391,4,2124,2,2,40
391,78,1,392,4,2128,1,0,40
392,78,1,393,9,2137,10,1,90
393,78,1,394,6,2143,14,1,60
394,78,1,395,2,2145,13,1,20
395,78,1,396,8,2153,14,1,80
396,78,1,397,9,2162,21,1,90
397,78,1,398,6,2168,23,2,60
398,78,1,399,6,2174,26,26,60
399,78,1,400,8,2182,3,1,80
400,78,1,401,4,2186,4,0,40
401,78,1,402,4,2190,7,0,40
402,78,1,403,5,2195,8,2,50
403,78,1,404,8,2203,11,2,80
404,78,1,405,5,2208,10,10,50
405,78,1,406,3,2211,1,0,30
406,78,1,407,4,2215,3,0,40
407,78,1,408,2,2217,5,0,20
408,78,1,409,3,2220,6,0,30
409,78,1,410,6,2226,12,2,60
410,78,1,411,9,2235,13,1,90
411,78,1,412,9,2244,20,2,90
412,78,1,413,3,2247,20,0,30
413,78,1,414,8,2255,25,3,80
414,78,1,415,9,2264,28,1,90
415,78,1,416,2,2266,28,28,20
416,78,1,417,9,2275,5,1,90
417,78,1,418,7,2282,12,12,70
418,78,1,419,5,2287,1,1,50
419,78,1,420,8,2295,5,0,80
420,78,1,421,2,2297,6,1,20
421,78,1,422,3,2300,7,1,30
422,78,1,423,5,2305,7,1,50
423,78,1,424,8,2313,8,0,80
424,78,1,425,4,2317,9,0,40
425,78,1,426,5,2322,13,0,50
426,78,1,427,8,2330,19,19,80
427,78,1,428,2,2332,1,0,20
428,78,1,429,8,2340,4,4,80
429,78,1,430,4,2344,1,0,40
430,78,1,431,3,2347,3,2,30
431,78,1,432,5,2352,6,2,50
432,78,1,433,5,2357,8,1,50
433,78,1,434,9,2366,12,1,90
434,78,1,435,4,2370,13,13,40
435,78,1,436,7,2377,4,0,70
436,78,1,437,7,2384,7,7,70
437,78,1,438,2,2386,1,1,20
438,78,1,439,5,2391,1,0,50
439,78,1,440,9,2400,5,0,90
440,78,1,441,2,2402,5,2,20
441,78,1,442,6,2408,7,0,60
442,78,1,443,6,2414,11,0,60
443,78,1,444,9,2423,15,0,90
444,78,1,445,5,2428,16,2,50
445,78,1,446,4,2432,14,14,40
446,78,1,447,5,2437,4,1,50
447,78,1,448,8,2445,7,1,80
448,78,1,449,2,2447,6,0,20
449,78,1,450,8,2455,12,0,80
450,78,1,451,6,2461,17,17,60
451,78,1,452,3,2464,4,1,30
452,78,1,453,6,2470,6,1,60
453,78,1,454,3,2473,5,5,30
454,78,1,455,3,2476,1,0,30
455,78,1,456,6,2482,2,0,60
456,78,1,457,5,2487,5,1,50
457,78,1,458,2,2489,4,4,20
458,78,1,459,6,2495,3,0,60
459,78,1,460,8,2503,7,1,80
460,78,1,461,8,2511,6,1,80
461,78,1,462,2,2513,5,1,20
462,78,1,463,2,2515,5,0,20
463,78,1,464,6,2521,6,0,60
464,78,1,465,3,2524,7,0,30
465,78,1,466,5,2529,8,2,50
466,78,1,467,5,2534,7,7,50
467,78,1,468,8,2542,3,0,80
468,78,1,469,4,2546,4,2,40
469,78,1,470,4,2550,3,1,40
470,78,1,471,6,2556,5,5,60
471,78,1,472,3,2559,3,0,30
472,78,1,473,6,2565,7,3,60
473,78,1,474,5,2570,5,5,50
474,78,1,475,7,2577,5,1,70
475,78,1,476,8,2585,9,0,80
476,78,1,477,9,2594,10,1,90
477,78,1,478,6,2600,11,11,60
478,78,1,479,2,2602,1,0,20
479,78,1,480,5,2607,3,0,50
480,78,1,481,8,2615,8,0,80
481,78,1,482,5,2620,11,3,50
482,78,1,483,2,2622,11,1,20
483,78,1,484,5,2627,12,0,50
484,78,1,485,8,2635,16,3,80
485,78,1,486,9,2644,16,5,90
486,78,1,487,5,2649,15,15,50
487,78,1,488,3,2652,2,0,30
488,78,1,489,2,2654,2,2,20
489,78,1,490,2,2656,1,0,20
490,78,1,491,3,2659,1,0,30
491,78,1,492,8,2667,2,0,80
492,78,1,493,6,2673,2,0,60
493,78,1,494,3,2676,3,0,30
494,78,1,495,2,2678,3,3,20
495,78,1,496,2,2680,1,1,20
496,78,1,497,4,2684,2,0,40
497,78,1,498,5,2689,4,0,50
498,78,1,499,8,2697,6,2,80
499,78,1,500,6,2703,7,7,60
500,78,1,501,4,2707,2,0,40
501,78,1,502,7,2714,7,1,70
502,78,1,503,4,2718,8,2,40
503,78,1,504,9,2727,11,0,90
504,78,1,505,2,2729,11,1,20
505,78,1,506,6,2735,12,2,60
506,78,1,507,3,2738,10,10,30
507,78,1,508,5,2743,3,1,50
508,78,1,509,5,2748,4,1,50
509,78,1,510,8,2756,6,1,80
510,78,1,511,5,2761,6,6,50
511,78,1,512,2,2763,3,3,20
512,78,1,513,7,2770,2,0,70
513,78,1,514,6,2776,5,0,60
514,78,1,515,9,2785,15,3,90
515,78,1,516,9,2794,14,4,90
516,78,1,517,3,2797,15,2,30
517,78,1,518,8,2805,16,2,80
518,78,1,519,6,2811,16,16,60
519,78,1,520,6,2817,3,3,60
520,78,1,521,7,2824,0,0,70
521,78,1,522,6,2830,3,1,60
522,78,1,523,6,2836,9,0,60
523,78,1,524,9,2845,15,2,90
524,78,1,525,9,2854,16,3,90
525,78,1,526,9,2863,20,2,90
526,78,1,527,9,2872,25,2,90
527,78,1,528,9,2881,29,4,90
528,78,1,529,5,2886,26,2,50
529,78,1,530,6,2892,25,3,60
530,78,1,531,6,2898,26,4,60
531,78,1,532,9,2907,23,2,90
532,78,1,533,5,2912,26,1,50
533,78,1,534,5,2917,27,27,50
534,78,1,535,5,2922,1,0,50
535,78,1,536,7,2929,3,3,70
536,78,1,537,7,2936,3,3,70
537,78,1,538,8,2944,7,0,80
538,78,1,539,8,2952,11,11,80
539,78,1,540,8,2960,3,0,80
540,78,1,541,5,2965,6,0,50
541,78,1,542,5,2970,8,1,50
542,78,1,543,6,2976,11,1,60
543,78,1,544,3,2979,11,1,30
544,78,1,545,4,2983,13,1,40
545,78,1,546,6,2989,17,3,60
546,78,1,547,9,2998,22,3,90
547,78,1,548,2,3000,21,3,20
548,78,1,549,2,3002,19,4,20
549,78,1,550,5,3007,17,0,50
550,78,1,551,6,3013,17,0,60
551,78,1,552,2,3015,18,6,20
552,78,1,553,8,3023,17,0,80
553,78,1,554,9,3032,20,1,90
554,78,1,555,6,3038,26,2,60
555,78,1,556,6,3044,27,1,60
556,78,1,557,6,3050,30,6,60
557,78,1,558,5,3055,27,5,50
558,78,1,559,5,3060,23,0,50
559,78,1,560,6,3066,25,3,60
560,78,1,561,9,3075,27,2,90
561,78,1,562,5,3080,28,3,50
562,78,1,563,3,3083,27,1,30
563,78,1,564,2,3085,29,1,20
564,78,1,565,3,3088,29,29,30
565,78,1,566,8,3096,8,8,80
566,78,1,567,3,3099,1,0,30
567,78,1,568,4,3103,2,0,40
568,78,1,569,2,3105,5,0,20
569,78,1,570,7,3112,11,1,70
570,78,1,571,7,3119,13,2,70
571,78,1,572,6,3125,17,0,60
572,78,1,573,7,3132,20,1,70
573,78,1,574,6,3138,23,4,60
574,78,1,575,6,3144,19,1,60
575,78,1,576,5,3149,20,3,50
576,78,1,577,7,3156,22,22,70
577,78,1,578,3,3159,1,0,30
578,78,1,579,8,3167,8,8,80
579,78,1,580,2,3169,0,0,20
580,78,1,581,8,3177,6,1,80
581,78,1,582,6,3183,10,10,60
582,78,1,583,7,3190,5,0,70
583,78,1,584,3,3193,6,1,30
584,78,1,585,9,3202,10,1,90
585,78,1,586,9,3211,15,2,90
586,78,1,587,4,3215,15,2,40
587,78,1,588,8,3223,14,1,80
588,78,1,589,6,3229,16,1,60
589,78,1,590,6,3235,17,1,60
590,78,1,591,6,3241,16,0,60
591,78,1,592,6,3247,20,2,60
592,78,1,593,2,3249,20,3,20
593,78,1,594,8,3257,20,5,80
594,78,1,595,6,3263,20,1,60
595,78,1,596,6,3269,21,21,60
596,78,1,597,7,3276,2,0,70
597,78,1,598,6,3282,4,4,60
598,78,1,599,4,3286,2,0,40
599,78,1,600,4,3290,3,3,40
600,78,1,601,8,3298,2,0,80
601,78,1,602,9,3307,8,0,90
602,78,1,603,6,3313,11,0,60
603,78,1,604,5,3318,15,1,50
604,78,1,605,5,3323,14,3,50
605,78,1,606,2,3325,13,0,20
606,78,1,607,5,3330,16,2,50
607,78,1,608,4,3334,20,2,40
608,78,1,609,9,3343,23,1,90
609,78,1,610,2,3345,23,1,20
610,78,1,611,5,3350,24,3,50
611,78,1,612,7,3357,24,3,70
612,78,1,613,8,3365,24,1,80
613,78,1,614,7,3372,27,27,70
614,78,1,615,7,3379,1,0,70
615,78,1,616,8,3387,8,8,80
616,78,1,617,4,3391,5,0,40
617,78,1,618,3,3394,6,1,30
618,78,1,619,5,3399,8,8,50
619,78,1,620,7,3406,4,0,70
620,78,1,621,5,3411,9,0,50
621,78,1,622,5,3416,11,2,50
622,78,1,623,8,3424,16,16,80
623,78,1,624,5,3429,2,0,50
624,78,1,625,8,3437,7,1,80
625,78,1,626,7,3444,9,1,70
626,78,1,627,4,3448,12,12,40
627,78,1,628,9,3457,7,7,90
628,78,1,629,8,3465,1,1,80
629,78,1,630,5,3470,2,2,50
630,78,1,631,4,3474,3,3,40
631,78,1,632,7,3481,3,3,70
632,78,1,633,7,3488,1,0,70
633,78,1,634,5,3493,5,5,50
634,78,1,635,6,3499,2,2,60
635,78,1,636,2,3501,1,1,20
636,78,1,637,3,3504,3,0,30
637,78,1,638,8,3512,8,8,80
638,78,1,639,8,3520,1,0,80
639,78,1,640,4,3524,3,0,40
640,78,1,641,3,3527,3,0,30
641,78,1,642,8,3535,9,1,80
642,78,1,643,6,3541,12,12,60
643,78,1,644,7,3548,4,0,70
644,78,1,645,5,3553,6,6,50
645,78,1,646,2,3555,3,0,20
646,78,1,647,9,3564,8,0,90
647,78,1,648,7,3571,12,1,70
648,78,1,649,7,3578,17,1,70
649,78,1,650,6,3584,18,3,60
650,78,1,651,6,3590,18,18,60
651,78,1,652,5,3595,2,2,50
652,78,1,653,4,3599,1,1,40
653,78,1,654,7,3606,3,0,70
654,78,1,655,9,3615,6,1,90
655,78,1,656,4,3619,7,0,40
656,78,1,657,2,3621,8,2,20
657,78,1,658,8,3629,8,1,80
658,78,1,659,2,3631,7,0,20
659,78,1,660,7,3638,15,1,70
660,78,1,661,6,3644,18,18,60
661,78,1,662,8,3652,1,0,80
662,78,1,663,5,3657,2,0,50
663,78,1,664,9,3666,7,1,90
664,78,1,665,7,3673,9,0,70
665,78,1,666,3,3676,12,0,30
666,78,1,667,9,3685,16,3,90
667,78,1,668,2,3687,14,14,20
668,78,1,669,6,3693,2,0,60
669,78,1,670,2,3695,2,0,20
670,78,1,671,7,3702,4,1,70
671,78,1,672,4,3706,7,7,40
672,78,1,673,4,3710,2,2,40
673,78,1,674,2,3712,3,0,20
674,78,1,675,9,3721,11,1,90
675,78,1,676,7,3728,17,3,70
676,78,1,677,7,3735,16,2,70
677,78,1,678,9,3744,21,2,90
678,78,1,679,7,3751,23,1,70
679,78,1,680,4,3755,24,1,40
680,78,1,681,2,3757,25,25,20
681,78,1,682,7,3764,3,0,70
682,78,1,683,4,3768,6,0,40
683,78,1,684,2,3770,8,8,20
684,78,1,685,7,3777,3,1,70
685,78,1,686,2,3779,3,1,20
686,78,1,687,5,3784,6,1,50
687,78,1,688,2,3786,6,0,20
688,78,1,689,8,3794,10,10,80
689,78,1,690,7,3801,5,0,70
690,78,1,691,4,3805,7,7,40
691,78,1,692,4,3809,1,0,40
692,78,1,693,3,3812,2,0,30
693,78,1,694,2,3814,3,0,20
694,78,1,695,3,3817,4,0,30
695,78,1,696,8,3825,9,9,80
696,78,1,697,9,3834,5,0,90
697,78,1,698,3,3837,7,1,30
698,78,1,699,6,3843,8,0,60
699,78,1,700,8,3851,9,9,80
700,78,1,701,9,3860,3,0,90
701,78,1,702,5,3865,5,5,50
702,78,1,703,7,3872,1,0,70
703,78,1,704,5,3877,4,1,50
704,78,1,705,4,3881,7,0,40
705,78,1,706,6,3887,10,1,60
706,78,1,707,8,3895,9,0,80
707,78,1,708,6,3901,9,0,60
708,78,1,709,8,3909,14,0,80
709,78,1,710,9,3918,19,2,90
710,78,1,711,9,3927,22,3,90
711,78,1,712,4,3931,22,22,40
712,78,1,713,4,3935,2,0,40
713,78,1,714,7,3942,4,0,70
714,78,1,715,5,3947,6,0,50
715,78,1,716,3,3950,8,0,30
716,78,1,717,7,3957,14,1,70
717,78,1,718,5,3962,16,1,50
718,78,1,719,7,3969,15,0,70
719,78,1,720,6,3975,16,16,60
720,78,1,721,3,3978,3,0,30
721,78,1,722,9,3987,8,0,90
722,78,1,723,6,3993,10,0,60
723,78,1,724,2,3995,10,1,20
724,78,1,725,6,4001,11,1,60
725,78,1,726,4,4005,12,12,40
726,78,1,727,5,4010,2,2,50
727,78,1,728,7,4017,4,0,70
728,78,1,729,5,4022,7,0,50
729,78,1,730,2,4024,8,1,20
730,78,1,731,6,4030,9,1,60
731,78,1,732,8,4038,10,0,80
732,78,1,733,2,4040,12,0,20
733,78,1,734,2,4042,12,1,20
734,78,1,735,6,4048,13,4,60
735,78,1,736,2,4050,9,2,20
736,78,1,737,8,4058,9,0,80
737,78,1,738,4,4062,9,0,40
738,78,1,739,3,4065,12,12,30
739,78,1,740,2,4067,1,0,20
740,78,1,741,7,4074,5,0,70
741,78,1,742,9,4083,10,0,90
742,78,1,743,7,4090,14,14,70
743,78,1,744,6,4096,3,0,60
744,78,1,745,9,4105,6,0,90
745,78,1,746,7,4112,9,1,70
746,78,1,747,9,4121,11,0,90
747,78,1,748,3,4124,13,0,30
748,78,1,749,4,4128,14,1,40
749,78,1,750,4,4132,16,16,40
750,78,1,751,4,4136,1,0,40
751,78,1,752,7,4143,5,0,70
752,78,1,753,4,4147,6,6,40
753,78,1,754,6,4153,5,1,60
754,78,1,755,2,4155,4,4,20
755,78,1,756,4,4159,3,0,40
756,78,1,757,5,4164,4,0,50
757,78,1,758,6,4170,4,1,60
758,78,1,759,4,4174,6,1,40
759,78,1,760,6,4180,9,1,60
760,78,1,761,3,4183,8,0,30
761,78,1,762,6,4189,14,0,60
762,78,1,763,5,4194,15,15,50
763,78,1,764,7,4201,3,0,70
764,78,1,765,7,4208,6,1,70
765,78,1,766,4,4212,9,3,40
766,78,1,767,5,4217,7,2,50
767,78,1,768,2,4219,7,1,20
768,78,1,769,2,4221,8,0,20
769,78,1,770,4,4225,10,1,40
770,78,1,771,6,4231,13,13,60
771,78,1,772,9,4240,5,1,90
772,78,1,773,7,4247,6,1,70
773,78,1,774,9,4256,7,7,90
774,78,1,775,5,4261,3,1,50
775,78,1,776,6,4267,10,0,60
776,78,1,777,3,4270,13,1,30
777,78,1,778,5,4275,13,13,50
778,78,1,779,6,4281,3,3,60
779,78,1,780,9,4290,7,7,90
780,78,1,781,4,4294,5,0,40
781,78,1,782,3,4297,6,0,30
782,78,1,783,4,4301,7,1,40
783,78,1,784,9,4310,7,7,90
784,78,1,785,8,4318,4,0,80
785,78,1,786,7,4325,10,1,70
786,78,1,787,9,4334,12,2,90
787,78,1,788,5,4339,10,1,50
788,78,1,789,3,4342,11,1,30
789,78,1,790,8,4350,15,0,80
790,78,1,791,5,4355,16,16,50
791,78,1,792,4,4359,2,0,40
792,78,1,793,4,4363,4,4,40
793,78,1,794,7,4370,2,0,70
794,78,1,795,8,4378,4,0,80
795,78,1,796,9,4387,6,6,90
796,78,1,797,8,4395,4,0,80
797,78,1,798,3,4398,5,5,30
798,78,1,799,2,4400,1,0,20
799,78,1,800,7,4407,5,5,70
800,78,1,801,6,4413,4,0,60
801,78,1,802,8,4421,10,0,80
802,78,1,803,7,4428,11,11,70
803,78,1,804,6,4434,3,3,60
804,78,1,805,7,4441,4,4,70
805,78,1,806,6,4447,1,0,60
806,78,1,807,8,4455,4,4,80
807,78,1,808,6,4461,3,0,60
808,78,1,809,8,4469,5,0,80
809,78,1,810,7,4476,9,9,70
810,78,1,811,7,4483,4,4,70
811,78,1,812,3,4486,4,0,30
812,78,1,813,4,4490,10,0,40
813,78,1,814,8,4498,14,0,80
814,78,1,815,7,4505,19,1,70
815,78,1,816,2,4507,21,21,20
816,78,1,817,5,4512,3,0,50
817,78,1,818,8,4520,8,1,80
818,78,1,819,6,4526,8,8,60
819,78,1,820,2,4528,0,0,20
820,78,1,821,2,4530,1,0,20
821,78,1,822,6,4536,4,0,60
822,78,1,823,7,4543,7,7,70
823,78,1,824,8,4551,0,0,80
824,78,1,825,5,4556,2,2,50
825,78,1,826,4,4560,6,1,40
826,78,1,827,5,4565,7,1,50
827,78,1,828,2,4567,6,1,20
828,78,1,829,4,4571,8,1,40
829,78,1,830,3,4574,7,0,30
830,78,1,831,8,4582,14,2,80
831,78,1,832,8,4590,17,1,80
832,78,1,833,5,4595,17,17,50
833,78,1,834,9,4604,3,3,90
834,78,1,835,2,4606,3,0,20
835,78,1,836,5,4611,5,1,50
836,78,1,837,2,4613,4,4,20
837,78,1,838,5,4618,1,0,50
838,78,1,839,9,4627,5,0,90
839,78,1,840,9,4636,10,10,90
840,78,1,841,7,4643,0,0,70
841,78,1,842,9,4652,6,6,90
842,78,1,843,5,4657,2,0,50
843,78,1,844,8,4665,6,6,80
844,78,1,845,3,4668,3,1,30
845,78,1,846,6,4674,8,8,60
846,78,1,847,7,4681,6,0,70
847,78,1,848,4,4685,6,6,40
848,78,1,849,6,4691,3,0,60
849,78,1,850,6,4697,10,0,60
850,78,1,851,7,4704,15,0,70
851,78,1,852,4,4708,15,1,40
852,78,1,853,8,4716,20,20,80
853,78,1,854,3,4719,1,0,30
854,78,1,855,4,4723,2,2,40
855,78,1,856,6,4729,3,0,60
856,78,1,857,7,4736,7,0,70
857,78,1,858,4,4740,7,0,40
858,78,1,859,6,4746,9,1,60
859,78,1,860,2,4748,9,0,20
860,78,1,861,7,4755,14,2,70
861,78,1,862,9,4764,17,17,90
862,78,1,863,2,4766,3,0,20
863,78,1,864,8,4774,5,5,80
864,78,1,865,7,4781,2,2,70
865,78,1,866,9,4790,2,2,90
866,78,1,867,5,4795,1,0,50
867,78,1,868,6,4801,3,3,60
868,78,1,869,9,4810,1,0,90
869,78,1,870,8,4818,5,0,80
870,78,1,871,4,4822,7,1,40
871,78,1,872,3,4825,7,1,30
872,78,1,873,9,4834,11,1,90
873,78,1,874,3,4837,10,0,30
874,78,1,875,5,4842,15,15,50
875,78,1,876,7,4849,3,0,70
876,78,1,877,4,4853,6,6,40
877,78,1,878,9,4862,6,0,90
878,78,1,879,3,4865,6,1,30
879,78,1,880,4,4869,7,0,40
880,78,1,881,7,4876,11,2,70
881,78,1,882,9,4885,16,16,90
882,78,1,883,7,4892,3,0,70
883,78,1,884,6,4898,11,3,60
884,78,1,885,8,4906,11,0,80
885,78,1,886,8,4914,19,3,80
886,78,1,887,3,4917,19,4,30
887,78,1,888,4,4921,18,0,40
888,78,1,889,6,4927,23,2,60
889,78,1,890,7,4934,22,22,70
890,78,1,891,2,4936,0,0,20
891,78,1,892,9,4945,2,0,90
892,78,1,893,9,4954,5,0,90
893,78,1,894,9,4963,8,1,90
894,78,1,895,9,4972,11,11,90
895,78,1,896,7,4979,4,4,70
896,78,1,897,8,4987,5,0,80
897,78,1,898,9,4996,9,0,90
898,78,2,1,2,2,1,0,20
899,78,2,2,8,10,9,1,80
900,78,2,3,7,17,12,12,70
901,78,2,4,2,19,1,0,20
902,78,2,5,3,22,3,0,30
903,78,2,6,7,29,4,4,70
904,78,2,7,7,36,2,0,70
905,78,2,8,9,45,7,0,90
906,78,2,9,9,54,15,1,90
907,78,2,10,7,61,18,3,70
908,78,2,11,7,68,20,2,70
909,78,2,12,5,73,21,3,50
910,78,2,13,5,78,18,1,50
911,78,2,14,4,82,20,20,40
912,78,2,15,3,85,3,0,30
913,78,2,16,5,90,6,0,50
914,78,2,17,9,99,12,3,90
915,78,2,18,3,102,10,0,30
916,78,2,19,3,105,11,0,30
917,78,2,20,2,107,12,1,20
918,78,2,21,3,110,13,2,30
919,78,2,22,2,112,14,3,20
920,78,2,23,5,117,12,1,50
921,78,2,24,3,120,12,0,30
922,78,2,25,6,126,14,3,60
923,78,2,26,8,134,16,0,80
924,78,2,27,2,136,16,16,20
925,78,2,28,2,138,2,0,20
926,78,2,29,6,144,4,0,60
927,78,2,30,6,150,9,9,60
928,78,2,31,6,156,5,1,60
929,78,2,32,4,160,6,6,40
930,78,2,33,3,163,0,0,30
931,78,2,34,4,167,1,0,40
932,78,2,35,5,172,3,0,50
933,78,2,36,7,179,10,10,70
934,78,2,37,4,183,1,1,40
935,78,2,38,2,185,2,0,20
936,78,2,39,7,192,8,2,70
937,78,2,40,9,201,13,1,90
938,78,2,41,5,206,13,0,50
939,78,2,42,6,212,18,0,60
940,78,2,43,6,218,24,4,60
941,78,2,44,4,222,22,1,40
942,78,2,45,3,225,22,2,30
943,78,2,46,6,231,23,2,60
944,78,2,47,3,234,23,1,30
945,78,2,48,2,236,22,5,20
946,78,2,49,3,239,18,18,30
947,78,2,50,9,248,2,0,90
948,78,2,51,7,255,6,0,70
949,78,2,52,5,260,11,1,50
950,78,2,53,6,266,13,1,60
951,78,2,54,9,275,15,3,90
952,78,2,55,2,277,13,2,20
953,78,2,56,2,279,12,1,20
954,78,2,57,8,287,15,2,80
955,78,2,58,8,295,15,15,80
956,78,2,59,7,302,4,4,70
957,78,2,60,4,306,0,0,40
958,78,2,61,8,314,4,0,80
959,78,2,62,7,321,9,9,70
960,78,2,63,8,329,3,0,80
961,78,2,64,9,338,7,0,90
962,78,2,65,6,344,11,1,60
963,78,2,66,3,347,11,1,30
964,78,2,67,6,353,11,1,60
965,78,2,68,9,362,16,4,90
966,78,2,69,7,369,13,1,70
967,78,2,70,8,377,16,16,80
968,78,2,71,6,383,2,2,60
969,78,2,72,2,385,0,0,20
970,78,2,73,4,389,4,0,40
971,78,2,74,5,394,7,0,50
972,78,2,75,4,398,11,0,40
973,78,2,76,9,407,14,0,90
974,78,2,77,4,411,17,0,40
975,78,2,78,3,414,18,1,30
976,78,2,79,2,416,18,3,20
977,78,2,80,2,418,16,16,20
978,78,2,81,7,425,3,0,70
979,78,2,82,2,427,4,4,20
980,78,2,83,6,433,6,6,60
981,78,2,84,7,440,2,0,70
982,78,2,85,5,445,4,0,50
983,78,2,86,7,452,7,0,70
984,78,2,87,3,455,9,1,30
985,78,2,88,3,458,10,1,30
986,78,2,89,3,461,10,0,30
987,78,2,90,3,464,11,1,30
988,78,2,91,6,470,15,2,60
989,78,2,92,3,473,15,1,30
990,78,2,93,4,477,18,18,40
991,78,2,94,9,486,2,2,90
992,78,2,95,7,493,4,0,70
993,78,2,96,6,499,8,0,60
994,78,2,97,8,507,12,0,80
995,78,2,98,7,514,14,14,70
996,78,2,99,7,521,2,1,70
997,78,2,100,5,526,4,0,50
998,78,2,101,3,529,6,0,30
999,78,2,102,3,532,8,0,30
1000,78,2,103,2,534,8,1,20
1001,78,2,104,3,537,9,2,30
1002,78,2,105,9,546,12,2,90
1003,78,2,106,5,551,13,0,50
1004,78,2,107,8,559,16,0,80
1005,78,2,108,3,562,19,19,30
1006,78,2,109,6,568,3,3,60
1007,78,2,110,7,575,9,1,70
1008,78,2,111,8,583,14,0,80
1009,78,2,112,3,586,17,17,30
1010,78,2,113,5,591,1,0,50
1011,78,2,114,6,597,4,4,60
1012,78,2,115,4,601,1,0,40
1013,78,2,116,7,608,5,0,70
1014,78,2,117,5,613,7,7,50
1015,78,2,118,9,622,6,6,90
1016,78,2,119,9,631,4,4,90
1017,78,2,120,3,634,2,0,30
1018,78,2,121,7,641,5,0,70
1019,78,2,122,8,649,5,0,80
1020,78,2,123,9,658,12,12,90
1021,78,2,124,3,661,1,0,30
1022,78,2,125,4,665,1,0,40
1023,78,2,126,6,671,3,0,60
1024,78,2,127,6,677,4,0,60
1025,78,2,128,2,679,6,6,20
1026,78,2,129,3,682,3,3,30
1027,78,2,130,2,684,1,0,20
1028,78,2,131,4,688,1,0,40
1029,78,2,132,5,693,2,0,50
1030,78,2,133,8,701,5,0,80
1031,78,2,134,6,707,5,5,60
1032,78,2,135,9,716,5,0,90
1033,78,2,136,7,723,8,1,70
1034,78,2,137,4,727,7,7,40
1035,78,2,138,7,734,0,0,70
1036,78,2,139,6,740,5,1,60
1037,78,2,140,8,748,9,9,80
1038,78,2,141,6,754,3,0,60
1039,78,2,142,8,762,10,2,80
1040,78,2,143,4,766,8,1,40
1041,78,2,144,3,769,8,0,30
1042,78,2,145,5,774,9,0,50
1043,78,2,146,4,778,10,2,40
1044,78,2,147,2,780,8,1,20
1045,78,2,148,4,784,8,1,40
1046,78,2,149,2,786,8,0,20
1047,78,2,150,8,794,11,1,80
1048,78,2,151,9,803,12,12,90
1049,78,2,152,4,807,0,0,40
1050,78,2,153,7,814,4,0,70
1051,78,2,154,6,820,10,10,60
1052,78,2,155,8,828,4,1,80
1053,78,2,156,8,836,7,7,80
1054,78,2,157,2,838,0,0,20
1055,78,2,158,3,841,4,0,30
1056,78,2,159,7,848,5,0,70
1057,78,2,160,5,853,8,8,50
1058,78,2,161,3,856,1,0,30
1059,78,2,162,3,859,2,0,30
1060,78,2,163,6,865,6,0,60
1061,78,2,164,7,872,11,11,70
1062,78,2,165,4,876,1,0,40
1063,78,2,166,3,879,4,4,30
1064,78,2,167,3,882,1,1,30
1065,78,2,168,2,884,1,0,20
1066,78,2,169,9,893,5,5,90
1067,78,2,170,2,895,0,0,20
1068,78,2,171,8,903,7,7,80
1069,78,2,172,7,910,4,0,70
1070,78,2,173,6,916,5,0,60
1071,78,2,174,7,923,11,0,70
1072,78,2,175,3,926,11,0,30
1073,78,2,176,9,935,14,1,90
1074,78,2,177,5,940,17,4,50
1075,78,2,178,9,949,17,1,90
1076,78,2,179,3,952,17,0,30
1077,78,2,180,5,957,20,2,50
1078,78,2,181,3,960,20,1,30
1079,78,2,182,6,966,22,3,60
1080,78,2,183,4,970,21,2,40
1081,78,2,184,4,974,20,20,40
1082,78,2,185,7,981,1,0,70
1083,78,2,186,5,986,3,0,50
1084,78,2,187,9,995,11,2,90
1085,78,2,188,2,997,9,9,20
1086,78,2,189,7,1004,6,6,70
1087,78,2,190,8,1012,3,0,80
1088,78,2,191,4,1016,5,0,40
1089,78,2,192,2,1018,5,0,20
1090,78,2,193,8,1026,11,0,80
1091,78,2,194,9,1035,15,1,90
1092,78,2,195,7,1042,17,2,70
1093,78,2,196,2,1044,16,1,20
1094,78,2,197,6,1050,20,1,60
1095,78,2,198,2,1052,20,4,20
1096,78,2,199,8,1060,19,1,80
1097,78,2,200,2,1062,18,3,20
1098,78,2,201,9,1071,25,4,90
1099,78,2,202,7,1078,24,24,70
1100,78,2,203,5,1083,5,1,50
1101,78,2,204,4,1087,5,1,40
1102,78,2,205,6,1093,6,0,60
1103,78,2,206,8,1101,9,0,80
1104,78,2,207,6,1107,10,1,60
1105,78,2,208,3,1110,10,0,30
1106,78,2,209,3,1113,11,1,30
1107,78,2,210,8,1121,12,1,80
1108,78,2,211,5,1126,11,11,50
1109,78,2,212,2,1128,0,0,20
1110,78,2,213,9,1137,4,0,90
1111,78,2,214,2,1139,4,0,20
1112,78,2,215,4,1143,5,1,40
1113,78,2,216,3,1146,5,1,30
1114,78,2,217,8,1154,9,0,80
1115,78,2,218,4,1158,11,0,40
1116,78,2,219,7,1165,14,1,70
1117,78,2,220,9,1174,19,1,90
1118,78,2,221,8,1182,23,23,80
1119,78,2,222,5,1187,0,0,50
1120,78,2,223,5,1192,1,1,50
1121,78,2,224,5,1197,1,1,50
1122,78,2,225,9,1206,4,0,90
1123,78,2,226,6,1212,4,0,60
1124,78,2,227,4,1216,9,9,40
1125,78,2,228,7,1223,3,0,70
1126,78,2,229,4,1227,7,0,40
1127,78,2,230,3,1230,10,0,30
1128,78,2,231,9,1239,15,2,90
1129,78,2,232,8,1247,17,0,80
1130,78,2,233,7,1254,22,2,70
1131,78,2,234,7,1261,24,24,70
1132,78,2,235,3,1264,1,1,30
1133,78,2,236,7,1271,2,0,70
1134,78,2,237,7,1278,3,0,70
1135,78,2,238,2,1280,4,0,20
1136,78,2,239,2,1282,4,0,20
1137,78,2,240,7,1289,8,1,70
1138,78,2,241,4,1293,8,0,40
1139,78,2,242,2,1295,8,1,20
1140,78,2,243,3,1298,8,0,30
1141,78,2,244,6,1304,14,1,60
1142,78,2,245,6,1310,15,0,60
1143,78,2,246,3,1313,17,2,30
1144,78,2,247,5,1318,16,1,50
1145,78,2,248,2,1320,15,15,20
1146,78,2,249,4,1324,1,0,40
1147,78,2,250,9,1333,9,1,90
1148,78,2,251,6,1339,14,0,60
1149,78,2,252,4,1343,18,0,40
1150,78,2,253,9,1352,21,3,90
1151,78,2,254,9,1361,22,2,90
1152,78,2,255,8,1369,25,25,80
1153,78,2,256,2,1371,1,0,20
1154,78,2,257,4,1375,2,0,40
1155,78,2,258,7,1382,7,1,70
1156,78,2,259,3,1385,7,0,30
1157,78,2,260,8,1393,12,0,80
1158,78,2,261,3,1396,14,14,30
1159,78,2,262,8,1404,1,0,80
1160,78,2,263,3,1407,3,1,30
1161,78,2,264,9,1416,7,0,90
1162,78,2,265,7,1423,9,0,70
1163,78,2,266,4,1427,12,12,40
1164,78,2,267,8,1435,4,4,80
1165,78,2,268,5,1440,5,0,50
1166,78,2,269,3,1443,11,1,30
1167,78,2,270,9,1452,11,11,90
1168,78,2,271,9,1461,5,5,90
1169,78,2,272,7,1468,3,3,70
1170,78,2,273,8,1476,3,0,80
1171,78,2,274,4,1480,6,6,40
1172,78,2,275,5,1485,2,0,50
1173,78,2,276,7,1492,6,0,70
1174,78,2,277,2,1494,7,1,20
1175,78,2,278,5,1499,7,7,50
1176,78,2,279,7,1506,2,1,70
1177,78,2,280,8,1514,5,0,80
1178,78,2,281,3,1517,5,1,30
1179,78,2,282,2,1519,4,0,20
1180,78,2,283,2,1521,4,0,20
1181,78,2,284,2,1523,5,5,20
1182,78,2,285,3,1526,0,0,30
1183,78,2,286,3,1529,0,0,30
1184,78,2,287,4,1533,1,1,40
1185,78,2,288,7,1540,3,0,70
1186,78,2,289,3,1543,6,1,30
1187,78,2,290,8,1551,11,11,80
1188,78,2,291,2,1553,0,0,20
1189,78,2,292,6,1559,1,0,60
1190,78,2,293,9,1568,7,0,90
1191,78,2,294,3,1571,10,0,30
1192,78,2,295,2,1573,12,12,20
1193,78,2,296,3,1576,2,0,30
1194,78,2,297,7,1583,4,0,70
1195,78,2,298,6,1589,6,0,60
1196,78,2,299,6,1595,8,8,60
1197,78,2,300,8,1603,3,0,80
1198,78,2,301,2,1605,3,0,20
1199,78,2,302,9,1614,6,1,90
1200,78,2,303,4,1618,6,0,40
1201,78,2,304,9,1627,9,1,90
1202,78,2,305,8,1635,10,0,80
1203,78,2,306,5,1640,11,1,50
1204,78,2,307,5,1645,12,0,50
1205,78,2,308,8,1653,17,17,80
1206,78,2,309,3,1656,2,0,30
1207,78,2,310,4,1660,2,2,40
1208,78,2,311,7,1667,4,4,70
1209,78,2,312,7,1674,5,0,70
1210,78,2,313,5,1679,7,1,50
1211,78,2,314,7,1686,8,1,70
1212,78,2,315,7,1693,9,1,70
1213,78,2,316,2,1695,10,1,20
1214,78,2,317,8,1703,13,13,80
1215,78,2,318,6,1709,3,0,60
1216,78,2,319,9,1718,11,0,90
1217,78,2,320,8,1726,16,2,80
1218,78,2,321,5,1731,15,0,50
1219,78,2,322,6,1737,16,0,60
1220,78,2,323,8,1745,19,19,80
1221,78,2,324,4,1749,1,0,40
1222,78,2,325,9,1758,5,0,90
1223,78,2,326,8,1766,12,1,80
1224,78,2,327,5,1771,13,5,50
1225,78,2,328,3,1774,11,1,30
1226,78,2,329,9,1783,17,0,90
1227,78,2,330,9,1792,21,5,90
1228,78,2,331,2,1794,19,2,20
1229,78,2,332,8,1802,22,1,80
1230,78,2,333,7,1809,24,1,70
1231,78,2,334,5,1814,23,2,50
1232,78,2,335,5,1819,25,3,50
1233,78,2,336,6,1825,23,4,60
1234,78,2,337,5,1830,20,2,50
1235,78,2,338,7,1837,25,3,70
1236,78,2,339,3,1840,23,3,30
1237,78,2,340,6,1846,23,2,60
1238,78,2,341,7,1853,23,3,70
1239,78,2,342,8,1861,23,3,80
1240,78,2,343,6,1867,22,1,60
1241,78,2,344,7,1874,23,1,70
1242,78,2,345,6,1880,27,3,60
1243,78,2,346,6,1886,30,30,60
1244,78,2,347,3,1889,1,0,30
1245,78,2,348,8,1897,6,1,80
1246,78,2,349,7,1904,6,0,70
1247,78,2,350,9,1913,11,1,90
1248,78,2,351,9,1922,13,1,90
1249,78,2,352,4,1926,14,0,40
1250,78,2,353,4,1930,17,1,40
1251,78,2,354,8,1938,21,21,80
1252,78,2,355,2,1940,2,0,20
1253,78,2,356,7,1947,3,0,70
1254,78,2,357,3,1950,8,0,30
1255,78,2,358,7,1957,11,1,70
1256,78,2,359,5,1962,12,0,50
1257,78,2,360,6,1968,17,3,60
1258,78,2,361,5,1973,17,17,50
1259,78,2,362,4,1977,3,0,40
1260,78,2,363,7,1984,7,1,70
1261,78,2,364,2,1986,8,8,20
1262,78,2,365,6,1992,5,5,60
1263,78,2,366,2,1994,1,0,20
1264,78,2,367,2,1996,2,0,20
1265,78,2,368,2,1998,2,0,20
1266,78,2,369,5,2003,4,0,50
1267,78,2,370,7,2010,11,11,70
1268,78,2,371,6,2016,3,0,60
1269,78,2,372,2,2018,5,0,20
1270,78,2,373,8,2026,9,0,80
1271,78,2,374,3,2029,9,0,30
1272,78,2,375,3,2032,12,12,30
1273,78,2,376,3,2035,2,0,30
1274,78,2,377,2,2037,4,4,20
1275,78,2,378,5,2042,2,0,50
1276,78,2,379,4,2046,3,3,40
1277,78,2,380,5,2051,4,0,50
1278,78,2,381,9,2060,10,10,90
1279,78,2,382,4,2064,2,0,40
1280,78,2,383,3,2067,2,0,30
1281,78,2,384,8,2075,5,1,80
1282,78,2,385,4,2079,6,1,40
1283,78,2,386,3,2082,5,1,30
1284,78,2,387,2,2084,6,6,20
1285,78,2,388,7,2091,7,0,70
1286,78,2,389,3,2094,8,0,30
1287,78,2,390,2,2096,8,0,20
1288,78,2,391,6,2102,12,12,60
1289,78,2,392,2,2104,1,0,20
1290,78,2,393,3,2107,2,0,30
1291,78,2,394,5,2112,5,0,50
1292,78,2,395,4,2116,8,1,40
1293,78,2,396,7,2123,12,1,70
1294,78,2,397,4,2127,13,2,40
1295,78,2,398,4,2131,11,1,40
1296,78,2,399,5,2136,10,1,50
1297,78,2,400,3,2139,9,0,30
1298,78,2,401,4,2143,12,1,40
1299,78,2,402,9,2152,16,1,90
1300,78,2,403,7,2159,15,1,70
1301,78,2,404,3,2162,19,2,30
1302,78,2,405,4,2166,20,3,40
1303,78,2,406,7,2173,24,3,70
1304,78,2,407,4,2177,23,3,40
1305,78,2,408,3,2180,22,1,30
1306,78,2,409,5,2185,30,30,50
1307,78,2,410,3,2188,3,1,30
1308,78,2,411,5,2193,8,0,50
1309,78,2,412,9,2202,12,2,90
1310,78,2,413,3,2205,12,0,30
1311,78,2,414,5,2210,15,1,50
1312,78,2,415,2,2212,14,14,20
1313,78,2,416,9,2221,6,0,90
1314,78,2,417,2,2223,6,1,20
1315,78,2,418,4,2227,8,0,40
1316,78,2,419,5,2232,8,1,50
1317,78,2,420,2,2234,10,10,20
1318,78,2,421,4,2238,4,0,40
1319,78,2,422,2,2240,6,0,20
1320,78,2,423,3,2243,6,6,30
1321,78,2,424,7,2250,3,0,70
1322,78,2,425,8,2258,7,1,80
1323,78,2,426,8,2266,10,0,80
1324,78,2,427,3,2269,10,10,30
1325,78,2,428,3,2272,3,0,30
1326,78,2,429,8,2280,7,2,80
1327,78,2,430,9,2289,7,2,90
1328,78,2,431,6,2295,8,8,60
1329,78,2,432,6,2301,2,1,60
1330,78,2,433,5,2306,3,0,50
1331,78,2,434,5,2311,4,0,50
1332,78,2,435,9,2320,9,1,90
1333,78,2,436,4,2324,11,11,40
1334,78,2,437,7,2331,3,3,70
1335,78,2,438,8,2339,5,0,80
1336,78,2,439,2,2341,6,1,20
1337,78,2,440,8,2349,9,1,80
1338,78,2,441,6,2355,10,1,60
1339,78,2,442,8,2363,19,2,80
1340,78,2,443,9,2372,23,2,90
1341,78,2,444,3,2375,21,2,30
1342,78,2,445,9,2384,25,2,90
1343,78,2,446,9,2393,27,4,90
1344,78,2,447,6,2399,26,3,60
1345,78,2,448,7,2406,31,2,70
1346,78,2,449,9,2415,37,5,90
1347,78,2,450,2,2417,34,4,20
1348,78,2,451,7,2424,33,6,70
1349,78,2,452,7,2431,29,2,70
1350,78,2,453,8,2439,38,3,80
1351,78,2,454,8,2447,40,40,80
1352,78,2,455,2,2449,0,0,20
1353,78,2,456,9,2458,2,0,90
1354,78,2,457,9,2467,4,0,90
1355,78,2,458,3,2470,6,6,30
1356,78,2,459,7,2477,3,3,70
1357,78,2,460,6,2483,2,0,60
1358,78,2,461,8,2491,5,0,80
1359,78,2,462,8,2499,7,0,80
1360,78,2,463,5,2504,9,0,50
1361,78,2,464,4,2508,9,0,40
1362,78,2,465,4,2512,10,2,40
1363,78,2,466,6,2518,12,1,60
1364,78,2,467,4,2522,12,12,40
1365,78,2,468,9,2531,3,0,90
1366,78,2,469,6,2537,4,0,60
1367,78,2,470,8,2545,14,1,80
1368,78,2,471,6,2551,16,16,60
1369,78,2,472,3,2554,1,1,30
1370,78,2,473,9,2563,0,0,90
1371,78,2,474,2,2565,1,0,20
1372,78,2,475,4,2569,3,0,40
1373,78,2,476,8,2577,10,2,80
1374,78,2,477,8,2585,15,15,80
1375,78,2,478,9,2594,4,4,90
1376,78,2,479,5,2599,1,1,50
1377,78,2,480,9,2608,5,0,90
1378,78,2,481,9,2617,11,0,90
1379,78,2,482,6,2623,14,2,60
1380,78,2,483,6,2629,16,16,60
1381,78,2,484,9,2638,5,0,90
1382,78,2,485,9,2647,11,0,90
1383,78,2,486,7,2654,14,1,70
1384,78,2,487,9,2663,19,2,90
1385,78,2,488,9,2672,23,3,90
1386,78,2,489,4,2676,22,4,40
1387,78,2,490,2,2678,18,1,20
1388,78,2,491,5,2683,22,1,50
1389,78,2,492,4,2687,24,3,40
1390,78,2,493,5,2692,22,1,50
1391,78,2,494,2,2694,21,21,20
1392,78,2,495,8,2702,4,4,80
1393,78,2,496,8,2710,0,0,80
1394,78,2,497,7,2717,1,0,70
1395,78,2,498,7,2724,3,0,70
1396,78,2,499,8,2732,7,7,80
1397,78,2,500,8,2740,2,0,80
1398,78,2,501,2,2742,2,0,20
1399,78,2,502,5,2747,5,5,50
1400,78,2,503,5,2752,5,0,50
1401,78,2,504,4,2756,7,0,40
1402,78,2,505,3,2759,10,1,30
1403,78,2,506,2,2761,9,1,20
1404,78,2,507,3,2764,9,0,30
1405,78,2,508,8,2772,15,15,80
1406,78,2,509,5,2777,3,3,50
1407,78,2,510,4,2781,3,3,40
1408,78,2,511,6,2787,3,0,60
1409,78,2,512,4,2791,7,7,40
1410,78,2,513,3,2794,2,2,30
1411,78,2,514,6,2800,2,0,60
1412,78,2,515,9,2809,7,1,90
1413,78,2,516,5,2814,7,1,50
1414,78,2,517,5,2819,9,2,50
1415,78,2,518,9,2828,13,2,90
1416,78,2,519,2,2830,12,12,20
1417,78,2,520,3,2833,2,0,30
1418,78,2,521,2,2835,3,0,20
1419,78,2,522,7,2842,7,0,70
1420,78,2,523,3,2845,13,0,30
1421,78,2,524,6,2851,14,0,60
1422,78,2,525,4,2855,17,2,40
1423,78,2,526,7,2862,21,2,70
1424,78,2,527,4,2866,21,21,40
1425,78,2,528,9,2875,3,1,90
1426,78,2,529,4,2879,4,0,40
1427,78,2,530,4,2883,7,7,40
1428,78,2,531,5,2888,4,0,50
1429,78,2,532,2,2890,5,0,20
1430,78,2,533,5,2895,7,7,50
1431,78,2,534,2,2897,1,0,20
1432,78,2,535,7,2904,7,7,70
1433,78,2,536,8,2912,3,0,80
1434,78,2,537,7,2919,6,0,70
1435,78,2,538,6,2925,9,0,60
1436,78,2,539,3,2928,10,1,30
1437,78,2,540,4,2932,11,0,40
1438,78,2,541,8,2940,16,2,80
1439,78,2,542,3,2943,14,14,30
1440,78,2,543,8,2951,4,1,80
1441,78,2,544,4,2955,4,0,40
1442,78,2,545,2,2957,4,0,20
1443,78,2,546,6,2963,5,0,60
1444,78,2,547,3,2966,5,1,30
1445,78,2,548,8,2974,12,0,80
1446,78,2,549,6,2980,15,15,60
1447,78,2,550,9,2989,4,4,90
1448,78,2,551,7,2996,4,0,70
1449,78,2,552,7,3003,11,0,70
1450,78,2,553,6,3009,12,12,60
1451,78,2,554,2,3011,0,0,20
1452,78,2,555,5,3016,1,0,50
1453,78,2,556,7,3023,6,6,70
1454,78,2,557,2,3025,0,0,20
1455,78,2,558,4,3029,2,0,40
1456,78,2,559,3,3032,3,3,30
1457,78,2,560,9,3041,4,1,90
1458,78,2,561,9,3050,11,11,90
1459,78,2,562,7,3057,7,1,70
1460,78,2,563,3,3060,8,0,30
1461,78,2,564,7,3067,11,0,70
1462,78,2,565,9,3076,13,0,90
1463,78,2,566,5,3081,18,2,50
1464,78,2,567,6,3087,19,19,60
1465,78,2,568,4,3091,3,0,40
1466,78,2,569,5,3096,4,0,50
1467,78,2,570,5,3101,6,1,50
1468,78,2,571,7,3108,5,0,70
1469,78,2,572,8,3116,9,1,80
1470,78,2,573,3,3119,9,1,30
1471,78,2,574,8,3127,14,14,80
1472,78,2,575,3,3130,2,0,30
1473,78,2,576,3,3133,2,0,30
1474,78,2,577,4,3137,4,1,40
1475,78,2,578,3,3140,6,1,30
1476,78,2,579,7,3147,9,1,70
1477,78,2,580,6,3153,11,0,60
1478,78,2,581,2,3155,13,13,20
1479,78,2,582,7,3162,1,0,70
1480,78,2,583,8,3170,8,2,80
1481,78,2,584,4,3174,7,1,40
1482,78,2,585,3,3177,8,0,30
1483,78,2,586,4,3181,9,9,40
1484,78,2,587,4,3185,2,0,40
1485,78,2,588,3,3188,3,1,30
1486,78,2,589,2,3190,4,0,20
1487,78,2,590,8,3198,8,1,80
1488,78,2,591,2,3200,8,8,20
1489,78,2,592,7,3207,7,7,70
1490,78,2,593,5,3212,2,0,50
1491,78,2,594,5,3217,3,0,50
1492,78,2,595,6,3223,4,0,60
1493,78,2,596,6,3229,4,0,60
1494,78,2,597,6,3235,6,6,60
1495,78,2,598,3,3238,1,0,30
1496,78,2,599,5,3243,3,0,50
1497,78,2,600,8,3251,5,5,80
1498,78,2,601,2,3253,1,0,20
1499,78,2,602,3,3256,2,0,30
1500,78,2,603,2,3258,3,0,20
1501,78,2,604,7,3265,5,5,70
1502,78,2,605,5,3270,1,0,50
1503,78,2,606,7,3277,6,1,70
1504,78,2,607,3,3280,6,0,30
1505,78,2,608,8,3288,13,1,80
1506,78,2,609,3,3291,12,2,30
1507,78,2,610,9,3300,14,2,90
1508,78,2,611,2,3302,13,0,20
1509,78,2,612,5,3307,15,3,50
1510,78,2,613,9,3316,17,3,90
1511,78,2,614,7,3323,17,1,70
1512,78,2,615,7,3330,21,2,70
1513,78,2,616,6,3336,22,3,60
1514,78,2,617,2,3338,20,1,20
1515,78,2,618,9,3347,21,21,90
1516,78,2,619,6,3353,2,0,60
1517,78,2,620,9,3362,5,5,90
1518,78,2,621,3,3365,1,0,30
1519,78,2,622,4,3369,2,0,40
1520,78,2,623,9,3378,7,2,90
1521,78,2,624,3,3381,6,1,30
1522,78,2,625,2,3383,7,1,20
1523,78,2,626,9,3392,9,0,90
1524,78,2,627,2,3394,10,10,20
1525,78,2,628,4,3398,1,0,40
1526,78,2,629,4,3402,1,0,40
1527,78,2,630,8,3410,3,0,80
1528,78,2,631,9,3419,6,1,90
1529,78,2,632,8,3427,8,8,80
1530,78,2,633,9,3436,4,4,90
1531,78,2,634,3,3439,0,0,30
1532,78,2,635,7,3446,6,6,70
1533,78,2,636,9,3455,3,3,90
1534,78,2,637,5,3460,7,7,50
1535,78,2,638,2,3462,0,0,20
1536,78,2,639,5,3467,2,0,50
1537,78,2,640,6,3473,5,5,60
1538,78,2,641,3,3476,2,0,30
1539,78,2,642,5,3481,3,0,50
1540,78,2,643,3,3484,5,1,30
1541,78,2,644,2,3486,5,5,20
1542,78,2,645,4,3490,1,0,40
1543,78,2,646,3,3493,3,0,30
1544,78,2,647,9,3502,6,2,90
1545,78,2,648,9,3511,6,6,90
1546,78,2,649,8,3519,3,3,80
1547,78,2,650,4,3523,2,0,40
1548,78,2,651,2,3525,2,0,20
1549,78,2,652,7,3532,6,0,70
1550,78,2,653,8,3540,13,3,80
1551,78,2,654,7,3547,13,2,70
1552,78,2,655,9,3556,13,13,90
1553,78,2,656,4,3560,0,0,40
1554,78,2,657,7,3567,2,1,70
1555,78,2,658,5,3572,2,0,50
1556,78,2,659,4,3576,3,0,40
1557,78,2,660,2,3578,4,0,20
1558,78,2,661,8,3586,7,2,80
1559,78,2,662,7,3593,9,9,70
1560,78,2,663,6,3599,4,0,60
1561,78,2,664,2,3601,6,0,20
1562,78,2,665,8,3609,10,10,80
1563,78,2,666,9,3618,5,1,90
1564,78,2,667,6,3624,4,4,60
1565,78,2,668,3,3627,1,0,30
1566,78,2,669,8,3635,7,0,80
1567,78,2,670,9,3644,16,2,90
1568,78,2,671,9,3653,15,0,90
1569,78,2,672,8,3661,20,1,80
1570,78,2,673,6,3667,19,1,60
1571,78,2,674,2,3669,19,1,20
1572,78,2,675,3,3672,18,18,30
1573,78,2,676,3,3675,0,0,30
1574,78,2,677,9,3684,1,0,90
1575,78,2,678,6,3690,2,2,60
1576,78,2,679,2,3692,0,0,20
1577,78,2,680,5,3697,3,0,50
1578,78,2,681,8,3705,8,8,80
1579,78,2,682,4,3709,0,0,40
1580,78,2,683,7,3716,2,0,70
1581,78,2,684,4,3720,3,0,40
1582,78,2,685,5,3725,4,0,50
1583,78,2,686,2,3727,7,2,20
1584,78,2,687,5,3732,7,0,50
1585,78,2,688,8,3740,9,0,80
1586,78,2,689,2,3742,11,11,20
1587,78,2,690,4,3746,1,0,40
1588,78,2,691,7,3753,6,0,70
1589,78,2,692,2,3755,9,9,20
1590,78,2,693,9,3764,2,2,90
1591,78,2,694,5,3769,1,1,50
1592,78,2,695,6,3775,5,0,60
1593,78,2,696,7,3782,7,0,70
1594,78,2,697,9,3791,14,14,90
1595,78,2,698,4,3795,1,0,40
1596,78,2,699,9,3804,5,5,90
1597,78,2,700,4,3808,1,0,40
1598,78,2,701,8,3816,4,4,80
1599,78,2,702,2,3818,0,0,20
1600,78,2,703,7,3825,4,0,70
1601,78,2,704,6,3831,9,2,60
1602,78,2,705,2,3833,8,0,20
1603,78,2,706,8,3841,11,2,80
1604,78,2,707,9,3850,19,2,90
1605,78,2,708,7,3857,24,2,70
1606,78,2,709,7,3864,31,3,70
1607,78,2,710,6,3870,33,33,60
1608,78,2,711,3,3873,1,1,30
1609,78,2,712,3,3876,1,1,30
1610,78,2,713,9,3885,4,0,90
1611,78,2,714,5,3890,5,0,50
1612,78,2,715,7,3897,5,1,70
1613,78,2,716,8,3905,7,7,80
1614,78,2,717,8,3913,4,0,80
1615,78,2,718,8,3921,7,7,80
1616,78,2,719,6,3927,3,1,60
1617,78,2,720,2,3929,3,0,20
1618,78,2,721,9,3938,7,0,90
1619,78,2,722,7,3945,12,12,70
1620,78,2,723,6,3951,1,0,60
1621,78,2,724,2,3953,2,2,20
1622,78,2,725,8,3961,5,1,80
1623,78,2,726,2,3963,4,4,20
1624,78,2,727,4,3967,2,0,40
1625,78,2,728,3,3970,3,0,30
1626,78,2,729,5,3975,4,1,50
1627,78,2,730,5,3980,6,6,50
1628,78,2,731,8,3988,5,0,80
1629,78,2,732,9,3997,7,0,90
1630,78,2,733,3,4000,8,1,30
1631,78,2,734,2,4002,8,8,20
1632,78,2,735,8,4010,5,0,80
1633,78,2,736,5,4015,9,3,50
1634,78,2,737,3,4018,7,7,30
1635,78,2,738,7,4025,5,5,70
1636,78,2,739,8,4033,3,0,80
1637,78,2,740,8,4041,8,0,80
1638,78,2,741,2,4043,8,2,20
1639,78,2,742,5,4048,8,0,50
1640,78,2,743,5,4053,8,1,50
1641,78,2,744,6,4059,13,0,60
1642,78,2,745,5,4064,15,2,50
1643,78,2,746,7,4071,18,0,70
1644,78,2,747,3,4074,18,18,30
1645,78,2,748,4,4078,5,5,40
1646,78,2,749,3,4081,3,0,30
1647,78,2,750,6,4087,6,0,60
1648,78,2,751,5,4092,6,0,50
1649,78,2,752,4,4096,9,9,40
1650,78,2,753,8,4104,5,0,80
1651,78,2,754,7,4111,8,0,70
1652,78,2,755,6,4117,10,0,60
1653,78,2,756,6,4123,11,0,60
1654,78,2,757,4,4127,15,3,40
1655,78,2,758,2,4129,12,0,20
1656,78,2,759,7,4136,15,0,70
1657,78,2,760,7,4143,17,1,70
1658,78,2,761,3,4146,17,3,30
1659,78,2,762,2,4148,17,2,20
1660,78,2,763,4,4152,17,2,40
1661,78,2,764,4,4156,18,4,40
1662,78,2,765,7,4163,17,17,70
1663,78,2,766,6,4169,2,2,60
1664,78,2,767,6,4175,3,3,60
1665,78,2,768,3,4178,3,0,30
1666,78,2,769,4,4182,4,2,40
1667,78,2,770,2,4184,3,1,20
1668,78,2,771,4,4188,3,0,40
1669,78,2,772,5,4193,10,10,50
1670,78,2,773,4,4197,3,1,40
1671,78,2,774,9,4206,9,9,90
1672,78,2,775,2,4208,2,0,20
1673,78,2,776,8,4216,10,1,80
1674,78,2,777,2,4218,9,0,20
1675,78,2,778,6,4224,13,0,60
1676,78,2,779,2,4226,13,2,20
1677,78,2,780,6,4232,13,2,60
1678,78,2,781,3,4235,12,2,30
1679,78,2,782,8,4243,15,15,80
1680,78,2,783,5,4248,3,0,50
1681,78,2,784,4,4252,5,0,40
1682,78,2,785,3,4255,6,0,30
1683,78,2,786,4,4259,7,0,40
1684,78,2,787,9,4268,15,2,90
1685,78,2,788,9,4277,22,2,90
1686,78,2,789,6,4283,26,4,60
1687,78,2,790,2,4285,23,1,20
1688,78,2,791,5,4290,25,25,50
1689,78,2,792,9,4299,4,4,90
1690,78,2,793,3,4302,1,0,30
1691,78,2,794,3,4305,3,0,30
1692,78,2,795,9,4314,8,1,90
1693,78,2,796,6,4320,10,1,60
1694,78,2,797,9,4329,13,1,90
1695,78,2,798,7,4336,19,19,70
1696,78,2,799,3,4339,1,0,30
1697,78,2,800,7,4346,7,0,70
1698,78,2,801,9,4355,12,0,90
1699,78,2,802,5,4360,18,2,50
1700,78,2,803,4,4364,19,2,40
1701,78,2,804,9,4373,21,3,90
1702,78,2,805,7,4380,22,3,70
1703,78,2,806,7,4387,22,1,70
1704,78,2,807,6,4393,23,5,60
1705,78,2,808,2,4395,19,19,20
1706,78,2,809,3,4398,0,0,30
1707,78,2,810,2,4400,1,0,20
1708,78,2,811,6,4406,3,0,60
1709,78,2,812,7,4413,6,0,70
1710,78,2,813,4,4417,6,6,40
1711,78,2,814,6,4423,1,0,60
1712,78,2,815,5,4428,4,0,50
1713,78,2,816,5,4433,5,0,50
1714,78,2,817,8,4441,11,1,80
1715,78,2,818,5,4446,14,0,50
1716,78,2,819,9,4455,17,17,90
1717,78,2,820,7,4462,1,0,70
1718,78,2,821,9,4471,5,0,90
1719,78,2,822,2,4473,7,0,20
1720,78,2,823,4,4477,8,0,40
1721,78,2,824,9,4486,15,1,90
1722,78,2,825,6,4492,16,2,60
1723,78,2,826,5,4497,17,5,50
1724,78,2,827,7,4504,16,1,70
1725,78,2,828,8,4512,21,21,80
1726,78,2,829,2,4514,1,1,20
1727,78,2,830,2,4516,0,0,20
1728,78,2,831,8,4524,6,1,80
1729,78,2,832,9,4533,9,0,90
1730,78,2,833,2,4535,11,1,20
1731,78,2,834,9,4544,15,0,90
1732,78,2,835,8,4552,18,1,80
1733,78,2,836,5,4557,21,1,50
1734,78,2,837,7,4564,22,1,70
1735,78,2,838,7,4571,25,25,70
1736,78,2,839,7,4578,3,0,70
1737,78,2,840,2,4580,6,0,20
1738,78,2,841,3,4583,6,1,30
1739,78,2,842,6,4589,7,1,60
1740,78,2,843,7,4596,7,0,70
1741,78,2,844,5,4601,7,7,50
1742,78,2,845,2,4603,3,0,20
1743,78,2,846,6,4609,4,1,60
1744,78,2,847,5,4614,3,0,50
1745,78,2,848,6,4620,10,2,60
1746,78,2,849,3,4623,11,11,30
1747,78,2,850,4,4627,2,2,40
1748,78,2,851,5,4632,2,0,50
1749,78,2,852,3,4635,2,0,30
1750,78,2,853,6,4641,4,0,60
1751,78,2,854,4,4645,5,5,40
1752,78,2,855,4,4649,2,0,40
1753,78,2,856,2,4651,2,0,20
1754,78,2,857,8,4659,6,6,80
1755,78,2,858,3,4662,4,0,30
1756,78,2,859,4,4666,5,0,40
1757,78,2,860,5,4671,8,2,50
1758,78,2,861,8,4679,10,2,80
1759,78,2,862,6,4685,11,11,60
1760,78,2,863,5,4690,3,0,50
1761,78,2,864,6,4696,3,3,60
1762,78,2,865,4,4700,1,0,40
1763,78,2,866,6,4706,3,0,60
1764,78,2,867,9,4715,9,2,90
1765,78,2,868,4,4719,9,1,40
1766,78,2,869,3,4722,8,0,30
1767,78,2,870,6,4728,8,0,60
1768,78,2,871,8,4736,12,2,80
1769,78,2,872,3,4739,10,2,30
1770,78,2,873,6,4745,12,0,60
1771,78,2,874,6,4751,16,2,60
1772,78,2,875,4,4755,16,2,40
1773,78,2,876,7,4762,20,3,70
1774,78,2,877,4,4766,19,4,40
1775,78,2,878,8,4774,19,2,80
1776,78,2,879,8,4782,20,20,80
1777,78,2,880,3,4785,3,0,30
1778,78,2,881,5,4790,5,5,50
1779,78,2,882,4,4794,3,0,40
1780,78,2,883,8,4802,10,10,80
1781,78,2,884,5,4807,4,0,50
1782,78,2,885,4,4811,7,0,40
1783,78,2,886,2,4813,7,0,20
1784,78,2,887,8,4821,13,0,80
1785,78,2,888,2,4823,14,3,20
1786,78,2,889,6,4829,15,2,60
1787,78,2,890,3,4832,13,1,30
1788,78,2,891,7,4839,18,0,70
1789,78,2,892,9,4848,21,1,90
1790,78,2,893,7,4855,21,2,70
1791,78,2,894,4,4859,22,4,40
1792,78,2,895,3,4862,21,21,30
1793,78,2,896,9,4871,6,0,90
1794,78,2,897,8,4879,11,2,80
1795,78,2,898,4,4883,14,14,40
1796,78,2,899,7,4890,5,0,70
1797,78,2,900,6,4896,9,9,60
1798,78,2,901,3,4899,4,4,30
1799,78,2,902,7,4906,2,1,70
1800,78,2,903,6,4912,3,0,60
1801,78,2,904,2,4914,3,3,20
1802,78,2,905,4,4918,1,0,40
1803,78,2,906,2,4920,2,2,20
1804,78,2,907,5,4925,1,1,50
1805,78,2,908,5,4930,3,0,50
1806,78,2,909,4,4934,6,0,40
1807,78,2,910,9,4943,8,2,90
1808,78,2,911,7,4950,11,2,70
1809,78,2,912,9,4959,13,13,90
1810,78,2,913,4,4963,0,0,40
1811,78,2,914,9,4972,5,5,90
1812,78,2,915,4,4976,1,0,40
1813,78,2,916,7,4983,4,0,70
1814,78,2,917,3,4986,4,4,30
1815,78,2,918,2,4988,0,0,20
1816,78,2,919,9,4997,5,5,90
1817,78,3,1,5,5,3,0,50
1818,78,3,2,6,11,6,0,60
1819,78,3,3,3,14,7,7,30
1820,78,3,4,7,21,2,0,70
1821,78,3,5,8,29,5,0,80
1822,78,3,6,8,37,7,0,80
1823,78,3,7,8,45,9,1,80
1824,78,3,8,4,49,9,0,40
1825,78,3,9,9,58,15,2,90
1826,78,3,10,6,64,17,1,60
1827,78,3,11,4,68,16,0,40
1828,78,3,12,8,76,20,5,80
1829,78,3,13,8,84,16,4,80
1830,78,3,14,2,86,12,1,20
1831,78,3,15,7,93,13,0,70
1832,78,3,16,6,99,15,2,60
1833,78,3,17,2,101,16,1,20
1834,78,3,18,4,105,16,3,40
1835,78,3,19,5,110,17,17,50
1836,78,3,20,9,119,5,5,90
1837,78,3,21,3,122,0,0,30
1838,78,3,22,3,125,1,0,30
1839,78,3,23,3,128,4,4,30
1840,78,3,24,6,134,3,0,60
1841,78,3,25,5,139,8,1,50
1842,78,3,26,7,146,11,1,70
1843,78,3,27,4,150,12,1,40
1844,78,3,28,9,159,13,1,90
1845,78,3,29,9,168,18,1,90
1846,78,3,30,3,171,17,4,30
1847,78,3,31,2,173,15,15,20
1848,78,3,32,4,177,1,0,40
1849,78,3,33,3,180,3,1,30
1850,78,3,34,6,186,5,0,60
1851,78,3,35,6,192,11,1,60
1852,78,3,36,2,194,11,1,20
1853,78,3,37,7,201,14,0,70
1854,78,3,38,9,210,22,1,90
1855,78,3,39,7,217,24,0,70
1856,78,3,40,7,224,30,30,70
1857,78,3,41,7,231,4,0,70
1858,78,3,42,9,240,10,2,90
1859,78,3,43,8,248,11,1,80
1860,78,3,44,9,257,15,1,90
1861,78,3,45,6,263,18,18,60
1862,78,3,46,5,268,2,2,50
1863,78,3,47,2,270,2,0,20
1864,78,3,48,9,279,8,8,90
1865,78,3,49,9,288,5,0,90
1866,78,3,50,3,291,8,8,30
1867,78,3,51,9,300,6,1,90
1868,78,3,52,8,308,11,0,80
1869,78,3,53,5,313,14,1,50
1870,78,3,54,4,317,13,1,40
1871,78,3,55,7,324,14,0,70
1872,78,3,56,5,329,18,18,50
1873,78,3,57,6,335,1,1,60
1874,78,3,58,8,343,2,0,80
1875,78,3,59,5,348,6,6,50
1876,78,3,60,5,353,3,0,50
1877,78,3,61,6,359,4,1,60
1878,78,3,62,6,365,6,1,60
1879,78,3,63,2,367,5,0,20
1880,78,3,64,3,370,8,8,30
1881,78,3,65,3,373,2,0,30
1882,78,3,66,4,377,2,2,40
1883,78,3,67,4,381,4,0,40
1884,78,3,68,6,387,11,0,60
1885,78,3,69,3,390,13,13,30
1886,78,3,70,4,394,2,0,40
1887,78,3,71,6,400,2,0,60
1888,78,3,72,8,408,5,1,80
1889,78,3,73,8,416,8,1,80
1890,78,3,74,6,422,11,0,60
1891,78,3,75,3,425,12,2,30
1892,78,3,76,2,427,13,13,20
1893,78,3,77,5,432,5,2,50
1894,78,3,78,4,436,6,6,40
1895,78,3,79,7,443,2,2,70
1896,78,3,80,6,449,2,0,60
1897,78,3,81,4,453,2,2,40
1898,78,3,82,5,458,10,0,50
1899,78,3,83,6,464,13,1,60
1900,78,3,84,3,467,14,2,30
1901,78,3,85,4,471,13,0,40
1902,78,3,86,5,476,13,1,50
1903,78,3,87,2,478,12,0,20
1904,78,3,88,4,482,14,1,40
1905,78,3,89,4,486,14,14,40
1906,78,3,90,5,491,1,0,50
1907,78,3,91,6,497,3,3,60
1908,78,3,92,4,501,0,0,40
1909,78,3,93,9,510,7,7,90
1910,78,3,94,9,519,5,5,90
1911,78,3,95,9,528,2,0,90
1912,78,3,96,9,537,6,0,90
1913,78,3,97,4,541,6,0,40
1914,78,3,98,9,550,8,0,90
1915,78,3,99,4,554,11,3,40
1916,78,3,100,3,557,11,0,30
1917,78,3,101,8,565,15,0,80
1918,78,3,102,9,574,23,1,90
1919,78,3,103,6,580,24,4,60
1920,78,3,104,2,582,21,21,20
1921,78,3,105,4,586,1,0,40
1922,78,3,106,8,594,4,4,80
1923,78,3,107,2,596,0,0,20
1924,78,3,108,3,599,3,0,30
1925,78,3,109,5,604,5,1,50
1926,78,3,110,9,613,9,1,90
1927,78,3,111,5,618,11,11,50
1928,78,3,112,9,627,3,0,90
1929,78,3,113,3,630,7,0,30
1930,78,3,114,6,636,10,10,60
1931,78,3,115,3,639,4,4,30
1932,78,3,116,8,647,3,0,80
1933,78,3,117,7,654,7,7,70
1934,78,3,118,7,661,2,1,70
1935,78,3,119,5,666,2,0,50
1936,78,3,120,2,668,5,1,20
1937,78,3,121,5,673,5,0,50
1938,78,3,122,6,679,6,0,60
1939,78,3,123,8,687,9,1,80
1940,78,3,124,6,693,9,1,60
1941,78,3,125,2,695,8,1,20
1942,78,3,126,7,702,10,0,70
1943,78,3,127,7,709,17,1,70
1944,78,3,128,5,714,22,4,50
1945,78,3,129,3,717,22,3,30
1946,78,3,130,9,726,22,5,90
1947,78,3,131,5,731,19,0,50
1948,78,3,132,7,738,21,1,70
1949,78,3,133,4,742,21,21,40
1950,78,3,134,8,750,7,0,80
1951,78,3,135,3,753,9,0,30
1952,78,3,136,7,760,12,3,70
1953,78,3,137,8,768,15,15,80
1954,78,3,138,4,772,1,0,40
1955,78,3,139,3,775,4,2,30
1956,78,3,140,6,781,4,0,60
1957,78,3,141,9,790,9,3,90
1958,78,3,142,2,792,8,1,20
1959,78,3,143,7,799,8,8,70
1960,78,3,144,9,808,2,0,90
1961,78,3,145,2,810,4,0,20
1962,78,3,146,5,815,5,0,50
1963,78,3,147,5,820,7,7,50
1964,78,3,148,9,829,5,0,90
1965,78,3,149,6,835,5,0,60
1966,78,3,150,8,843,7,0,80
1967,78,3,151,3,846,11,2,30
1968,78,3,152,7,853,13,3,70
1969,78,3,153,5,858,14,2,50
1970,78,3,154,4,862,16,2,40
1971,78,3,155,5,867,18,0,50
1972,78,3,156,8,875,19,1,80
1973,78,3,157,6,881,21,5,60
1974,78,3,158,4,885,17,0,40
1975,78,3,159,4,889,20,2,40
1976,78,3,160,4,893,22,1,40
1977,78,3,161,9,902,29,1,90
1978,78,3,162,5,907,31,31,50
1979,78,3,163,6,913,7,2,60
1980,78,3,164,4,917,8,0,40
1981,78,3,165,4,921,13,0,40
1982,78,3,166,2,923,15,2,20
1983,78,3,167,9,932,20,3,90
1984,78,3,168,6,938,18,0,60
1985,78,3,169,4,942,21,0,40
1986,78,3,170,5,947,23,1,50
1987,78,3,171,4,951,24,3,40
1988,78,3,172,2,953,24,3,20
1989,78,3,173,3,956,23,23,30
1990,78,3,174,9,965,5,0,90
1991,78,3,175,9,974,9,9,90
1992,78,3,176,3,977,3,0,30
1993,78,3,177,7,984,6,1,70
1994,78,3,178,6,990,10,0,60
1995,78,3,179,8,998,19,19,80
1996,78,3,180,3,1001,0,0,30
1997,78,3,181,4,1005,1,0,40
1998,78,3,182,9,1014,6,0,90
1999,78,3,183,6,1020,7,1,60
2000,78,3,184,4,1024,6,2,40
2001,78,3,185,7,1031,7,0,70
2002,78,3,186,4,1035,9,0,40
2003,78,3,187,7,1042,13,1,70
2004,78,3,188,8,1050,13,13,80
2005,78,3,189,3,1053,1,0,30
2006,78,3,190,4,1057,2,1,40
2007,78,3,191,2,1059,2,0,20
2008,78,3,192,2,1061,3,0,20
2009,78,3,193,9,1070,8,1,90
2010,78,3,194,2,1072,9,9,20
2011,78,3,195,2,1074,0,0,20
2012,78,3,196,5,1079,2,0,50
2013,78,3,197,5,1084,3,3,50
2014,78,3,198,9,1093,2,0,90
2015,78,3,199,4,1097,4,0,40
2016,78,3,200,3,1100,4,4,30
2017,78,3,201,8,1108,6,0,80
2018,78,3,202,6,1114,9,0,60
2019,78,3,203,7,1121,12,2,70
2020,78,3,204,2,1123,11,0,20
2021,78,3,205,3,1126,14,0,30
2022,78,3,206,9,1135,20,20,90
2023,78,3,207,7,1142,5,5,70
2024,78,3,208,5,1147,1,0,50
2025,78,3,209,8,1155,4,0,80
2026,78,3,210,9,1164,11,2,90
2027,78,3,211,3,1167,12,0,30
2028,78,3,212,2,1169,12,12,20
2029,78,3,213,7,1176,3,3,70
2030,78,3,214,9,1185,7,1,90
2031,78,3,215,3,1188,7,1,30
2032,78,3,216,7,1195,10,2,70
2033,78,3,217,5,1200,12,1,50
2034,78,3,218,3,1203,11,11,30
2035,78,3,219,5,1208,3,0,50
2036,78,3,220,3,1211,6,1,30
2037,78,3,221,3,1214,8,0,30
2038,78,3,222,9,1223,12,1,90
2039,78,3,223,5,1228,18,18,50
2040,78,3,224,3,1231,4,4,30
2041,78,3,225,3,1234,2,1,30
2042,78,3,226,4,1238,5,0,40
2043,78,3,227,2,1240,7,7,20
2044,78,3,228,4,1244,3,0,40
2045,78,3,229,3,1247,5,0,30
2046,78,3,230,9,1256,8,0,90
2047,78,3,231,4,1260,12,0,40
2048,78,3,232,7,1267,15,3,70
2049,78,3,233,5,1272,15,15,50
2050,78,3,234,2,1274,3,3,20
2051,78,3,235,7,1281,3,1,70
2052,78,3,236,8,1289,6,0,80
2053,78,3,237,4,1293,10,2,40
2054,78,3,238,5,1298,15,0,50
2055,78,3,239,3,1301,17,2,30
2056,78,3,240,9,1310,17,2,90
2057,78,3,241,4,1314,17,2,40
2058,78,3,242,6,1320,18,0,60
2059,78,3,243,8,1328,23,5,80
2060,78,3,244,7,1335,19,1,70
2061,78,3,245,8,1343,19,2,80
2062,78,3,246,5,1348,20,4,50
2063,78,3,247,5,1353,17,1,50
2064,78,3,248,5,1358,18,2,50
2065,78,3,249,9,1367,23,23,90
2066,78,3,250,6,1373,4,0,60
2067,78,3,251,2,1375,5,1,20
2068,78,3,252,3,1378,5,0,30
2069,78,3,253,4,1382,6,0,40
2070,78,3,254,6,1388,11,1,60
2071,78,3,255,3,1391,15,15,30
2072,78,3,256,9,1400,2,0,90
2073,78,3,257,2,1402,2,0,20
2074,78,3,258,6,1408,5,5,60
2075,78,3,259,6,1414,6,1,60
2076,78,3,260,3,1417,7,1,30
2077,78,3,261,3,1420,8,1,30
2078,78,3,262,4,1424,8,8,40
2079,78,3,263,7,1431,1,0,70
2080,78,3,264,6,1437,7,0,60
2081,78,3,265,3,1440,8,0,30
2082,78,3,266,4,1444,10,0,40
2083,78,3,267,9,1453,15,0,90
2084,78,3,268,9,1462,19,2,90
2085,78,3,269,9,1471,20,1,90
2086,78,3,270,7,1478,22,22,70
2087,78,3,271,3,1481,0,0,30
2088,78,3,272,3,1484,1,0,30
2089,78,3,273,4,1488,2,0,40
2090,78,3,274,7,1495,6,1,70
2091,78,3,275,3,1498,6,0,30
2092,78,3,276,3,1501,7,1,30
2093,78,3,277,2,1503,9,1,20
2094,78,3,278,7,1510,13,0,70
2095,78,3,279,8,1518,17,2,80
2096,78,3,280,2,1520,16,1,20
2097,78,3,281,6,1526,19,3,60
2098,78,3,282,7,1533,20,3,70
2099,78,3,283,6,1539,19,3,60
2100,78,3,284,7,1546,18,3,70
2101,78,3,285,7,1553,18,1,70
2102,78,3,286,6,1559,20,1,60
2103,78,3,287,8,1567,24,4,80
2104,78,3,288,5,1572,25,3,50
2105,78,3,289,7,1579,26,26,70
2106,78,3,290,3,1582,1,0,30
2107,78,3,291,2,1584,1,0,20
2108,78,3,292,7,1591,3,0,70
2109,78,3,293,5,1596,8,1,50
2110,78,3,294,7,1603,10,0,70
2111,78,3,295,7,1610,12,12,70
2112,78,3,296,9,1619,5,0,90
2113,78,3,297,4,1623,9,9,40
2114,78,3,298,4,1627,2,1,40
2115,78,3,299,3,1630,2,0,30
2116,78,3,300,4,1634,4,1,40
2117,78,3,301,5,1639,8,4,50
2118,78,3,302,6,1645,7,7,60
2119,78,3,303,4,1649,3,3,40
2120,78,3,304,9,1658,6,6,90
2121,78,3,305,9,1667,6,6,90
2122,78,3,306,3,1670,3,3,30
2123,78,3,307,8,1678,6,0,80
2124,78,3,308,5,1683,9,1,50
2125,78,3,309,9,1692,14,14,90
2126,78,3,310,8,1700,7,0,80
2127,78,3,311,5,1705,11,0,50
2128,78,3,312,7,1712,18,3,70
2129,78,3,313,8,1720,20,0,80
2130,78,3,314,4,1724,22,22,40
2131,78,3,315,5,1729,4,4,50
2132,78,3,316,4,1733,3,0,40
2133,78,3,317,2,1735,5,0,20
2134,78,3,318,8,1743,10,2,80
2135,78,3,319,3,1746,9,9,30
2136,78,3,320,6,1752,2,0,60
2137,78,3,321,9,1761,4,0,90
2138,78,3,322,6,1767,6,6,60
2139,78,3,323,8,1775,5,0,80
2140,78,3,324,2,1777,9,2,20
2141,78,3,325,8,1785,12,2,80
2142,78,3,326,9,1794,14,0,90
2143,78,3,327,6,1800,16,2,60
2144,78,3,328,8,1808,19,19,80
2145,78,3,329,6,1814,5,0,60
2146,78,3,330,6,1820,10,1,60
2147,78,3,331,6,1826,13,1,60
2148,78,3,332,7,1833,18,0,70
2149,78,3,333,8,1841,21,3,80
2150,78,3,334,8,1849,21,21,80
2151,78,3,335,8,1857,6,6,80
2152,78,3,336,7,1864,3,1,70
2153,78,3,337,4,1868,2,0,40
2154,78,3,338,4,1872,8,1,40
2155,78,3,339,6,1878,10,10,60
2156,78,3,340,7,1885,2,2,70
2157,78,3,341,3,1888,0,0,30
2158,78,3,342,8,1896,4,0,80
2159,78,3,343,8,1904,4,4,80
2160,78,3,344,8,1912,3,0,80
2161,78,3,345,5,1917,5,0,50
2162,78,3,346,6,1923,7,7,60
2163,78,3,347,3,1926,2,0,30
2164,78,3,348,5,1931,5,5,50
2165,78,3,349,2,1933,1,1,20
2166,78,3,350,9,1942,4,0,90
2167,78,3,351,2,1944,5,1,20
2168,78,3,352,9,1953,6,0,90
2169,78,3,353,5,1958,7,1,50
2170,78,3,354,9,1967,10,0,90
2171,78,3,355,8,1975,14,1,80
2172,78,3,356,2,1977,15,0,20
2173,78,3,357,2,1979,15,2,20
2174,78,3,358,5,1984,15,1,50
2175,78,3,359,8,1992,17,2,80
2176,78,3,360,7,1999,18,18,70
2177,78,3,361,5,2004,2,0,50
2178,78,3,362,3,2007,2,0,30
2179,78,3,363,6,2013,5,0,60
2180,78,3,364,2,2015,6,2,20
2181,78,3,365,8,2023,9,3,80
2182,78,3,366,7,2030,9,0,70
2183,78,3,367,6,2036,12,1,60
2184,78,3,368,7,2043,13,2,70
2185,78,3,369,4,2047,13,1,40
2186,78,3,370,8,2055,15,0,80
2187,78,3,371,7,2062,23,1,70
2188,78,3,372,8,2070,29,3,80
2189,78,3,373,5,2075,28,3,50
2190,78,3,374,2,2077,25,1,20
2191,78,3,375,8,2085,26,2,80
2192,78,3,376,3,2088,26,26,30
2193,78,3,377,4,2092,0,0,40
2194,78,3,378,4,2096,4,1,40
2195,78,3,379,8,2104,6,1,80
2196,78,3,380,7,2111,7,0,70
2197,78,3,381,4,2115,10,0,40
2198,78,3,382,7,2122,12,1,70
2199,78,3,383,9,2131,16,2,90
2200,78,3,384,6,2137,16,3,60
2201,78,3,385,7,2144,17,1,70
2202,78,3,386,3,2147,18,18,30
2203,78,3,387,6,2153,4,4,60
2204,78,3,388,9,2162,9,1,90
2205,78,3,389,7,2169,10,0,70
2206,78,3,390,9,2178,12,2,90
2207,78,3,391,3,2181,10,1,30
2208,78,3,392,4,2185,13,13,40
2209,78,3,393,4,2189,0,0,40
2210,78,3,394,3,2192,3,3,30
2211,78,3,395,9,2201,2,0,90
2212,78,3,396,4,2205,2,0,40
2213,78,3,397,6,2211,6,2,60
2214,78,3,398,2,2213,5,0,20
2215,78,3,399,2,2215,5,0,20
2216,78,3,400,6,2221,10,2,60
2217,78,3,401,3,2224,10,10,30
2218,78,3,402,5,2229,1,1,50
2219,78,3,403,2,2231,1,0,20
2220,78,3,404,4,2235,2,1,40
2221,78,3,405,4,2239,5,0,40
2222,78,3,406,3,2242,6,6,30
2223,78,3,407,2,2244,1,0,20
2224,78,3,408,2,2246,2,0,20
2225,78,3,409,4,2250,2,0,40
2226,78,3,410,9,2259,6,6,90
2227,78,3,411,6,2265,6,1,60
2228,78,3,412,9,2274,6,6,90
2229,78,3,413,8,2282,4,0,80
2230,78,3,414,5,2287,4,4,50
2231,78,3,415,8,2295,3,3,80
2232,78,3,416,3,2298,2,2,30
2233,78,3,417,8,2306,4,0,80
2234,78,3,418,4,2310,4,4,40
2235,78,3,419,5,2315,4,4,50
2236,78,3,420,8,2323,2,0,80
2237,78,3,421,2,2325,3,0,20
2238,78,3,422,6,2331,7,0,60
2239,78,3,423,4,2335,8,0,40
2240,78,3,424,6,2341,10,10,60
2241,78,3,425,6,2347,1,1,60
2242,78,3,426,5,2352,4,1,50
2243,78,3,427,2,2354,4,0,20
2244,78,3,428,8,2362,8,8,80
2245,78,3,429,2,2364,2,0,20
2246,78,3,430,5,2369,6,0,50
2247,78,3,431,8,2377,8,8,80
2248,78,3,432,4,2381,2,2,40
2249,78,3,433,9,2390,3,0,90
2250,78,3,434,2,2392,6,0,20
2251,78,3,435,9,2401,9,0,90
2252,78,3,436,7,2408,12,0,70
2253,78,3,437,6,2414,16,3,60
2254,78,3,438,6,2420,15,2,60
2255,78,3,439,3,2423,14,1,30
2256,78,3,440,7,2430,17,3,70
2257,78,3,441,5,2435,17,2,50
2258,78,3,442,2,2437,16,4,20
2259,78,3,443,8,2445,16,2,80
2260,78,3,444,9,2454,22,3,90
2261,78,3,445,5,2459,24,24,50
2262,78,3,446,9,2468,4,1,90
2263,78,3,447,6,2474,7,2,60
2264,78,3,448,8,2482,7,0,80
2265,78,3,449,7,2489,12,0,70
2266,78,3,450,6,2495,16,0,60
2267,78,3,451,4,2499,19,3,40
2268,78,3,452,7,2506,22,3,70
2269,78,3,453,6,2512,23,23,60
2270,78,3,454,2,2514,0,0,20
2271,78,3,455,2,2516,4,0,20
2272,78,3,456,9,2525,7,0,90
2273,78,3,457,7,2532,12,0,70
2274,78,3,458,3,2535,15,1,30
2275,78,3,459,7,2542,19,1,70
2276,78,3,460,3,2545,18,18,30
2277,78,3,461,8,2553,1,1,80
2278,78,3,462,4,2557,4,0,40
2279,78,3,463,4,2561,8,1,40
2280,78,3,464,3,2564,9,0,30
2281,78,3,465,3,2567,10,0,30
2282,78,3,466,2,2569,13,0,20
2283,78,3,467,7,2576,16,16,70
2284,78,3,468,3,2579,4,0,30
2285,78,3,469,7,2586,7,0,70
2286,78,3,470,2,2588,8,0,20
2287,78,3,471,8,2596,11,11,80
2288,78,3,472,7,2603,3,0,70
2289,78,3,473,4,2607,4,4,40
2290,78,3,474,3,2610,1,0,30
2291,78,3,475,9,2619,8,8,90
2292,78,3,476,5,2624,1,0,50
2293,78,3,477,7,2631,2,0,70
2294,78,3,478,6,2637,5,1,60
2295,78,3,479,5,2642,8,3,50
2296,78,3,480,7,2649,7,1,70
2297,78,3,481,8,2657,11,1,80
2298,78,3,482,2,2659,11,1,20
2299,78,3,483,4,2663,10,0,40
2300,78,3,484,5,2668,14,2,50
2301,78,3,485,5,2673,13,13,50
2302,78,3,486,3,2676,1,0,30
2303,78,3,487,9,2685,4,0,90
2304,78,3,488,8,2693,6,0,80
2305,78,3,489,2,2695,6,0,20
2306,78,3,490,3,2698,8,0,30
2307,78,3,491,3,2701,11,11,30
2308,78,3,492,4,2705,1,1,40
2309,78,3,493,5,2710,1,0,50
2310,78,3,494,8,2718,2,0,80
2311,78,3,495,3,2721,5,5,30
2312,78,3,496,7,2728,2,0,70
2313,78,3,497,4,2732,3,3,40
2314,78,3,498,7,2739,4,0,70
2315,78,3,499,5,2744,4,4,50
2316,78,3,500,7,2751,2,0,70
2317,78,3,501,5,2756,4,4,50
2318,78,3,502,6,2762,5,0,60
2319,78,3,503,4,2766,6,6,40
2320,78,3,504,7,2773,3,0,70
2321,78,3,505,7,2780,6,2,70
2322,78,3,506,2,2782,5,5,20
2323,78,3,507,9,2791,8,3,90
2324,78,3,508,7,2798,9,1,70
2325,78,3,509,8,2806,15,15,80
2326,78,3,510,2,2808,1,1,20
2327,78,3,511,8,2816,3,1,80
2328,78,3,512,3,2819,4,0,30
2329,78,3,513,9,2828,8,4,90
2330,78,3,514,5,2833,6,1,50
2331,78,3,515,2,2835,7,0,20
2332,78,3,516,2,2837,7,7,20
2333,78,3,517,8,2845,4,0,80
2334,78,3,518,4,2849,5,5,40
2335,78,3,519,7,2856,2,2,70
2336,78,3,520,3,2859,2,0,30
2337,78,3,521,7,2866,3,3,70
2338,78,3,522,8,2874,2,0,80
2339,78,3,523,3,2877,2,1,30
2340,78,3,524,7,2884,3,1,70
2341,78,3,525,9,2893,4,0,90
2342,78,3,526,2,2895,4,0,20
2343,78,3,527,2,2897,4,0,20
2344,78,3,528,4,2901,7,7,40
2345,78,3,529,8,2909,9,9,80
2346,78,3,530,2,2911,3,3,20
2347,78,3,531,9,2920,3,3,90
2348,78,3,532,2,2922,2,0,20
2349,78,3,533,8,2930,5,5,80
2350,78,3,534,2,2932,2,0,20
2351,78,3,535,5,2937,4,1,50
2352,78,3,536,8,2945,8,0,80
2353,78,3,537,7,2952,10,0,70
2354,78,3,538,9,2961,16,0,90
2355,78,3,539,7,2968,20,1,70
2356,78,3,540,7,2975,24,24,70
2357,78,3,541,7,2982,3,0,70
2358,78,3,542,7,2989,7,1,70
2359,78,3,543,2,2991,6,0,20
2360,78,3,544,7,2998,9,1,70
2361,78,3,545,7,3005,11,1,70
2362,78,3,546,4,3009,14,14,40
2363,78,3,547,7,3016,4,0,70
2364,78,3,548,9,3025,9,0,90
2365,78,3,549,5,3030,13,1,50
2366,78,3,550,9,3039,17,0,90
2367,78,3,551,2,3041,18,18,20
2368,78,3,552,6,3047,0,0,60
2369,78,3,553,3,3050,2,2,30
2370,78,3,554,3,3053,2,1,30
2371,78,3,555,9,3062,3,0,90
2372,78,3,556,4,3066,4,0,40
2373,78,3,557,4,3070,6,0,40
2374,78,3,558,7,3077,9,9,70
2375,78,3,559,4,3081,1,0,40
2376,78,3,560,7,3088,6,1,70
2377,78,3,561,3,3091,6,6,30
2378,78,3,562,7,3098,4,0,70
2379,78,3,563,5,3103,7,0,50
2380,78,3,564,9,3112,10,1,90
2381,78,3,565,9,3121,13,0,90
2382,78,3,566,6,3127,14,0,60
2383,78,3,567,5,3132,16,2,50
2384,78,3,568,5,3137,15,0,50
2385,78,3,569,4,3141,16,16,40
2386,78,3,570,4,3145,0,0,40
2387,78,3,571,5,3150,3,1,50
2388,78,3,572,3,3153,6,0,30
2389,78,3,573,3,3156,8,8,30
2390,78,3,574,7,3163,5,5,70
2391,78,3,575,7,3170,0,0,70
2392,78,3,576,5,3175,3,3,50
2393,78,3,577,2,3177,2,0,20
2394,78,3,578,5,3182,4,2,50
2395,78,3,579,6,3188,2,0,60
2396,78,3,580,7,3195,7,0,70
2397,78,3,581,6,3201,8,0,60
2398,78,3,582,7,3208,11,11,70
2399,78,3,583,4,3212,3,3,40
2400,78,3,584,8,3220,3,0,80
2401,78,3,585,8,3228,9,0,80
2402,78,3,586,9,3237,10,0,90
2403,78,3,587,9,3246,17,17,90
2404,78,3,588,3,3249,1,0,30
2405,78,3,589,2,3251,4,1,20
2406,78,3,590,7,3258,8,0,70
2407,78,3,591,5,3263,11,11,50
2408,78,3,592,2,3265,0,0,20
2409,78,3,593,3,3268,1,0,30
2410,78,3,594,4,3272,3,0,40
2411,78,3,595,2,3274,4,0,20
2412,78,3,596,9,3283,6,6,90
2413,78,3,597,5,3288,6,0,50
2414,78,3,598,4,3292,7,0,40
2415,78,3,599,5,3297,10,3,50
2416,78,3,600,4,3301,9,0,40
2417,78,3,601,6,3307,14,1,60
2418,78,3,602,7,3314,15,2,70
2419,78,3,603,4,3318,16,1,40
2420,78,3,604,4,3322,21,1,40
2421,78,3,605,5,3327,21,2,50
2422,78,3,606,5,3332,20,3,50
2423,78,3,607,8,3340,21,3,80
2424,78,3,608,7,3347,20,4,70
2425,78,3,609,3,3350,16,1,30
2426,78,3,610,7,3357,19,2,70
2427,78,3,611,5,3362,17,1,50
2428,78,3,612,5,3367,17,1,50
2429,78,3,613,4,3371,18,18,40
2430,78,3,614,4,3375,3,0,40
2431,78,3,615,8,3383,7,1,80
2432,78,3,616,4,3387,8,0,40
2433,78,3,617,5,3392,12,5,50
2434,78,3,618,2,3394,9,9,20
2435,78,3,619,7,3401,3,0,70
2436,78,3,620,3,3404,6,1,30
2437,78,3,621,7,3411,8,8,70
2438,78,3,622,2,3413,0,0,20
2439,78,3,623,3,3416,2,0,30
2440,78,3,624,2,3418,2,0,20
2441,78,3,625,6,3424,7,0,60
2442,78,3,626,3,3427,8,2,30
2443,78,3,627,2,3429,7,7,20
2444,78,3,628,2,3431,0,0,20
2445,78,3,629,8,3439,5,0,80
2446,78,3,630,9,3448,10,1,90
2447,78,3,631,6,3454,10,1,60
2448,78,3,632,2,3456,9,9,20
2449,78,3,633,7,3463,3,0,70
2450,78,3,634,4,3467,6,6,40
2451,78,3,635,4,3471,1,0,40
2452,78,3,636,5,3476,5,1,50
2453,78,3,637,4,3480,4,0,40
2454,78,3,638,3,3483,5,1,30
2455,78,3,639,8,3491,8,8,80
2456,78,3,640,7,3498,3,1,70
2457,78,3,641,8,3506,4,4,80
2458,78,3,642,8,3514,6,6,80
2459,78,3,643,3,3517,1,0,30
2460,78,3,644,4,3521,2,2,40
2461,78,3,645,8,3529,4,1,80
2462,78,3,646,5,3534,5,5,50
2463,78,3,647,3,3537,1,1,30
2464,78,3,648,2,3539,0,0,20
2465,78,3,649,7,3546,3,3,70
2466,78,3,650,2,3548,1,0,20
2467,78,3,651,4,3552,3,0,40
2468,78,3,652,2,3554,4,1,20
2469,78,3,653,2,3556,3,0,20
2470,78,3,654,8,3564,6,1,80
2471,78,3,655,7,3571,7,7,70
2472,78,3,656,3,3574,2,0,30
2473,78,3,657,2,3576,3,3,20
2474,78,3,658,9,3585,6,6,90
2475,78,3,659,6,3591,5,2,60
2476,78,3,660,5,3596,7,1,50
2477,78,3,661,7,3603,8,1,70
2478,78,3,662,5,3608,12,12,50
2479,78,3,663,3,3611,1,1,30
2480,78,3,664,8,3619,8,0,80
2481,78,3,665,9,3628,12,12,90
2482,78,3,666,4,3632,2,0,40
2483,78,3,667,6,3638,4,0,60
2484,78,3,668,9,3647,10,1,90
2485,78,3,669,9,3656,11,0,90
2486,78,3,670,2,3658,12,12,20
2487,78,3,671,5,3663,7,7,50
2488,78,3,672,3,3666,1,1,30
2489,78,3,673,2,3668,4,1,20
2490,78,3,674,7,3675,6,0,70
2491,78,3,675,9,3684,10,0,90
2492,78,3,676,6,3690,12,2,60
2493,78,3,677,6,3696,10,10,60
2494,78,3,678,2,3698,1,0,20
2495,78,3,679,7,3705,5,0,70
2496,78,3,680,4,3709,8,2,40
2497,78,3,681,9,3718,7,0,90
2498,78,3,682,7,3725,9,9,70
2499,78,3,683,7,3732,4,2,70
2500,78,3,684,7,3739,6,1,70
2501,78,3,685,6,3745,10,10,60
2502,78,3,686,5,3750,2,2,50
2503,78,3,687,5,3755,2,2,50
2504,78,3,688,7,3762,2,2,70
2505,78,3,689,4,3766,3,1,40
2506,78,3,690,9,3775,6,0,90
2507,78,3,691,3,3778,10,1,30
2508,78,3,692,3,3781,11,1,30
2509,78,3,693,4,3785,13,3,40
2510,78,3,694,7,3792,12,12,70
2511,78,3,695,2,3794,0,0,20
2512,78,3,696,2,3796,0,0,20
2513,78,3,697,9,3805,4,0,90
2514,78,3,698,9,3814,11,0,90
2515,78,3,699,3,3817,13,1,30
2516,78,3,700,4,3821,14,4,40
2517,78,3,701,7,3828,14,14,70
2518,78,3,702,7,3835,4,1,70
2519,78,3,703,4,3839,3,0,40
2520,78,3,704,2,3841,4,0,20
2521,78,3,705,7,3848,6,6,70
2522,78,3,706,2,3850,1,0,20
2523,78,3,707,2,3852,1,0,20
2524,78,3,708,8,3860,8,0,80
2525,78,3,709,3,3863,13,13,30
2526,78,3,710,3,3866,2,2,30
2527,78,3,711,8,3874,7,0,80
2528,78,3,712,5,3879,7,1,50
2529,78,3,713,5,3884,9,1,50
2530,78,3,714,4,3888,12,2,40
2531,78,3,715,8,3896,15,1,80
2532,78,3,716,5,3901,14,2,50
2533,78,3,717,4,3905,14,2,40
2534,78,3,718,6,3911,14,1,60
2535,78,3,719,4,3915,15,15,40
2536,78,3,720,6,3921,4,1,60
2537,78,3,721,4,3925,7,1,40
2538,78,3,722,9,3934,13,1,90
2539,78,3,723,6,3940,16,2,60
2540,78,3,724,8,3948,17,1,80
2541,78,3,725,9,3957,22,22,90
2542,78,3,726,2,3959,0,0,20
2543,78,3,727,5,3964,2,0,50
2544,78,3,728,6,3970,3,0,60
2545,78,3,729,4,3974,3,3,40
2546,78,3,730,9,3983,4,1,90
2547,78,3,731,3,3986,7,0,30
2548,78,3,732,4,3990,9,0,40
2549,78,3,733,6,3996,14,0,60
2550,78,3,734,8,4004,19,19,80
2551,78,3,735,3,4007,2,0,30
2552,78,3,736,2,4009,3,3,20
2553,78,3,737,7,4016,4,1,70
2554,78,3,738,4,4020,4,1,40
2555,78,3,739,9,4029,7,0,90
2556,78,3,740,8,4037,11,3,80
2557,78,3,741,5,4042,8,0,50
2558,78,3,742,9,4051,17,0,90
2559,78,3,743,7,4058,18,3,70
2560,78,3,744,2,4060,15,0,20
2561,78,3,745,4,4064,15,1,40
2562,78,3,746,3,4067,17,0,30
2563,78,3,747,5,4072,21,1,50
2564,78,3,748,6,4078,23,0,60
2565,78,3,749,9,4087,27,27,90
2566,78,3,750,4,4091,3,0,40
2567,78,3,751,4,4095,3,3,40
2568,78,3,752,9,4104,6,0,90
2569,78,3,753,4,4108,9,1,40
2570,78,3,754,8,4116,10,0,80
2571,78,3,755,9,4125,13,2,90
2572,78,3,756,2,4127,11,11,20
2573,78,3,757,9,4136,2,0,90
2574,78,3,758,7,4143,5,1,70
2575,78,3,759,6,4149,9,0,60
2576,78,3,760,6,4155,11,2,60
2577,78,3,761,2,4157,11,11,20
2578,78,3,762,6,4163,5,5,60
2579,78,3,763,2,4165,1,0,20
2580,78,3,764,5,4170,2,0,50
2581,78,3,765,3,4173,4,0,30
2582,78,3,766,2,4175,5,1,20
2583,78,3,767,3,4178,5,0,30
2584,78,3,768,7,4185,9,0,70
2585,78,3,769,6,4191,12,0,60
2586,78,3,770,7,4198,14,0,70
2587,78,3,771,2,4200,14,1,20
2588,78,3,772,2,4202,14,0,20
2589,78,3,773,3,4205,15,2,30
2590,78,3,774,3,4208,15,1,30
2591,78,3,775,5,4213,15,2,50
2592,78,3,776,2,4215,17,1,20
2593,78,3,777,5,4220,19,19,50
2594,78,3,778,2,4222,0,0,20
2595,78,3,779,3,4225,2,2,30
2596,78,3,780,2,4227,0,0,20
2597,78,3,781,6,4233,2,2,60
2598,78,3,782,8,4241,1,0,80
2599,78,3,783,5,4246,2,2,50
2600,78,3,784,5,4251,1,1,50
2601,78,3,785,8,4259,3,0,80
2602,78,3,786,7,4266,6,1,70
2603,78,3,787,4,4270,7,0,40
2604,78,3,788,3,4273,8,8,30
2605,78,3,789,8,4281,2,0,80
2606,78,3,790,5,4286,4,4,50
2607,78,3,791,9,4295,2,0,90
2608,78,3,792,7,4302,5,5,70
2609,78,3,793,6,4308,1,0,60
2610,78,3,794,9,4317,2,0,90
2611,78,3,795,7,4324,4,1,70
2612,78,3,796,6,4330,6,0,60
2613,78,3,797,6,4336,9,1,60
2614,78,3,798,7,4343,11,3,70
2615,78,3,799,4,4347,12,0,40
2616,78,3,800,4,4351,16,16,40
2617,78,3,801,4,4355,1,0,40
2618,78,3,802,3,4358,1,0,30
2619,78,3,803,8,4366,2,0,80
2620,78,3,804,7,4373,9,0,70
2621,78,3,805,4,4377,11,1,40
2622,78,3,806,8,4385,13,0,80
2623,78,3,807,4,4389,16,16,40
2624,78,3,808,5,4394,1,0,50
2625,78,3,809,6,4400,2,0,60
2626,78,3,810,7,4407,6,1,70
2627,78,3,811,8,4415,7,0,80
2628,78,3,812,3,4418,9,9,30
2629,78,3,813,5,4423,2,0,50
2630,78,3,814,8,4431,6,0,80
2631,78,3,815,4,4435,9,1,40
2632,78,3,816,5,4440,11,11,50
2633,78,3,817,5,4445,2,0,50
2634,78,3,818,9,4454,7,0,90
2635,78,3,819,7,4461,10,1,70
2636,78,3,820,3,4464,10,0,30
2637,78,3,821,2,4466,11,1,20
2638,78,3,822,4,4470,12,12,40
2639,78,3,823,8,4478,2,0,80
2640,78,3,824,7,4485,6,0,70
2641,78,3,825,2,4487,6,1,20
2642,78,3,826,3,4490,7,2,30
2643,78,3,827,2,4492,6,1,20
2644,78,3,828,6,4498,9,1,60
2645,78,3,829,4,4502,10,0,40
2646,78,3,830,5,4507,11,0,50
2647,78,3,831,4,4511,13,1,40
2648,78,3,832,9,4520,14,1,90
2649,78,3,833,2,4522,14,0,20
2650,78,3,834,4,4526,14,14,40
2651,78,3,835,4,4530,3,0,40
2652,78,3,836,4,4534,7,2,40
2653,78,3,837,9,4543,8,1,90
2654,78,3,838,8,4551,10,10,80
2655,78,3,839,4,4555,1,0,40
2656,78,3,840,2,4557,3,0,20
2657,78,3,841,2,4559,5,5,20
2658,78,3,842,6,4565,1,1,60
2659,78,3,843,5,4570,3,3,50
2660,78,3,844,7,4577,4,0,70
2661,78,3,845,4,4581,6,6,40
2662,78,3,846,2,4583,0,0,20
2663,78,3,847,5,4588,1,1,50
2664,78,3,848,3,4591,0,0,30
2665,78,3,849,2,4593,2,0,20
2666,78,3,850,2,4595,2,0,20
2667,78,3,851,4,4599,3,3,40
2668,78,3,852,9,4608,7,7,90
2669,78,3,853,5,4613,2,0,50
2670,78,3,854,6,4619,4,4,60
2671,78,3,855,7,4626,1,1,70
2672,78,3,856,5,4631,1,0,50
2673,78,3,857,5,4636,5,1,50
2674,78,3,858,7,4643,8,2,70
2675,78,3,859,7,4650,10,3,70
2676,78,3,860,4,4654,7,2,40
2677,78,3,861,7,4661,7,0,70
2678,78,3,862,3,4664,7,7,30
2679,78,3,863,7,4671,10,0,70
2680,78,3,864,4,4675,11,0,40
2681,78,3,865,9,4684,15,15,90
2682,78,3,866,6,4690,3,3,60
2683,78,3,867,9,4699,3,0,90
2684,78,3,868,3,4702,7,0,30
2685,78,3,869,3,4705,8,1,30
2686,78,3,870,5,4710,7,1,50
2687,78,3,871,6,4716,9,0,60
2688,78,3,872,4,4720,9,9,40
2689,78,3,873,3,4723,2,2,30
2690,78,3,874,8,4731,6,0,80
2691,78,3,875,9,4740,7,7,90
2692,78,3,876,4,4744,1,0,40
2693,78,3,877,6,4750,5,1,60
2694,78,3,878,9,4759,5,1,90
2695,78,3,879,6,4765,6,1,60
2696,78,3,880,6,4771,8,0,60
2697,78,3,881,7,4778,11,1,70
2698,78,3,882,3,4781,11,2,30
2699,78,3,883,9,4790,14,2,90
2700,78,3,884,8,4798,15,1,80
2701,78,3,885,5,4803,18,3,50
2702,78,3,886,9,4812,21,2,90
2703,78,3,887,9,4821,21,3,90
2704,78,3,888,5,4826,23,1,50
2705,78,3,889,6,4832,26,2,60
2706,78,3,890,8,4840,28,28,80
2707,78,3,891,3,4843,1,1,30
2708,78,3,892,7,4850,3,1,70
2709,78,3,893,2,4852,3,1,20
2710,78,3,894,2,4854,2,2,20
2711,78,3,895,8,4862,3,0,80
2712,78,3,896,5,4867,3,3,50
2713,78,3,897,8,4875,3,0,80
2714,78,3,898,5,4880,6,2,50
2715,78,3,899,7,4887,9,1,70
2716,78,3,900,2,4889,10,0,20
2717,78,3,901,3,4892,11,11,30
2718,78,3,902,2,4894,1,0,20
2719,78,3,903,5,4899,5,5,50
2720,78,3,904,7,4906,3,0,70
2721,78,3,905,6,4912,7,7,60
2722,78,3,906,5,4917,0,0,50
2723,78,3,907,5,4922,4,0,50
2724,78,3,908,9,4931,13,2,90
2725,78,3,909,9,4940,16,16,90
2726,78,3,910,5,4945,2,0,50
2727,78,3,911,9,4954,10,0,90
2728,78,3,912,4,4958,11,11,40
2729,78,3,913,3,4961,3,3,30
2730,78,3,914,4,4965,4,0,40
2731,78,3,915,5,4970,7,0,50
2732,78,3,916,3,4973,8,0,30
2733,78,3,917,4,4977,10,1,40
2734,78,3,918,9,4986,11,1,90
2735,78,3,919,6,4992,15,15,60
2736,78,3,920,2,4994,3,0,20
