,Scenario,Trial,Inspection,Interval,Time,Defects,Rate
0,352,1,1,5,5,1,50
1,352,1,2,3,8,1,30
2,352,1,3,6,14,2,60
3,352,1,4,9,23,1,90
4,352,1,5,4,27,1,40
5,352,1,6,3,30,3,30
6,352,1,7,5,35,1,50
7,352,1,8,3,38,1,30
8,352,1,9,5,43,1,50
9,352,1,10,6,49,1,60
10,352,1,11,3,52,6,30
11,352,1,12,6,58,1,60
12,352,1,13,8,66,1,80
13,352,1,14,2,68,1,20
14,352,1,15,8,76,1,80
15,352,1,16,5,81,1,50
16,352,1,17,7,88,1,70
17,352,1,18,2,90,1,20
18,352,1,19,4,94,1,40
19,352,1,20,5,99,1,50
20,352,1,21,5,104,1,50
21,352,1,22,9,113,1,90
22,352,1,23,5,118,1,50
23,352,1,24,3,121,12,30
24,352,1,25,5,126,1,50
25,352,1,26,8,134,1,80
26,352,1,27,4,138,1,40
27,352,1,28,6,144,1,60
28,352,1,29,7,151,8,70
29,352,1,30,2,153,1,20
30,352,1,31,6,159,8,60
31,352,1,32,4,163,1,40
32,352,1,33,4,167,1,40
33,352,1,34,3,170,6,30
34,352,1,35,4,174,1,40
35,352,1,36,8,182,1,80
36,352,1,37,5,187,1,50
37,352,1,38,4,191,1,40
38,352,1,39,2,193,1,20
39,352,1,40,4,197,1,40
40,352,1,41,5,202,1,50
41,352,1,42,9,211,1,90
42,352,1,43,2,213,1,20
43,352,1,44,6,219,1,60
44,352,1,45,3,222,1,30
45,352,1,46,5,227,1,50
46,352,1,47,9,236,1,90
47,352,1,48,5,241,1,50
48,352,1,49,9,250,1,90
49,352,1,50,3,253,1,30
50,352,1,51,4,257,1,40
51,352,1,52,9,266,1,90
52,352,1,53,7,273,1,70
53,352,1,54,7,280,1,70
54,352,1,55,7,287,1,70
55,352,1,56,4,291,1,40
56,352,1,57,9,300,1,90
57,352,1,58,8,308,1,80
58,352,1,59,6,314,1,60
59,352,1,60,4,318,1,40
60,352,1,61,2,320,1,20
61,352,1,62,4,324,1,40
62,352,1,63,9,333,1,90
63,352,1,64,2,335,1,20
64,352,1,65,5,340,1,50
65,352,1,66,6,346,1,60
66,352,1,67,5,351,1,50
67,352,1,68,9,360,1,90
68,352,1,69,5,365,42,50
69,352,1,70,3,368,1,30
70,352,1,71,6,374,1,60
71,352,1,72,5,379,1,50
72,352,1,73,8,387,1,80
73,352,1,74,4,391,1,40
74,352,1,75,9,400,1,90
75,352,1,76,4,404,1,40
76,352,1,77,2,406,1,20
77,352,1,78,8,414,1,80
78,352,1,79,4,418,1,40
79,352,1,80,4,422,1,40
80,352,1,81,5,427,1,50
81,352,1,82,9,436,1,90
82,352,1,83,6,442,1,60
83,352,1,84,9,451,1,90
84,352,1,85,9,460,1,90
85,352,1,86,7,467,1,70
86,352,1,87,8,475,1,80
87,352,1,88,7,482,1,70
88,352,1,89,3,485,1,30
89,352,1,90,7,492,1,70
90,352,1,91,2,494,1,20
91,352,1,92,7,501,1,70
92,352,1,93,4,505,1,40
93,352,1,94,6,511,1,60
94,352,1,95,8,519,1,80
95,352,1,96,8,527,1,80
96,352,1,97,7,534,1,70
97,352,1,98,4,538,1,40
98,352,1,99,4,542,38,40
99,352,1,100,8,550,1,80
100,352,1,101,2,552,1,20
101,352,1,102,4,556,1,40
102,352,1,103,2,558,1,20
103,352,1,104,9,567,1,90
104,352,1,105,8,575,1,80
105,352,1,106,3,578,1,30
106,352,1,107,3,581,1,30
107,352,1,108,6,587,1,60
108,352,1,109,2,589,1,20
109,352,1,110,4,593,1,40
110,352,1,111,7,600,1,70
111,352,1,112,2,602,1,20
112,352,1,113,8,610,41,80
113,352,1,114,3,613,1,30
114,352,1,115,8,621,1,80
115,352,1,116,3,624,1,30
116,352,1,117,5,629,1,50
117,352,1,118,5,634,1,50
118,352,1,119,9,643,1,90
119,352,1,120,2,645,1,20
120,352,1,121,4,649,1,40
121,352,1,122,8,657,1,80
122,352,1,123,5,662,1,50
123,352,1,124,3,665,1,30
124,352,1,125,8,673,1,80
125,352,1,126,6,679,1,60
126,352,1,127,8,687,1,80
127,352,1,128,3,690,1,30
128,352,1,129,7,697,1,70
129,352,1,130,6,703,1,60
130,352,1,131,9,712,1,90
131,352,1,132,2,714,1,20
132,352,1,133,5,719,1,50
133,352,1,134,4,723,1,40
134,352,1,135,5,728,1,50
135,352,1,136,4,732,1,40
136,352,1,137,8,740,1,80
137,352,1,138,3,743,1,30
138,352,1,139,4,747,1,40
139,352,1,140,4,751,1,40
140,352,1,141,5,756,1,50
141,352,1,142,6,762,1,60
142,352,1,143,4,766,1,40
143,352,1,144,2,768,1,20
144,352,1,145,5,773,1,50
145,352,1,146,4,777,1,40
146,352,1,147,7,784,1,70
147,352,1,148,8,792,1,80
148,352,1,149,3,795,1,30
149,352,1,150,2,797,1,20
150,352,1,151,6,803,1,60
151,352,1,152,6,809,1,60
152,352,1,153,5,814,1,50
153,352,1,154,9,823,1,90
154,352,1,155,7,830,1,70
155,352,1,156,5,835,1,50
156,352,1,157,5,840,1,50
157,352,1,158,4,844,1,40
158,352,1,159,8,852,1,80
159,352,1,160,6,858,1,60
160,352,1,161,7,865,1,70
161,352,1,162,8,873,1,80
162,352,1,163,7,880,1,70
163,352,1,164,7,887,1,70
164,352,1,165,9,896,1,90
165,352,1,166,9,905,1,90
166,352,1,167,3,908,1,30
167,352,1,168,8,916,57,80
168,352,1,169,8,924,1,80
169,352,1,170,9,933,1,90
170,352,1,171,8,941,1,80
171,352,1,172,3,944,1,30
172,352,1,173,8,952,1,80
173,352,1,174,4,956,1,40
174,352,1,175,6,962,1,60
175,352,1,176,5,967,1,50
176,352,1,177,8,975,1,80
177,352,1,178,9,984,1,90
178,352,1,179,7,991,1,70
179,352,1,180,3,994,1,30
180,352,1,181,6,1000,1,60
181,352,1,182,2,1002,1,20
182,352,1,183,4,1006,1,40
183,352,1,184,9,1015,1,90
184,352,1,185,3,1018,1,30
185,352,1,186,5,1023,1,50
186,352,1,187,5,1028,1,50
187,352,1,188,3,1031,1,30
188,352,1,189,4,1035,1,40
189,352,1,190,4,1039,1,40
190,352,1,191,7,1046,1,70
191,352,1,192,9,1055,1,90
192,352,1,193,4,1059,1,40
193,352,1,194,7,1066,1,70
194,352,1,195,8,1074,1,80
195,352,1,196,5,1079,39,50
196,352,1,197,6,1085,33,60
197,352,1,198,2,1087,1,20
198,352,1,199,9,1096,1,90
199,352,1,200,4,1100,1,40
200,352,1,201,7,1107,1,70
201,352,1,202,2,1109,1,20
202,352,1,203,9,1118,1,90
203,352,1,204,5,1123,1,50
204,352,1,205,2,1125,1,20
205,352,1,206,6,1131,1,60
206,352,1,207,2,1133,1,20
207,352,1,208,4,1137,1,40
208,352,1,209,5,1142,1,50
209,352,1,210,7,1149,20,70
210,352,1,211,3,1152,1,30
211,352,1,212,9,1161,1,90
212,352,1,213,6,1167,1,60
213,352,1,214,2,1169,1,20
214,352,1,215,9,1178,1,90
215,352,1,216,3,1181,1,30
216,352,1,217,3,1184,1,30
217,352,1,218,4,1188,1,40
218,352,1,219,4,1192,1,40
219,352,1,220,7,1199,1,70
220,352,1,221,7,1206,1,70
221,352,1,222,4,1210,1,40
222,352,1,223,7,1217,1,70
223,352,1,224,5,1222,1,50
224,352,1,225,4,1226,1,40
225,352,1,226,6,1232,1,60
226,352,1,227,6,1238,1,60
227,352,1,228,3,1241,1,30
228,352,1,229,7,1248,1,70
229,352,1,230,9,1257,1,90
230,352,1,231,4,1261,1,40
231,352,1,232,3,1264,28,30
232,352,1,233,8,1272,1,80
233,352,1,234,2,1274,15,20
234,352,1,235,2,1276,7,20
235,352,1,236,4,1280,1,40
236,352,1,237,7,1287,1,70
237,352,1,238,8,1295,1,80
238,352,1,239,2,1297,1,20
239,352,1,240,3,1300,1,30
240,352,1,241,2,1302,1,20
241,352,1,242,5,1307,1,50
242,352,1,243,6,1313,1,60
243,352,1,244,3,1316,1,30
244,352,1,245,5,1321,1,50
245,352,1,246,4,1325,1,40
246,352,1,247,7,1332,1,70
247,352,1,248,3,1335,1,30
248,352,1,249,2,1337,1,20
249,352,1,250,8,1345,1,80
250,352,1,251,2,1347,1,20
251,352,1,252,6,1353,1,60
252,352,1,253,2,1355,12,20
253,352,1,254,4,1359,1,40
254,352,1,255,7,1366,1,70
255,352,1,256,7,1373,13,70
256,352,1,257,6,1379,1,60
257,352,1,258,7,1386,1,70
258,352,1,259,9,1395,1,90
259,352,1,260,9,1404,1,90
260,352,1,261,9,1413,1,90
261,352,1,262,3,1416,1,30
262,352,1,263,9,1425,1,90
263,352,1,264,2,1427,1,20
264,352,1,265,2,1429,1,20
265,352,1,266,7,1436,1,70
266,352,1,267,9,1445,1,90
267,352,1,268,7,1452,1,70
268,352,1,269,5,1457,1,50
269,352,1,270,5,1462,1,50
270,352,1,271,9,1471,1,90
271,352,1,272,7,1478,1,70
272,352,1,273,4,1482,1,40
273,352,1,274,4,1486,1,40
274,352,1,275,8,1494,1,80
275,352,1,276,7,1501,1,70
276,352,1,277,7,1508,1,70
277,352,1,278,4,1512,33,40
278,352,1,279,3,1515,1,30
279,352,1,280,5,1520,1,50
280,352,1,281,7,1527,1,70
281,352,1,282,3,1530,1,30
282,352,1,283,8,1538,1,80
283,352,1,284,4,1542,1,40
284,352,1,285,9,1551,1,90
285,352,1,286,9,1560,1,90
286,352,1,287,9,1569,1,90
287,352,1,288,7,1576,1,70
288,352,1,289,9,1585,1,90
289,352,1,290,8,1593,1,80
290,352,1,291,3,1596,1,30
291,352,1,292,3,1599,1,30
292,352,1,293,4,1603,1,40
293,352,1,294,6,1609,1,60
294,352,1,295,5,1614,1,50
295,352,1,296,9,1623,1,90
296,352,1,297,5,1628,1,50
297,352,1,298,7,1635,1,70
298,352,1,299,7,1642,1,70
299,352,1,300,4,1646,1,40
300,352,1,301,9,1655,1,90
301,352,1,302,8,1663,37,80
302,352,1,303,5,1668,1,50
303,352,1,304,6,1674,1,60
304,352,1,305,2,1676,1,20
305,352,1,306,8,1684,1,80
306,352,1,307,6,1690,1,60
307,352,1,308,9,1699,1,90
308,352,1,309,6,1705,1,60
309,352,1,310,8,1713,1,80
310,352,1,311,9,1722,1,90
311,352,1,312,6,1728,1,60
312,352,1,313,9,1737,1,90
313,352,1,314,6,1743,1,60
314,352,1,315,9,1752,1,90
315,352,1,316,8,1760,1,80
316,352,1,317,2,1762,1,20
317,352,1,318,5,1767,1,50
318,352,1,319,2,1769,1,20
319,352,1,320,9,1778,1,90
320,352,1,321,8,1786,1,80
321,352,1,322,4,1790,1,40
322,352,1,323,2,1792,1,20
323,352,1,324,9,1801,1,90
324,352,1,325,9,1810,1,90
325,352,1,326,2,1812,1,20
326,352,1,327,5,1817,1,50
327,352,1,328,6,1823,1,60
328,352,1,329,7,1830,1,70
329,352,1,330,4,1834,1,40
330,352,1,331,7,1841,1,70
331,352,1,332,2,1843,1,20
332,352,1,333,8,1851,1,80
333,352,1,334,9,1860,1,90
334,352,1,335,9,1869,1,90
335,352,1,336,4,1873,1,40
336,352,1,337,3,1876,1,30
337,352,1,338,2,1878,1,20
338,352,1,339,6,1884,1,60
339,352,1,340,7,1891,1,70
340,352,1,341,2,1893,1,20
341,352,1,342,3,1896,1,30
342,352,1,343,3,1899,1,30
343,352,1,344,6,1905,1,60
344,352,1,345,5,1910,1,50
345,352,1,346,7,1917,1,70
346,352,1,347,7,1924,1,70
347,352,1,348,4,1928,1,40
348,352,1,349,2,1930,1,20
349,352,1,350,9,1939,1,90
350,352,1,351,8,1947,66,80
351,352,1,352,3,1950,1,30
352,352,1,353,7,1957,1,70
353,352,1,354,5,1962,1,50
354,352,1,355,8,1970,1,80
355,352,1,356,3,1973,1,30
356,352,1,357,6,1979,1,60
357,352,1,358,5,1984,1,50
358,352,1,359,8,1992,1,80
359,352,1,360,6,1998,1,60
360,352,1,361,2,2000,1,20
361,352,1,362,8,2008,1,80
362,352,1,363,7,2015,46,70
363,352,1,364,3,2018,1,30
364,352,1,365,8,2026,1,80
365,352,1,366,6,2032,1,60
366,352,1,367,6,2038,1,60
367,352,1,368,3,2041,1,30
368,352,1,369,3,2044,1,30
369,352,1,370,4,2048,1,40
370,352,1,371,2,2050,1,20
371,352,1,372,7,2057,1,70
372,352,1,373,4,2061,1,40
373,352,1,374,6,2067,1,60
374,352,1,375,6,2073,1,60
375,352,1,376,8,2081,1,80
376,352,1,377,4,2085,1,40
377,352,1,378,5,2090,1,50
378,352,1,379,4,2094,1,40
379,352,1,380,5,2099,1,50
380,352,1,381,2,2101,1,20
381,352,1,382,6,2107,1,60
382,352,1,383,7,2114,1,70
383,352,1,384,3,2117,1,30
384,352,1,385,5,2122,1,50
385,352,1,386,3,2125,1,30
386,352,1,387,2,2127,1,20
387,352,1,388,4,2131,1,40
388,352,1,389,8,2139,1,80
389,352,1,390,5,2144,1,50
390,352,1,391,6,2150,1,60
391,352,1,392,7,2157,1,70
392,352,1,393,6,2163,1,60
393,352,1,394,5,2168,1,50
394,352,1,395,8,2176,1,80
395,352,1,396,6,2182,1,60
396,352,1,397,5,2187,1,50
397,352,1,398,8,2195,1,80
398,352,1,399,6,2201,51,60
399,352,1,400,8,2209,1,80
400,352,1,401,8,2217,1,80
401,352,1,402,4,2221,1,40
402,352,1,403,5,2226,1,50
403,352,1,404,9,2235,1,90
404,352,1,405,8,2243,1,80
405,352,1,406,8,2251,1,80
406,352,1,407,9,2260,1,90
407,352,1,408,3,2263,1,30
408,352,1,409,2,2265,1,20
409,352,1,410,6,2271,1,60
410,352,1,411,5,2276,1,50
411,352,1,412,9,2285,1,90
412,352,1,413,8,2293,1,80
413,352,1,414,3,2296,1,30
414,352,1,415,3,2299,1,30
415,352,1,416,9,2308,36,90
416,352,1,417,6,2314,1,60
417,352,1,418,3,2317,1,30
418,352,1,419,2,2319,1,20
419,352,1,420,9,2328,1,90
420,352,1,421,3,2331,1,30
421,352,1,422,9,2340,1,90
422,352,1,423,4,2344,1,40
423,352,1,424,5,2349,1,50
424,352,1,425,3,2352,1,30
425,352,1,426,5,2357,1,50
426,352,1,427,8,2365,1,80
427,352,1,428,3,2368,1,30
428,352,1,429,4,2372,1,40
429,352,1,430,9,2381,1,90
430,352,1,431,2,2383,1,20
431,352,1,432,4,2387,1,40
432,352,1,433,7,2394,1,70
433,352,1,434,6,2400,1,60
434,352,1,435,8,2408,1,80
435,352,1,436,9,2417,1,90
436,352,1,437,5,2422,1,50
437,352,1,438,3,2425,1,30
438,352,1,439,8,2433,1,80
439,352,1,440,6,2439,48,60
440,352,1,441,6,2445,1,60
441,352,1,442,7,2452,1,70
442,352,1,443,5,2457,1,50
443,352,1,444,8,2465,1,80
444,352,1,445,2,2467,1,20
445,352,1,446,4,2471,1,40
446,352,1,447,9,2480,1,90
447,352,1,448,3,2483,1,30
448,352,1,449,3,2486,1,30
449,352,1,450,8,2494,1,80
450,352,1,451,7,2501,1,70
451,352,1,452,5,2506,1,50
452,352,1,453,2,2508,1,20
453,352,1,454,4,2512,1,40
454,352,1,455,9,2521,1,90
455,352,1,456,3,2524,1,30
456,352,1,457,6,2530,1,60
457,352,1,458,5,2535,1,50
458,352,1,459,3,2538,1,30
459,352,1,460,5,2543,1,50
460,352,1,461,4,2547,40,40
461,352,1,462,8,2555,1,80
462,352,1,463,8,2563,1,80
463,352,1,464,4,2567,1,40
464,352,1,465,2,2569,1,20
465,352,1,466,2,2571,1,20
466,352,1,467,6,2577,1,60
467,352,1,468,6,2583,1,60
468,352,1,469,5,2588,1,50
469,352,1,470,3,2591,1,30
470,352,1,471,4,2595,1,40
471,352,1,472,2,2597,1,20
472,352,1,473,7,2604,1,70
473,352,1,474,9,2613,1,90
474,352,1,475,6,2619,1,60
475,352,1,476,5,2624,1,50
476,352,1,477,2,2626,1,20
477,352,1,478,5,2631,1,50
478,352,1,479,2,2633,1,20
479,352,1,480,3,2636,26,30
480,352,1,481,8,2644,1,80
481,352,1,482,2,2646,1,20
482,352,1,483,8,2654,1,80
483,352,1,484,9,2663,1,90
484,352,1,485,8,2671,1,80
485,352,1,486,7,2678,1,70
486,352,1,487,9,2687,1,90
487,352,1,488,6,2693,1,60
488,352,1,489,9,2702,1,90
489,352,1,490,2,2704,1,20
490,352,1,491,4,2708,1,40
491,352,1,492,4,2712,1,40
492,352,1,493,5,2717,1,50
493,352,1,494,4,2721,1,40
494,352,1,495,9,2730,1,90
495,352,1,496,5,2735,1,50
496,352,1,497,2,2737,1,20
497,352,1,498,5,2742,1,50
498,352,1,499,6,2748,1,60
499,352,1,500,3,2751,1,30
500,352,1,501,3,2754,1,30
501,352,1,502,3,2757,1,30
502,352,1,503,5,2762,1,50
503,352,1,504,7,2769,1,70
504,352,1,505,4,2773,1,40
505,352,1,506,7,2780,1,70
506,352,1,507,3,2783,1,30
507,352,1,508,4,2787,1,40
508,352,1,509,5,2792,44,50
509,352,1,510,3,2795,22,30
510,352,1,511,9,2804,1,90
511,352,1,512,6,2810,1,60
512,352,1,513,9,2819,1,90
513,352,1,514,7,2826,1,70
514,352,1,515,5,2831,1,50
515,352,1,516,3,2834,1,30
516,352,1,517,5,2839,1,50
517,352,1,518,4,2843,1,40
518,352,1,519,5,2848,1,50
519,352,1,520,9,2857,1,90
520,352,1,521,7,2864,1,70
521,352,1,522,5,2869,1,50
522,352,1,523,4,2873,1,40
523,352,1,524,8,2881,1,80
524,352,1,525,6,2887,1,60
525,352,1,526,8,2895,1,80
526,352,1,527,2,2897,1,20
527,352,1,528,5,2902,1,50
528,352,1,529,6,2908,1,60
529,352,1,530,2,2910,1,20
530,352,1,531,6,2916,1,60
531,352,1,532,2,2918,27,20
532,352,1,533,3,2921,1,30
533,352,1,534,8,2929,1,80
534,352,1,535,8,2937,1,80
535,352,1,536,3,2940,1,30
536,352,1,537,4,2944,1,40
537,352,1,538,3,2947,1,30
538,352,1,539,3,2950,1,30
539,352,1,540,4,2954,1,40
540,352,1,541,9,2963,1,90
541,352,1,542,7,2970,1,70
542,352,1,543,3,2973,1,30
543,352,1,544,3,2976,1,30
544,352,1,545,5,2981,1,50
545,352,1,546,3,2984,1,30
546,352,1,547,5,2989,1,50
547,352,1,548,5,2994,1,50
548,352,1,549,8,3002,1,80
549,352,1,550,7,3009,1,70
550,352,1,551,5,3014,1,50
551,352,1,552,3,3017,1,30
552,352,1,553,5,3022,1,50
553,352,1,554,4,3026,1,40
554,352,1,555,4,3030,1,40
555,352,1,556,8,3038,1,80
556,352,1,557,6,3044,1,60
557,352,1,558,8,3052,1,80
558,352,1,559,8,3060,1,80
559,352,1,560,3,3063,1,30
560,352,1,561,6,3069,1,60
561,352,1,562,4,3073,1,40
562,352,1,563,8,3081,1,80
563,352,1,564,3,3084,1,30
564,352,1,565,2,3086,1,20
565,352,1,566,5,3091,1,50
566,352,1,567,7,3098,1,70
567,352,1,568,2,3100,1,20
568,352,1,569,8,3108,1,80
569,352,1,570,4,3112,1,40
570,352,1,571,8,3120,1,80
571,352,1,572,6,3126,1,60
572,352,1,573,5,3131,1,50
573,352,1,574,4,3135,1,40
574,352,1,575,8,3143,1,80
575,352,1,576,9,3152,1,90
576,352,1,577,2,3154,1,20
577,352,1,578,8,3162,1,80
578,352,1,579,8,3170,1,80
579,352,1,580,2,3172,1,20
580,352,1,581,4,3176,1,40
581,352,1,582,6,3182,1,60
582,352,1,583,4,3186,1,40
583,352,1,584,3,3189,1,30
584,352,1,585,5,3194,1,50
585,352,1,586,7,3201,1,70
586,352,1,587,6,3207,1,60
587,352,1,588,6,3213,1,60
588,352,1,589,4,3217,1,40
589,352,1,590,2,3219,1,20
590,352,1,591,9,3228,1,90
591,352,1,592,7,3235,1,70
592,352,1,593,5,3240,1,50
593,352,1,594,2,3242,1,20
594,352,1,595,7,3249,1,70
595,352,1,596,9,3258,1,90
596,352,1,597,5,3263,1,50
597,352,1,598,5,3268,70,50
598,352,1,599,3,3271,1,30
599,352,1,600,3,3274,1,30
600,352,1,601,5,3279,1,50
601,352,1,602,8,3287,1,80
602,352,1,603,8,3295,1,80
603,352,1,604,6,3301,1,60
604,352,1,605,7,3308,1,70
605,352,1,606,7,3315,1,70
606,352,1,607,2,3317,44,20
607,352,1,608,8,3325,1,80
608,352,1,609,9,3334,1,90
609,352,1,610,9,3343,1,90
610,352,1,611,6,3349,1,60
611,352,1,612,9,3358,1,90
612,352,1,613,6,3364,1,60
613,352,1,614,4,3368,1,40
614,352,1,615,3,3371,1,30
615,352,1,616,6,3377,1,60
616,352,1,617,5,3382,1,50
617,352,1,618,4,3386,1,40
618,352,1,619,5,3391,1,50
619,352,1,620,5,3396,1,50
620,352,1,621,9,3405,1,90
621,352,1,622,3,3408,1,30
622,352,1,623,6,3414,1,60
623,352,1,624,7,3421,1,70
624,352,1,625,5,3426,1,50
625,352,1,626,6,3432,1,60
626,352,1,627,6,3438,1,60
627,352,1,628,3,3441,1,30
628,352,1,629,4,3445,1,40
629,352,1,630,6,3451,1,60
630,352,1,631,7,3458,1,70
631,352,1,632,7,3465,1,70
632,352,1,633,2,3467,1,20
633,352,1,634,3,3470,1,30
634,352,1,635,6,3476,1,60
635,352,1,636,4,3480,1,40
636,352,1,637,4,3484,1,40
637,352,1,638,4,3488,1,40
638,352,1,639,9,3497,1,90
639,352,1,640,3,3500,1,30
640,352,1,641,4,3504,1,40
641,352,1,642,9,3513,1,90
642,352,1,643,6,3519,1,60
643,352,1,644,2,3521,1,20
644,352,1,645,4,3525,1,40
645,352,1,646,6,3531,1,60
646,352,1,647,7,3538,1,70
647,352,1,648,2,3540,1,20
648,352,1,649,9,3549,1,90
649,352,1,650,3,3552,1,30
650,352,1,651,8,3560,1,80
651,352,1,652,4,3564,1,40
652,352,1,653,9,3573,1,90
653,352,1,654,8,3581,1,80
654,352,1,655,5,3586,1,50
655,352,1,656,3,3589,1,30
656,352,1,657,6,3595,1,60
657,352,1,658,4,3599,1,40
658,352,1,659,7,3606,1,70
659,352,1,660,9,3615,1,90
660,352,1,661,9,3624,1,90
661,352,1,662,4,3628,1,40
662,352,1,663,5,3633,1,50
663,352,1,664,5,3638,1,50
664,352,1,665,6,3644,1,60
665,352,1,666,7,3651,1,70
666,352,1,667,3,3654,1,30
667,352,1,668,7,3661,1,70
668,352,1,669,8,3669,1,80
669,352,1,670,5,3674,1,50
670,352,1,671,9,3683,1,90
671,352,1,672,5,3688,1,50
672,352,1,673,7,3695,1,70
673,352,1,674,7,3702,1,70
674,352,1,675,3,3705,1,30
675,352,1,676,6,3711,1,60
676,352,1,677,4,3715,1,40
677,352,1,678,7,3722,1,70
678,352,1,679,3,3725,1,30
679,352,1,680,7,3732,1,70
680,352,1,681,2,3734,1,20
681,352,1,682,6,3740,1,60
682,352,1,683,3,3743,1,30
683,352,1,684,7,3750,1,70
684,352,1,685,5,3755,1,50
685,352,1,686,9,3764,1,90
686,352,1,687,3,3767,1,30
687,352,1,688,6,3773,1,60
688,352,1,689,9,3782,1,90
689,352,1,690,7,3789,1,70
690,352,1,691,9,3798,1,90
691,352,1,692,8,3806,1,80
692,352,1,693,7,3813,1,70
693,352,1,694,5,3818,1,50
694,352,1,695,8,3826,1,80
695,352,1,696,7,3833,1,70
696,352,1,697,2,3835,1,20
697,352,1,698,4,3839,1,40
698,352,1,699,7,3846,1,70
699,352,1,700,8,3854,1,80
700,352,1,701,4,3858,1,40
701,352,1,702,4,3862,1,40
702,352,1,703,9,3871,1,90
703,352,1,704,7,3878,1,70
704,352,1,705,4,3882,100,40
705,352,1,706,4,3886,1,40
706,352,1,707,8,3894,1,80
707,352,1,708,8,3902,1,80
708,352,1,709,9,3911,1,90
709,352,1,710,5,3916,1,50
710,352,1,711,8,3924,1,80
711,352,1,712,9,3933,1,90
712,352,1,713,7,3940,1,70
713,352,1,714,6,3946,1,60
714,352,1,715,6,3952,1,60
715,352,1,716,4,3956,1,40
716,352,1,717,4,3960,1,40
717,352,1,718,5,3965,1,50
718,352,1,719,5,3970,81,50
719,352,1,720,5,3975,1,50
720,352,1,721,5,3980,1,50
721,352,1,722,9,3989,1,90
722,352,1,723,4,3993,45,40
723,352,1,724,3,3996,20,30
724,352,1,725,4,4000,1,40
725,352,1,726,7,4007,1,70
726,352,1,727,6,4013,1,60
727,352,1,728,2,4015,1,20
728,352,1,729,8,4023,1,80
729,352,1,730,4,4027,16,40
730,352,1,731,7,4034,1,70
731,352,1,732,5,4039,1,50
732,352,1,733,6,4045,1,60
733,352,1,734,9,4054,1,90
734,352,1,735,9,4063,1,90
735,352,1,736,3,4066,1,30
736,352,1,737,3,4069,1,30
737,352,1,738,6,4075,1,60
738,352,1,739,9,4084,1,90
739,352,1,740,4,4088,1,40
740,352,1,741,3,4091,21,30
741,352,1,742,8,4099,1,80
742,352,1,743,7,4106,5,70
743,352,1,744,4,4110,1,40
744,352,1,745,8,4118,1,80
745,352,1,746,5,4123,1,50
746,352,1,747,6,4129,1,60
747,352,1,748,8,4137,1,80
748,352,1,749,7,4144,1,70
749,352,1,750,2,4146,1,20
750,352,1,751,4,4150,1,40
751,352,1,752,8,4158,1,80
752,352,1,753,5,4163,1,50
753,352,1,754,6,4169,1,60
754,352,1,755,3,4172,1,30
755,352,1,756,4,4176,1,40
756,352,1,757,7,4183,1,70
757,352,1,758,9,4192,1,90
758,352,1,759,8,4200,1,80
759,352,1,760,6,4206,1,60
760,352,1,761,3,4209,1,30
761,352,1,762,7,4216,1,70
762,352,1,763,4,4220,19,40
763,352,1,764,6,4226,1,60
764,352,1,765,5,4231,1,50
765,352,1,766,4,4235,1,40
766,352,1,767,3,4238,1,30
767,352,1,768,7,4245,1,70
768,352,1,769,9,4254,1,90
769,352,1,770,6,4260,1,60
770,352,1,771,3,4263,1,30
771,352,1,772,5,4268,1,50
772,352,1,773,7,4275,1,70
773,352,1,774,2,4277,1,20
774,352,1,775,4,4281,1,40
775,352,1,776,8,4289,1,80
776,352,1,777,6,4295,1,60
777,352,1,778,3,4298,1,30
778,352,1,779,8,4306,1,80
779,352,1,780,4,4310,1,40
780,352,1,781,3,4313,1,30
781,352,1,782,2,4315,1,20
782,352,1,783,9,4324,1,90
783,352,1,784,2,4326,1,20
784,352,1,785,8,4334,1,80
785,352,1,786,3,4337,1,30
786,352,1,787,4,4341,1,40
787,352,1,788,2,4343,1,20
788,352,1,789,5,4348,1,50
789,352,1,790,5,4353,1,50
790,352,1,791,5,4358,1,50
791,352,1,792,9,4367,1,90
792,352,1,793,3,4370,1,30
793,352,1,794,9,4379,1,90
794,352,1,795,2,4381,1,20
795,352,1,796,2,4383,1,20
796,352,1,797,3,4386,1,30
797,352,1,798,9,4395,1,90
798,352,1,799,2,4397,1,20
799,352,1,800,4,4401,1,40
800,352,1,801,8,4409,1,80
801,352,1,802,9,4418,1,90
802,352,1,803,9,4427,1,90
803,352,1,804,9,4436,1,90
804,352,1,805,9,4445,1,90
805,352,1,806,6,4451,1,60
806,352,1,807,6,4457,1,60
807,352,1,808,9,4466,1,90
808,352,1,809,6,4472,1,60
809,352,1,810,4,4476,1,40
810,352,1,811,7,4483,1,70
811,352,1,812,7,4490,1,70
812,352,1,813,6,4496,1,60
813,352,1,814,4,4500,1,40
814,352,1,815,2,4502,1,20
815,352,1,816,3,4505,1,30
816,352,1,817,6,4511,1,60
817,352,1,818,6,4517,1,60
818,352,1,819,6,4523,1,60
819,352,1,820,7,4530,1,70
820,352,1,821,5,4535,1,50
821,352,1,822,6,4541,1,60
822,352,1,823,9,4550,1,90
823,352,1,824,4,4554,1,40
824,352,1,825,6,4560,1,60
825,352,1,826,8,4568,1,80
826,352,1,827,5,4573,1,50
827,352,1,828,4,4577,1,40
828,352,1,829,9,4586,1,90
829,352,1,830,6,4592,1,60
830,352,1,831,6,4598,1,60
831,352,1,832,5,4603,1,50
832,352,1,833,9,4612,1,90
833,352,1,834,5,4617,1,50
834,352,1,835,9,4626,1,90
835,352,1,836,7,4633,1,70
836,352,1,837,2,4635,1,20
837,352,1,838,8,4643,1,80
838,352,1,839,4,4647,1,40
839,352,1,840,3,4650,1,30
840,352,1,841,7,4657,1,70
841,352,1,842,2,4659,1,20
842,352,1,843,4,4663,1,40
843,352,1,844,2,4665,1,20
844,352,1,845,3,4668,1,30
845,352,1,846,2,4670,1,20
846,352,1,847,8,4678,1,80
847,352,1,848,4,4682,1,40
848,352,1,849,2,4684,75,20
849,352,1,850,6,4690,1,60
850,352,1,851,3,4693,1,30
851,352,1,852,8,4701,1,80
852,352,1,853,5,4706,1,50
853,352,1,854,7,4713,1,70
854,352,1,855,9,4722,1,90
855,352,1,856,3,4725,1,30
856,352,1,857,7,4732,1,70
857,352,1,858,9,4741,1,90
858,352,1,859,5,4746,1,50
859,352,1,860,9,4755,1,90
860,352,1,861,3,4758,1,30
861,352,1,862,5,4763,1,50
862,352,1,863,4,4767,1,40
863,352,1,864,7,4774,1,70
864,352,1,865,6,4780,1,60
865,352,1,866,3,4783,60,30
866,352,1,867,9,4792,1,90
867,352,1,868,2,4794,1,20
868,352,1,869,8,4802,1,80
869,352,1,870,2,4804,1,20
870,352,1,871,7,4811,1,70
871,352,1,872,5,4816,1,50
872,352,1,873,8,4824,40,80
873,352,1,874,5,4829,1,50
874,352,1,875,7,4836,1,70
875,352,1,876,4,4840,1,40
876,352,1,877,2,4842,1,20
877,352,1,878,9,4851,1,90
878,352,1,879,7,4858,1,70
879,352,1,880,8,4866,1,80
880,352,1,881,2,4868,1,20
881,352,1,882,3,4871,1,30
882,352,1,883,2,4873,1,20
883,352,1,884,5,4878,1,50
884,352,1,885,8,4886,1,80
885,352,1,886,2,4888,1,20
886,352,1,887,5,4893,1,50
887,352,1,888,5,4898,1,50
888,352,1,889,4,4902,1,40
889,352,1,890,6,4908,1,60
890,352,1,891,3,4911,1,30
891,352,1,892,3,4914,1,30
892,352,1,893,3,4917,1,30
893,352,1,894,4,4921,1,40
894,352,1,895,3,4924,1,30
895,352,1,896,8,4932,1,80
896,352,1,897,6,4938,43,60
897,352,1,898,7,4945,1,70
898,352,1,899,5,4950,1,50
899,352,1,900,4,4954,1,40
900,352,1,901,9,4963,1,90
901,352,1,902,2,4965,1,20
902,352,1,903,4,4969,1,40
903,352,1,904,5,4974,1,50
904,352,1,905,5,4979,1,50
905,352,1,906,3,4982,1,30
906,352,1,907,5,4987,1,50
907,352,1,908,4,4991,24,40
908,352,1,909,2,4993,1,20
909,352,1,910,4,4997,1,40
910,352,2,1,6,6,1,60
911,352,2,2,2,8,1,20
912,352,2,3,3,11,1,30
913,352,2,4,8,19,1,80
914,352,2,5,3,22,1,30
915,352,2,6,9,31,1,90
916,352,2,7,6,37,1,60
917,352,2,8,6,43,1,60
918,352,2,9,6,49,12,60
919,352,2,10,4,53,1,40
920,352,2,11,8,61,1,80
921,352,2,12,6,67,1,60
922,352,2,13,4,71,1,40
923,352,2,14,3,74,1,30
924,352,2,15,4,78,1,40
925,352,2,16,2,80,1,20
926,352,2,17,4,84,1,40
927,352,2,18,9,93,1,90
928,352,2,19,8,101,1,80
929,352,2,20,4,105,1,40
930,352,2,21,2,107,1,20
931,352,2,22,3,110,1,30
932,352,2,23,9,119,15,90
933,352,2,24,5,124,1,50
934,352,2,25,5,129,1,50
935,352,2,26,8,137,1,80
936,352,2,27,2,139,1,20
937,352,2,28,8,147,1,80
938,352,2,29,5,152,1,50
939,352,2,30,2,154,1,20
940,352,2,31,5,159,1,50
941,352,2,32,3,162,1,30
942,352,2,33,9,171,1,90
943,352,2,34,7,178,1,70
944,352,2,35,8,186,1,80
945,352,2,36,9,195,1,90
946,352,2,37,8,203,1,80
947,352,2,38,4,207,1,40
948,352,2,39,3,210,1,30
949,352,2,40,3,213,1,30
950,352,2,41,6,219,1,60
951,352,2,42,5,224,1,50
952,352,2,43,3,227,1,30
953,352,2,44,7,234,1,70
954,352,2,45,9,243,1,90
955,352,2,46,4,247,1,40
956,352,2,47,5,252,1,50
957,352,2,48,9,261,1,90
958,352,2,49,5,266,1,50
959,352,2,50,3,269,1,30
960,352,2,51,6,275,1,60
961,352,2,52,7,282,1,70
962,352,2,53,2,284,1,20
963,352,2,54,7,291,1,70
964,352,2,55,5,296,1,50
965,352,2,56,4,300,1,40
966,352,2,57,4,304,1,40
967,352,2,58,9,313,1,90
968,352,2,59,6,319,1,60
969,352,2,60,6,325,1,60
970,352,2,61,5,330,1,50
971,352,2,62,5,335,1,50
972,352,2,63,3,338,1,30
973,352,2,64,7,345,1,70
974,352,2,65,9,354,50,90
975,352,2,66,3,357,1,30
976,352,2,67,6,363,1,60
977,352,2,68,5,368,1,50
978,352,2,69,8,376,1,80
979,352,2,70,4,380,1,40
980,352,2,71,9,389,1,90
981,352,2,72,2,391,1,20
982,352,2,73,7,398,25,70
983,352,2,74,8,406,1,80
984,352,2,75,4,410,1,40
985,352,2,76,7,417,1,70
986,352,2,77,7,424,1,70
987,352,2,78,4,428,1,40
988,352,2,79,2,430,1,20
989,352,2,80,8,438,1,80
990,352,2,81,6,444,1,60
991,352,2,82,2,446,1,20
992,352,2,83,8,454,1,80
993,352,2,84,4,458,28,40
994,352,2,85,4,462,1,40
995,352,2,86,3,465,1,30
996,352,2,87,8,473,1,80
997,352,2,88,7,480,1,70
998,352,2,89,5,485,1,50
999,352,2,90,5,490,1,50
1000,352,2,91,3,493,1,30
1001,352,2,92,8,501,1,80
1002,352,2,93,2,503,1,20
1003,352,2,94,3,506,1,30
1004,352,2,95,3,509,1,30
1005,352,2,96,6,515,1,60
1006,352,2,97,4,519,1,40
1007,352,2,98,8,527,13,80
1008,352,2,99,5,532,1,50
1009,352,2,100,8,540,1,80
1010,352,2,101,5,545,1,50
1011,352,2,102,4,549,1,40
1012,352,2,103,6,555,1,60
1013,352,2,104,9,564,1,90
1014,352,2,105,8,572,1,80
1015,352,2,106,7,579,1,70
1016,352,2,107,3,582,1,30
1017,352,2,108,2,584,1,20
1018,352,2,109,7,591,1,70
1019,352,2,110,8,599,1,80
1020,352,2,111,4,603,1,40
1021,352,2,112,5,608,1,50
1022,352,2,113,7,615,1,70
1023,352,2,114,9,624,1,90
1024,352,2,115,7,631,1,70
1025,352,2,116,5,636,1,50
1026,352,2,117,7,643,1,70
1027,352,2,118,6,649,45,60
1028,352,2,119,3,652,1,30
1029,352,2,120,9,661,1,90
1030,352,2,121,3,664,1,30
1031,352,2,122,7,671,1,70
1032,352,2,123,5,676,1,50
1033,352,2,124,3,679,1,30
1034,352,2,125,2,681,1,20
1035,352,2,126,7,688,1,70
1036,352,2,127,2,690,1,20
1037,352,2,128,6,696,1,60
1038,352,2,129,7,703,1,70
1039,352,2,130,8,711,1,80
1040,352,2,131,3,714,1,30
1041,352,2,132,4,718,1,40
1042,352,2,133,7,725,1,70
1043,352,2,134,2,727,1,20
1044,352,2,135,4,731,1,40
1045,352,2,136,4,735,1,40
1046,352,2,137,3,738,21,30
1047,352,2,138,7,745,1,70
1048,352,2,139,5,750,1,50
1049,352,2,140,6,756,1,60
1050,352,2,141,4,760,1,40
1051,352,2,142,2,762,1,20
1052,352,2,143,5,767,1,50
1053,352,2,144,6,773,1,60
1054,352,2,145,8,781,1,80
1055,352,2,146,8,789,1,80
1056,352,2,147,4,793,1,40
1057,352,2,148,3,796,1,30
1058,352,2,149,5,801,1,50
1059,352,2,150,9,810,1,90
1060,352,2,151,2,812,1,20
1061,352,2,152,8,820,1,80
1062,352,2,153,6,826,24,60
1063,352,2,154,8,834,1,80
1064,352,2,155,9,843,1,90
1065,352,2,156,3,846,1,30
1066,352,2,157,7,853,1,70
1067,352,2,158,4,857,1,40
1068,352,2,159,7,864,1,70
1069,352,2,160,4,868,1,40
1070,352,2,161,6,874,1,60
1071,352,2,162,6,880,1,60
1072,352,2,163,9,889,1,90
1073,352,2,164,8,897,1,80
1074,352,2,165,2,899,1,20
1075,352,2,166,2,901,29,20
1076,352,2,167,5,906,1,50
1077,352,2,168,5,911,1,50
1078,352,2,169,3,914,1,30
1079,352,2,170,5,919,1,50
1080,352,2,171,9,928,1,90
1081,352,2,172,9,937,1,90
1082,352,2,173,9,946,1,90
1083,352,2,174,7,953,1,70
1084,352,2,175,5,958,1,50
1085,352,2,176,2,960,1,20
1086,352,2,177,2,962,1,20
1087,352,2,178,3,965,1,30
1088,352,2,179,6,971,1,60
1089,352,2,180,2,973,1,20
1090,352,2,181,7,980,1,70
1091,352,2,182,7,987,1,70
1092,352,2,183,8,995,1,80
1093,352,2,184,9,1004,1,90
1094,352,2,185,3,1007,1,30
1095,352,2,186,2,1009,1,20
1096,352,2,187,5,1014,1,50
1097,352,2,188,4,1018,1,40
1098,352,2,189,2,1020,1,20
1099,352,2,190,5,1025,1,50
1100,352,2,191,8,1033,1,80
1101,352,2,192,2,1035,1,20
1102,352,2,193,9,1044,1,90
1103,352,2,194,6,1050,1,60
1104,352,2,195,6,1056,1,60
1105,352,2,196,3,1059,1,30
1106,352,2,197,4,1063,1,40
1107,352,2,198,9,1072,39,90
1108,352,2,199,8,1080,1,80
1109,352,2,200,6,1086,1,60
1110,352,2,201,3,1089,1,30
1111,352,2,202,4,1093,1,40
1112,352,2,203,5,1098,21,50
1113,352,2,204,5,1103,1,50
1114,352,2,205,5,1108,1,50
1115,352,2,206,2,1110,1,20
1116,352,2,207,3,1113,1,30
1117,352,2,208,4,1117,1,40
1118,352,2,209,3,1120,1,30
1119,352,2,210,9,1129,1,90
1120,352,2,211,8,1137,1,80
1121,352,2,212,5,1142,1,50
1122,352,2,213,7,1149,1,70
1123,352,2,214,5,1154,1,50
1124,352,2,215,3,1157,1,30
1125,352,2,216,8,1165,1,80
1126,352,2,217,9,1174,1,90
1127,352,2,218,6,1180,1,60
1128,352,2,219,3,1183,1,30
1129,352,2,220,5,1188,1,50
1130,352,2,221,6,1194,1,60
1131,352,2,222,3,1197,1,30
1132,352,2,223,6,1203,1,60
1133,352,2,224,6,1209,1,60
1134,352,2,225,5,1214,1,50
1135,352,2,226,6,1220,25,60
1136,352,2,227,7,1227,1,70
1137,352,2,228,3,1230,1,30
1138,352,2,229,4,1234,1,40
1139,352,2,230,6,1240,1,60
1140,352,2,231,2,1242,1,20
1141,352,2,232,2,1244,1,20
1142,352,2,233,3,1247,1,30
1143,352,2,234,4,1251,1,40
1144,352,2,235,8,1259,1,80
1145,352,2,236,3,1262,1,30
1146,352,2,237,6,1268,1,60
1147,352,2,238,9,1277,1,90
1148,352,2,239,3,1280,1,30
1149,352,2,240,3,1283,1,30
1150,352,2,241,8,1291,1,80
1151,352,2,242,2,1293,1,20
1152,352,2,243,5,1298,1,50
1153,352,2,244,8,1306,1,80
1154,352,2,245,8,1314,1,80
1155,352,2,246,4,1318,1,40
1156,352,2,247,6,1324,1,60
1157,352,2,248,3,1327,33,30
1158,352,2,249,2,1329,1,20
1159,352,2,250,9,1338,1,90
1160,352,2,251,9,1347,1,90
1161,352,2,252,6,1353,1,60
1162,352,2,253,4,1357,1,40
1163,352,2,254,2,1359,1,20
1164,352,2,255,9,1368,1,90
1165,352,2,256,4,1372,1,40
1166,352,2,257,9,1381,1,90
1167,352,2,258,2,1383,1,20
1168,352,2,259,2,1385,1,20
1169,352,2,260,2,1387,27,20
1170,352,2,261,8,1395,1,80
1171,352,2,262,2,1397,1,20
1172,352,2,263,3,1400,1,30
1173,352,2,264,3,1403,1,30
1174,352,2,265,8,1411,1,80
1175,352,2,266,3,1414,1,30
1176,352,2,267,8,1422,1,80
1177,352,2,268,9,1431,1,90
1178,352,2,269,5,1436,1,50
1179,352,2,270,6,1442,1,60
1180,352,2,271,9,1451,1,90
1181,352,2,272,8,1459,1,80
1182,352,2,273,4,1463,1,40
1183,352,2,274,2,1465,1,20
1184,352,2,275,7,1472,1,70
1185,352,2,276,7,1479,1,70
1186,352,2,277,4,1483,1,40
1187,352,2,278,7,1490,1,70
1188,352,2,279,5,1495,1,50
1189,352,2,280,3,1498,1,30
1190,352,2,281,3,1501,1,30
1191,352,2,282,3,1504,1,30
1192,352,2,283,5,1509,1,50
1193,352,2,284,3,1512,1,30
1194,352,2,285,2,1514,1,20
1195,352,2,286,2,1516,1,20
1196,352,2,287,8,1524,1,80
1197,352,2,288,4,1528,1,40
1198,352,2,289,7,1535,1,70
1199,352,2,290,4,1539,1,40
1200,352,2,291,4,1543,1,40
1201,352,2,292,8,1551,1,80
1202,352,2,293,5,1556,1,50
1203,352,2,294,5,1561,1,50
1204,352,2,295,3,1564,1,30
1205,352,2,296,4,1568,47,40
1206,352,2,297,3,1571,19,30
1207,352,2,298,2,1573,1,20
1208,352,2,299,6,1579,1,60
1209,352,2,300,7,1586,1,70
1210,352,2,301,6,1592,1,60
1211,352,2,302,2,1594,1,20
1212,352,2,303,5,1599,1,50
1213,352,2,304,3,1602,1,30
1214,352,2,305,2,1604,1,20
1215,352,2,306,3,1607,1,30
1216,352,2,307,8,1615,1,80
1217,352,2,308,9,1624,1,90
1218,352,2,309,3,1627,1,30
1219,352,2,310,9,1636,1,90
1220,352,2,311,4,1640,1,40
1221,352,2,312,5,1645,1,50
1222,352,2,313,9,1654,1,90
1223,352,2,314,8,1662,1,80
1224,352,2,315,6,1668,1,60
1225,352,2,316,8,1676,1,80
1226,352,2,317,9,1685,28,90
1227,352,2,318,7,1692,1,70
1228,352,2,319,5,1697,1,50
1229,352,2,320,9,1706,1,90
1230,352,2,321,8,1714,1,80
1231,352,2,322,6,1720,1,60
1232,352,2,323,8,1728,1,80
1233,352,2,324,2,1730,1,20
1234,352,2,325,3,1733,20,30
1235,352,2,326,6,1739,1,60
1236,352,2,327,6,1745,1,60
1237,352,2,328,9,1754,1,90
1238,352,2,329,8,1762,16,80
1239,352,2,330,6,1768,1,60
1240,352,2,331,9,1777,1,90
1241,352,2,332,4,1781,11,40
1242,352,2,333,7,1788,1,70
1243,352,2,334,3,1791,1,30
1244,352,2,335,3,1794,1,30
1245,352,2,336,2,1796,1,20
1246,352,2,337,4,1800,1,40
1247,352,2,338,9,1809,1,90
1248,352,2,339,9,1818,1,90
1249,352,2,340,8,1826,1,80
1250,352,2,341,2,1828,1,20
1251,352,2,342,6,1834,1,60
1252,352,2,343,2,1836,1,20
1253,352,2,344,7,1843,1,70
1254,352,2,345,4,1847,1,40
1255,352,2,346,7,1854,1,70
1256,352,2,347,9,1863,1,90
1257,352,2,348,5,1868,1,50
1258,352,2,349,2,1870,1,20
1259,352,2,350,2,1872,1,20
1260,352,2,351,2,1874,1,20
1261,352,2,352,4,1878,1,40
1262,352,2,353,6,1884,1,60
1263,352,2,354,2,1886,20,20
1264,352,2,355,3,1889,1,30
1265,352,2,356,7,1896,1,70
1266,352,2,357,7,1903,1,70
1267,352,2,358,2,1905,1,20
1268,352,2,359,2,1907,1,20
1269,352,2,360,8,1915,1,80
1270,352,2,361,7,1922,1,70
1271,352,2,362,2,1924,1,20
1272,352,2,363,3,1927,1,30
1273,352,2,364,6,1933,1,60
1274,352,2,365,6,1939,1,60
1275,352,2,366,8,1947,1,80
1276,352,2,367,3,1950,1,30
1277,352,2,368,9,1959,21,90
1278,352,2,369,7,1966,1,70
1279,352,2,370,6,1972,1,60
1280,352,2,371,8,1980,1,80
1281,352,2,372,3,1983,1,30
1282,352,2,373,7,1990,1,70
1283,352,2,374,7,1997,1,70
1284,352,2,375,8,2005,1,80
1285,352,2,376,9,2014,1,90
1286,352,2,377,3,2017,1,30
1287,352,2,378,2,2019,1,20
1288,352,2,379,4,2023,1,40
1289,352,2,380,8,2031,1,80
1290,352,2,381,2,2033,1,20
1291,352,2,382,4,2037,1,40
1292,352,2,383,4,2041,1,40
1293,352,2,384,3,2044,1,30
1294,352,2,385,5,2049,1,50
1295,352,2,386,7,2056,1,70
1296,352,2,387,7,2063,1,70
1297,352,2,388,5,2068,1,50
1298,352,2,389,4,2072,1,40
1299,352,2,390,5,2077,1,50
1300,352,2,391,9,2086,1,90
1301,352,2,392,4,2090,43,40
1302,352,2,393,6,2096,1,60
1303,352,2,394,7,2103,1,70
1304,352,2,395,3,2106,1,30
1305,352,2,396,5,2111,1,50
1306,352,2,397,6,2117,1,60
1307,352,2,398,9,2126,1,90
1308,352,2,399,7,2133,1,70
1309,352,2,400,7,2140,1,70
1310,352,2,401,2,2142,1,20
1311,352,2,402,4,2146,1,40
1312,352,2,403,5,2151,1,50
1313,352,2,404,2,2153,1,20
1314,352,2,405,9,2162,1,90
1315,352,2,406,7,2169,1,70
1316,352,2,407,5,2174,1,50
1317,352,2,408,4,2178,1,40
1318,352,2,409,9,2187,1,90
1319,352,2,410,2,2189,1,20
1320,352,2,411,4,2193,1,40
1321,352,2,412,5,2198,1,50
1322,352,2,413,9,2207,1,90
1323,352,2,414,3,2210,1,30
1324,352,2,415,2,2212,1,20
1325,352,2,416,6,2218,1,60
1326,352,2,417,4,2222,1,40
1327,352,2,418,9,2231,1,90
1328,352,2,419,4,2235,1,40
1329,352,2,420,7,2242,1,70
1330,352,2,421,3,2245,1,30
1331,352,2,422,6,2251,1,60
1332,352,2,423,6,2257,34,60
1333,352,2,424,6,2263,1,60
1334,352,2,425,2,2265,1,20
1335,352,2,426,2,2267,1,20
1336,352,2,427,6,2273,1,60
1337,352,2,428,5,2278,1,50
1338,352,2,429,9,2287,1,90
1339,352,2,430,3,2290,1,30
1340,352,2,431,4,2294,1,40
1341,352,2,432,9,2303,1,90
1342,352,2,433,7,2310,1,70
1343,352,2,434,8,2318,1,80
1344,352,2,435,8,2326,1,80
1345,352,2,436,9,2335,1,90
1346,352,2,437,3,2338,1,30
1347,352,2,438,7,2345,1,70
1348,352,2,439,9,2354,1,90
1349,352,2,440,2,2356,1,20
1350,352,2,441,2,2358,1,20
1351,352,2,442,9,2367,1,90
1352,352,2,443,3,2370,1,30
1353,352,2,444,3,2373,1,30
1354,352,2,445,3,2376,1,30
1355,352,2,446,8,2384,1,80
1356,352,2,447,8,2392,1,80
1357,352,2,448,6,2398,1,60
1358,352,2,449,5,2403,1,50
1359,352,2,450,4,2407,1,40
1360,352,2,451,5,2412,1,50
1361,352,2,452,3,2415,1,30
1362,352,2,453,4,2419,1,40
1363,352,2,454,2,2421,1,20
1364,352,2,455,3,2424,1,30
1365,352,2,456,9,2433,1,90
1366,352,2,457,5,2438,1,50
1367,352,2,458,4,2442,1,40
1368,352,2,459,3,2445,1,30
1369,352,2,460,8,2453,51,80
1370,352,2,461,4,2457,1,40
1371,352,2,462,6,2463,1,60
1372,352,2,463,5,2468,1,50
1373,352,2,464,7,2475,1,70
1374,352,2,465,8,2483,1,80
1375,352,2,466,2,2485,1,20
1376,352,2,467,5,2490,1,50
1377,352,2,468,4,2494,1,40
1378,352,2,469,3,2497,1,30
1379,352,2,470,7,2504,1,70
1380,352,2,471,3,2507,1,30
1381,352,2,472,5,2512,37,50
1382,352,2,473,4,2516,1,40
1383,352,2,474,6,2522,1,60
1384,352,2,475,8,2530,1,80
1385,352,2,476,6,2536,1,60
1386,352,2,477,9,2545,1,90
1387,352,2,478,4,2549,1,40
1388,352,2,479,4,2553,1,40
1389,352,2,480,7,2560,1,70
1390,352,2,481,7,2567,1,70
1391,352,2,482,9,2576,1,90
1392,352,2,483,6,2582,1,60
1393,352,2,484,2,2584,1,20
1394,352,2,485,4,2588,1,40
1395,352,2,486,8,2596,1,80
1396,352,2,487,7,2603,1,70
1397,352,2,488,7,2610,1,70
1398,352,2,489,2,2612,1,20
1399,352,2,490,3,2615,1,30
1400,352,2,491,4,2619,1,40
1401,352,2,492,9,2628,1,90
1402,352,2,493,6,2634,1,60
1403,352,2,494,9,2643,1,90
1404,352,2,495,8,2651,1,80
1405,352,2,496,9,2660,1,90
1406,352,2,497,4,2664,1,40
1407,352,2,498,6,2670,1,60
1408,352,2,499,4,2674,1,40
1409,352,2,500,8,2682,1,80
1410,352,2,501,9,2691,62,90
1411,352,2,502,4,2695,1,40
1412,352,2,503,3,2698,1,30
1413,352,2,504,7,2705,1,70
1414,352,2,505,3,2708,1,30
1415,352,2,506,8,2716,1,80
1416,352,2,507,6,2722,1,60
1417,352,2,508,3,2725,1,30
1418,352,2,509,6,2731,1,60
1419,352,2,510,5,2736,1,50
1420,352,2,511,6,2742,1,60
1421,352,2,512,4,2746,1,40
1422,352,2,513,6,2752,1,60
1423,352,2,514,7,2759,1,70
1424,352,2,515,2,2761,1,20
1425,352,2,516,3,2764,1,30
1426,352,2,517,8,2772,1,80
1427,352,2,518,4,2776,1,40
1428,352,2,519,9,2785,1,90
1429,352,2,520,9,2794,1,90
1430,352,2,521,2,2796,1,20
1431,352,2,522,5,2801,32,50
1432,352,2,523,5,2806,1,50
1433,352,2,524,2,2808,1,20
1434,352,2,525,7,2815,1,70
1435,352,2,526,4,2819,1,40
1436,352,2,527,4,2823,1,40
1437,352,2,528,3,2826,1,30
1438,352,2,529,4,2830,1,40
1439,352,2,530,5,2835,1,50
1440,352,2,531,4,2839,1,40
1441,352,2,532,8,2847,1,80
1442,352,2,533,8,2855,1,80
1443,352,2,534,7,2862,1,70
1444,352,2,535,2,2864,1,20
1445,352,2,536,2,2866,1,20
1446,352,2,537,4,2870,1,40
1447,352,2,538,3,2873,1,30
1448,352,2,539,9,2882,1,90
1449,352,2,540,7,2889,1,70
1450,352,2,541,6,2895,1,60
1451,352,2,542,9,2904,1,90
1452,352,2,543,9,2913,1,90
1453,352,2,544,2,2915,1,20
1454,352,2,545,2,2917,1,20
1455,352,2,546,2,2919,1,20
1456,352,2,547,9,2928,1,90
1457,352,2,548,7,2935,1,70
1458,352,2,549,7,2942,1,70
1459,352,2,550,6,2948,1,60
1460,352,2,551,8,2956,1,80
1461,352,2,552,6,2962,1,60
1462,352,2,553,7,2969,1,70
1463,352,2,554,8,2977,1,80
1464,352,2,555,7,2984,48,70
1465,352,2,556,8,2992,1,80
1466,352,2,557,5,2997,1,50
1467,352,2,558,2,2999,1,20
1468,352,2,559,7,3006,1,70
1469,352,2,560,8,3014,1,80
1470,352,2,561,8,3022,1,80
1471,352,2,562,9,3031,1,90
1472,352,2,563,8,3039,1,80
1473,352,2,564,4,3043,1,40
1474,352,2,565,8,3051,1,80
1475,352,2,566,5,3056,1,50
1476,352,2,567,2,3058,1,20
1477,352,2,568,5,3063,1,50
1478,352,2,569,6,3069,1,60
1479,352,2,570,7,3076,1,70
1480,352,2,571,9,3085,1,90
1481,352,2,572,5,3090,59,50
1482,352,2,573,5,3095,1,50
1483,352,2,574,5,3100,30,50
1484,352,2,575,4,3104,1,40
1485,352,2,576,6,3110,1,60
1486,352,2,577,4,3114,1,40
1487,352,2,578,7,3121,1,70
1488,352,2,579,2,3123,1,20
1489,352,2,580,2,3125,1,20
1490,352,2,581,8,3133,1,80
1491,352,2,582,4,3137,1,40
1492,352,2,583,6,3143,1,60
1493,352,2,584,5,3148,1,50
1494,352,2,585,9,3157,1,90
1495,352,2,586,6,3163,1,60
1496,352,2,587,7,3170,1,70
1497,352,2,588,8,3178,1,80
1498,352,2,589,7,3185,1,70
1499,352,2,590,3,3188,1,30
1500,352,2,591,3,3191,1,30
1501,352,2,592,2,3193,1,20
1502,352,2,593,9,3202,1,90
1503,352,2,594,8,3210,1,80
1504,352,2,595,6,3216,1,60
1505,352,2,596,8,3224,1,80
1506,352,2,597,2,3226,1,20
1507,352,2,598,9,3235,1,90
1508,352,2,599,8,3243,1,80
1509,352,2,600,6,3249,1,60
1510,352,2,601,4,3253,1,40
1511,352,2,602,9,3262,1,90
1512,352,2,603,3,3265,1,30
1513,352,2,604,5,3270,1,50
1514,352,2,605,2,3272,1,20
1515,352,2,606,5,3277,1,50
1516,352,2,607,2,3279,1,20
1517,352,2,608,9,3288,1,90
1518,352,2,609,5,3293,1,50
1519,352,2,610,2,3295,1,20
1520,352,2,611,9,3304,1,90
1521,352,2,612,2,3306,1,20
1522,352,2,613,4,3310,47,40
1523,352,2,614,6,3316,1,60
1524,352,2,615,4,3320,1,40
1525,352,2,616,8,3328,1,80
1526,352,2,617,3,3331,1,30
1527,352,2,618,7,3338,1,70
1528,352,2,619,4,3342,1,40
1529,352,2,620,4,3346,1,40
1530,352,2,621,7,3353,1,70
1531,352,2,622,8,3361,1,80
1532,352,2,623,6,3367,1,60
1533,352,2,624,7,3374,1,70
1534,352,2,625,8,3382,1,80
1535,352,2,626,9,3391,1,90
1536,352,2,627,6,3397,1,60
1537,352,2,628,2,3399,1,20
1538,352,2,629,9,3408,1,90
1539,352,2,630,7,3415,1,70
1540,352,2,631,9,3424,1,90
1541,352,2,632,6,3430,1,60
1542,352,2,633,4,3434,1,40
1543,352,2,634,8,3442,1,80
1544,352,2,635,8,3450,1,80
1545,352,2,636,5,3455,1,50
1546,352,2,637,6,3461,1,60
1547,352,2,638,7,3468,1,70
1548,352,2,639,4,3472,1,40
1549,352,2,640,4,3476,58,40
1550,352,2,641,8,3484,1,80
1551,352,2,642,4,3488,1,40
1552,352,2,643,5,3493,1,50
1553,352,2,644,3,3496,1,30
1554,352,2,645,4,3500,1,40
1555,352,2,646,9,3509,1,90
1556,352,2,647,6,3515,1,60
1557,352,2,648,2,3517,1,20
1558,352,2,649,9,3526,1,90
1559,352,2,650,5,3531,1,50
1560,352,2,651,8,3539,1,80
1561,352,2,652,3,3542,1,30
1562,352,2,653,7,3549,1,70
1563,352,2,654,8,3557,1,80
1564,352,2,655,8,3565,1,80
1565,352,2,656,6,3571,1,60
1566,352,2,657,3,3574,1,30
1567,352,2,658,8,3582,33,80
1568,352,2,659,3,3585,1,30
1569,352,2,660,3,3588,1,30
1570,352,2,661,5,3593,1,50
1571,352,2,662,3,3596,1,30
1572,352,2,663,5,3601,1,50
1573,352,2,664,6,3607,1,60
1574,352,2,665,8,3615,1,80
1575,352,2,666,7,3622,1,70
1576,352,2,667,9,3631,1,90
1577,352,2,668,7,3638,1,70
1578,352,2,669,5,3643,1,50
1579,352,2,670,5,3648,1,50
1580,352,2,671,3,3651,1,30
1581,352,2,672,6,3657,1,60
1582,352,2,673,9,3666,1,90
1583,352,2,674,8,3674,1,80
1584,352,2,675,2,3676,43,20
1585,352,2,676,3,3679,1,30
1586,352,2,677,9,3688,1,90
1587,352,2,678,9,3697,1,90
1588,352,2,679,3,3700,1,30
1589,352,2,680,6,3706,1,60
1590,352,2,681,3,3709,1,30
1591,352,2,682,3,3712,1,30
1592,352,2,683,7,3719,1,70
1593,352,2,684,7,3726,1,70
1594,352,2,685,3,3729,1,30
1595,352,2,686,3,3732,1,30
1596,352,2,687,6,3738,1,60
1597,352,2,688,6,3744,1,60
1598,352,2,689,3,3747,1,30
1599,352,2,690,7,3754,1,70
1600,352,2,691,5,3759,1,50
1601,352,2,692,2,3761,1,20
1602,352,2,693,4,3765,1,40
1603,352,2,694,7,3772,1,70
1604,352,2,695,2,3774,1,20
1605,352,2,696,4,3778,1,40
1606,352,2,697,3,3781,1,30
1607,352,2,698,7,3788,1,70
1608,352,2,699,9,3797,49,90
1609,352,2,700,3,3800,1,30
1610,352,2,701,4,3804,18,40
1611,352,2,702,7,3811,1,70
1612,352,2,703,6,3817,1,60
1613,352,2,704,7,3824,1,70
1614,352,2,705,6,3830,1,60
1615,352,2,706,6,3836,1,60
1616,352,2,707,3,3839,1,30
1617,352,2,708,9,3848,1,90
1618,352,2,709,7,3855,1,70
1619,352,2,710,3,3858,1,30
1620,352,2,711,7,3865,1,70
1621,352,2,712,9,3874,1,90
1622,352,2,713,4,3878,1,40
1623,352,2,714,6,3884,1,60
1624,352,2,715,5,3889,1,50
1625,352,2,716,7,3896,1,70
1626,352,2,717,6,3902,1,60
1627,352,2,718,8,3910,1,80
1628,352,2,719,5,3915,1,50
1629,352,2,720,8,3923,1,80
1630,352,2,721,7,3930,1,70
1631,352,2,722,8,3938,36,80
1632,352,2,723,8,3946,1,80
1633,352,2,724,8,3954,1,80
1634,352,2,725,3,3957,1,30
1635,352,2,726,3,3960,1,30
1636,352,2,727,9,3969,1,90
1637,352,2,728,5,3974,1,50
1638,352,2,729,5,3979,1,50
1639,352,2,730,6,3985,1,60
1640,352,2,731,7,3992,1,70
1641,352,2,732,2,3994,1,20
1642,352,2,733,6,4000,1,60
1643,352,2,734,5,4005,1,50
1644,352,2,735,8,4013,19,80
1645,352,2,736,7,4020,1,70
1646,352,2,737,9,4029,1,90
1647,352,2,738,4,4033,1,40
1648,352,2,739,2,4035,1,20
1649,352,2,740,5,4040,1,50
1650,352,2,741,7,4047,1,70
1651,352,2,742,4,4051,1,40
1652,352,2,743,6,4057,1,60
1653,352,2,744,5,4062,1,50
1654,352,2,745,7,4069,1,70
1655,352,2,746,8,4077,1,80
1656,352,2,747,5,4082,1,50
1657,352,2,748,9,4091,1,90
1658,352,2,749,5,4096,1,50
1659,352,2,750,6,4102,1,60
1660,352,2,751,5,4107,1,50
1661,352,2,752,5,4112,1,50
1662,352,2,753,6,4118,1,60
1663,352,2,754,8,4126,1,80
1664,352,2,755,6,4132,1,60
1665,352,2,756,7,4139,1,70
1666,352,2,757,4,4143,1,40
1667,352,2,758,3,4146,1,30
1668,352,2,759,5,4151,1,50
1669,352,2,760,3,4154,1,30
1670,352,2,761,6,4160,1,60
1671,352,2,762,3,4163,1,30
1672,352,2,763,4,4167,1,40
1673,352,2,764,5,4172,1,50
1674,352,2,765,3,4175,1,30
1675,352,2,766,4,4179,1,40
1676,352,2,767,9,4188,1,90
1677,352,2,768,5,4193,1,50
1678,352,2,769,2,4195,1,20
1679,352,2,770,8,4203,1,80
1680,352,2,771,7,4210,1,70
1681,352,2,772,2,4212,1,20
1682,352,2,773,7,4219,1,70
1683,352,2,774,3,4222,1,30
1684,352,2,775,2,4224,1,20
1685,352,2,776,5,4229,1,50
1686,352,2,777,3,4232,1,30
1687,352,2,778,3,4235,44,30
1688,352,2,779,7,4242,1,70
1689,352,2,780,2,4244,1,20
1690,352,2,781,2,4246,19,20
1691,352,2,782,6,4252,1,60
1692,352,2,783,2,4254,1,20
1693,352,2,784,4,4258,1,40
1694,352,2,785,7,4265,1,70
1695,352,2,786,6,4271,1,60
1696,352,2,787,6,4277,1,60
1697,352,2,788,9,4286,20,90
1698,352,2,789,7,4293,1,70
1699,352,2,790,8,4301,1,80
1700,352,2,791,4,4305,1,40
1701,352,2,792,6,4311,1,60
1702,352,2,793,5,4316,1,50
1703,352,2,794,2,4318,1,20
1704,352,2,795,9,4327,1,90
1705,352,2,796,8,4335,1,80
1706,352,2,797,8,4343,1,80
1707,352,2,798,6,4349,1,60
1708,352,2,799,6,4355,1,60
1709,352,2,800,6,4361,1,60
1710,352,2,801,7,4368,1,70
1711,352,2,802,9,4377,1,90
1712,352,2,803,7,4384,1,70
1713,352,2,804,8,4392,1,80
1714,352,2,805,5,4397,1,50
1715,352,2,806,5,4402,1,50
1716,352,2,807,7,4409,1,70
1717,352,2,808,5,4414,1,50
1718,352,2,809,8,4422,1,80
1719,352,2,810,4,4426,1,40
1720,352,2,811,7,4433,1,70
1721,352,2,812,7,4440,1,70
1722,352,2,813,2,4442,1,20
1723,352,2,814,5,4447,1,50
1724,352,2,815,9,4456,1,90
1725,352,2,816,4,4460,1,40
1726,352,2,817,9,4469,1,90
1727,352,2,818,6,4475,1,60
1728,352,2,819,8,4483,1,80
1729,352,2,820,4,4487,1,40
1730,352,2,821,4,4491,1,40
1731,352,2,822,7,4498,1,70
1732,352,2,823,2,4500,1,20
1733,352,2,824,3,4503,1,30
1734,352,2,825,3,4506,1,30
1735,352,2,826,9,4515,1,90
1736,352,2,827,7,4522,46,70
1737,352,2,828,8,4530,1,80
1738,352,2,829,8,4538,31,80
1739,352,2,830,6,4544,1,60
1740,352,2,831,9,4553,1,90
1741,352,2,832,5,4558,1,50
1742,352,2,833,6,4564,1,60
1743,352,2,834,8,4572,1,80
1744,352,2,835,8,4580,1,80
1745,352,2,836,8,4588,1,80
1746,352,2,837,4,4592,1,40
1747,352,2,838,2,4594,1,20
1748,352,2,839,6,4600,1,60
1749,352,2,840,9,4609,1,90
1750,352,2,841,9,4618,1,90
1751,352,2,842,6,4624,1,60
1752,352,2,843,7,4631,1,70
1753,352,2,844,3,4634,1,30
1754,352,2,845,3,4637,1,30
1755,352,2,846,4,4641,1,40
1756,352,2,847,5,4646,1,50
1757,352,2,848,3,4649,1,30
1758,352,2,849,5,4654,1,50
1759,352,2,850,7,4661,1,70
1760,352,2,851,5,4666,1,50
1761,352,2,852,5,4671,1,50
1762,352,2,853,4,4675,1,40
1763,352,2,854,5,4680,1,50
1764,352,2,855,9,4689,1,90
1765,352,2,856,7,4696,1,70
1766,352,2,857,7,4703,1,70
1767,352,2,858,3,4706,1,30
1768,352,2,859,6,4712,1,60
1769,352,2,860,5,4717,1,50
1770,352,2,861,9,4726,1,90
1771,352,2,862,5,4731,1,50
1772,352,2,863,5,4736,1,50
1773,352,2,864,6,4742,55,60
1774,352,2,865,2,4744,20,20
1775,352,2,866,4,4748,1,40
1776,352,2,867,4,4752,1,40
1777,352,2,868,2,4754,1,20
1778,352,2,869,9,4763,1,90
1779,352,2,870,3,4766,1,30
1780,352,2,871,9,4775,26,90
1781,352,2,872,3,4778,1,30
1782,352,2,873,6,4784,1,60
1783,352,2,874,7,4791,1,70
1784,352,2,875,9,4800,1,90
1785,352,2,876,3,4803,1,30
1786,352,2,877,7,4810,1,70
1787,352,2,878,8,4818,22,80
1788,352,2,879,2,4820,1,20
1789,352,2,880,9,4829,1,90
1790,352,2,881,7,4836,1,70
1791,352,2,882,9,4845,1,90
1792,352,2,883,4,4849,1,40
1793,352,2,884,2,4851,1,20
1794,352,2,885,5,4856,1,50
1795,352,2,886,6,4862,1,60
1796,352,2,887,4,4866,1,40
1797,352,2,888,4,4870,1,40
1798,352,2,889,4,4874,1,40
1799,352,2,890,3,4877,1,30
1800,352,2,891,9,4886,1,90
1801,352,2,892,5,4891,1,50
1802,352,2,893,7,4898,1,70
1803,352,2,894,4,4902,14,40
1804,352,2,895,5,4907,1,50
1805,352,2,896,3,4910,1,30
1806,352,2,897,7,4917,1,70
1807,352,2,898,9,4926,1,90
1808,352,2,899,6,4932,1,60
1809,352,2,900,8,4940,1,80
1810,352,2,901,8,4948,1,80
1811,352,2,902,6,4954,1,60
1812,352,2,903,3,4957,1,30
1813,352,2,904,6,4963,1,60
1814,352,2,905,8,4971,1,80
1815,352,2,906,5,4976,1,50
1816,352,2,907,4,4980,1,40
1817,352,2,908,3,4983,1,30
1818,352,2,909,2,4985,1,20
1819,352,2,910,6,4991,1,60
1820,352,2,911,3,4994,1,30
1821,352,2,912,2,4996,1,20
1822,352,3,1,4,4,1,40
1823,352,3,2,2,6,1,20
1824,352,3,3,3,9,1,30
1825,352,3,4,9,18,1,90
1826,352,3,5,7,25,1,70
1827,352,3,6,5,30,1,50
1828,352,3,7,2,32,1,20
1829,352,3,8,5,37,1,50
1830,352,3,9,5,42,1,50
1831,352,3,10,6,48,1,60
1832,352,3,11,7,55,1,70
1833,352,3,12,8,63,1,80
1834,352,3,13,3,66,1,30
1835,352,3,14,4,70,1,40
1836,352,3,15,9,79,1,90
1837,352,3,16,2,81,1,20
1838,352,3,17,7,88,1,70
1839,352,3,18,7,95,1,70
1840,352,3,19,9,104,1,90
1841,352,3,20,9,113,23,90
1842,352,3,21,8,121,1,80
1843,352,3,22,9,130,1,90
1844,352,3,23,7,137,1,70
1845,352,3,24,3,140,1,30
1846,352,3,25,8,148,10,80
1847,352,3,26,3,151,1,30
1848,352,3,27,5,156,1,50
1849,352,3,28,4,160,1,40
1850,352,3,29,7,167,1,70
1851,352,3,30,7,174,6,70
1852,352,3,31,8,182,1,80
1853,352,3,32,9,191,1,90
1854,352,3,33,7,198,1,70
1855,352,3,34,8,206,1,80
1856,352,3,35,7,213,1,70
1857,352,3,36,2,215,1,20
1858,352,3,37,3,218,1,30
1859,352,3,38,5,223,1,50
1860,352,3,39,7,230,1,70
1861,352,3,40,8,238,16,80
1862,352,3,41,3,241,1,30
1863,352,3,42,9,250,1,90
1864,352,3,43,8,258,1,80
1865,352,3,44,9,267,1,90
1866,352,3,45,3,270,1,30
1867,352,3,46,4,274,1,40
1868,352,3,47,9,283,1,90
1869,352,3,48,7,290,1,70
1870,352,3,49,7,297,1,70
1871,352,3,50,3,300,1,30
1872,352,3,51,5,305,1,50
1873,352,3,52,4,309,1,40
1874,352,3,53,7,316,1,70
1875,352,3,54,6,322,1,60
1876,352,3,55,6,328,1,60
1877,352,3,56,2,330,1,20
1878,352,3,57,4,334,1,40
1879,352,3,58,6,340,1,60
1880,352,3,59,8,348,1,80
1881,352,3,60,8,356,1,80
1882,352,3,61,3,359,1,30
1883,352,3,62,8,367,1,80
1884,352,3,63,4,371,1,40
1885,352,3,64,6,377,1,60
1886,352,3,65,4,381,1,40
1887,352,3,66,9,390,27,90
1888,352,3,67,2,392,1,20
1889,352,3,68,7,399,1,70
1890,352,3,69,9,408,1,90
1891,352,3,70,7,415,1,70
1892,352,3,71,2,417,1,20
1893,352,3,72,4,421,1,40
1894,352,3,73,4,425,1,40
1895,352,3,74,6,431,1,60
1896,352,3,75,8,439,1,80
1897,352,3,76,8,447,1,80
1898,352,3,77,9,456,1,90
1899,352,3,78,9,465,23,90
1900,352,3,79,3,468,1,30
1901,352,3,80,2,470,1,20
1902,352,3,81,5,475,22,50
1903,352,3,82,5,480,1,50
1904,352,3,83,6,486,1,60
1905,352,3,84,2,488,1,20
1906,352,3,85,4,492,1,40
1907,352,3,86,3,495,1,30
1908,352,3,87,5,500,1,50
1909,352,3,88,5,505,1,50
1910,352,3,89,9,514,1,90
1911,352,3,90,7,521,1,70
1912,352,3,91,5,526,1,50
1913,352,3,92,8,534,1,80
1914,352,3,93,9,543,1,90
1915,352,3,94,9,552,1,90
1916,352,3,95,3,555,1,30
1917,352,3,96,2,557,1,20
1918,352,3,97,8,565,1,80
1919,352,3,98,8,573,1,80
1920,352,3,99,2,575,1,20
1921,352,3,100,3,578,1,30
1922,352,3,101,8,586,1,80
1923,352,3,102,5,591,1,50
1924,352,3,103,7,598,1,70
1925,352,3,104,5,603,1,50
1926,352,3,105,9,612,1,90
1927,352,3,106,8,620,1,80
1928,352,3,107,7,627,1,70
1929,352,3,108,3,630,1,30
1930,352,3,109,4,634,1,40
1931,352,3,110,4,638,1,40
1932,352,3,111,5,643,1,50
1933,352,3,112,5,648,1,50
1934,352,3,113,9,657,1,90
1935,352,3,114,2,659,1,20
1936,352,3,115,5,664,1,50
1937,352,3,116,2,666,1,20
1938,352,3,117,5,671,1,50
1939,352,3,118,9,680,1,90
1940,352,3,119,9,689,1,90
1941,352,3,120,4,693,40,40
1942,352,3,121,6,699,24,60
1943,352,3,122,2,701,1,20
1944,352,3,123,7,708,1,70
1945,352,3,124,8,716,1,80
1946,352,3,125,6,722,1,60
1947,352,3,126,7,729,1,70
1948,352,3,127,9,738,1,90
1949,352,3,128,3,741,1,30
1950,352,3,129,8,749,1,80
1951,352,3,130,3,752,1,30
1952,352,3,131,5,757,1,50
1953,352,3,132,4,761,1,40
1954,352,3,133,3,764,1,30
1955,352,3,134,3,767,1,30
1956,352,3,135,9,776,21,90
1957,352,3,136,2,778,1,20
1958,352,3,137,6,784,1,60
1959,352,3,138,7,791,1,70
1960,352,3,139,5,796,1,50
1961,352,3,140,7,803,1,70
1962,352,3,141,7,810,1,70
1963,352,3,142,7,817,1,70
1964,352,3,143,2,819,1,20
1965,352,3,144,7,826,1,70
1966,352,3,145,3,829,1,30
1967,352,3,146,3,832,1,30
1968,352,3,147,8,840,1,80
1969,352,3,148,4,844,1,40
1970,352,3,149,8,852,1,80
1971,352,3,150,3,855,1,30
1972,352,3,151,4,859,1,40
1973,352,3,152,4,863,1,40
1974,352,3,153,6,869,1,60
1975,352,3,154,3,872,1,30
1976,352,3,155,5,877,1,50
1977,352,3,156,8,885,1,80
1978,352,3,157,5,890,1,50
1979,352,3,158,3,893,1,30
1980,352,3,159,6,899,1,60
1981,352,3,160,7,906,1,70
1982,352,3,161,5,911,1,50
1983,352,3,162,8,919,1,80
1984,352,3,163,5,924,1,50
1985,352,3,164,7,931,1,70
1986,352,3,165,8,939,1,80
1987,352,3,166,4,943,34,40
1988,352,3,167,8,951,1,80
1989,352,3,168,2,953,25,20
1990,352,3,169,7,960,1,70
1991,352,3,170,3,963,1,30
1992,352,3,171,5,968,1,50
1993,352,3,172,2,970,1,20
1994,352,3,173,7,977,1,70
1995,352,3,174,6,983,1,60
1996,352,3,175,7,990,1,70
1997,352,3,176,6,996,1,60
1998,352,3,177,7,1003,1,70
1999,352,3,178,2,1005,1,20
2000,352,3,179,4,1009,1,40
2001,352,3,180,2,1011,1,20
2002,352,3,181,9,1020,1,90
2003,352,3,182,6,1026,21,60
2004,352,3,183,7,1033,1,70
2005,352,3,184,7,1040,1,70
2006,352,3,185,6,1046,1,60
2007,352,3,186,7,1053,1,70
2008,352,3,187,6,1059,1,60
2009,352,3,188,8,1067,1,80
2010,352,3,189,9,1076,1,90
2011,352,3,190,2,1078,1,20
2012,352,3,191,5,1083,1,50
2013,352,3,192,3,1086,1,30
2014,352,3,193,6,1092,1,60
2015,352,3,194,8,1100,22,80
2016,352,3,195,4,1104,1,40
2017,352,3,196,2,1106,1,20
2018,352,3,197,4,1110,1,40
2019,352,3,198,4,1114,1,40
2020,352,3,199,6,1120,1,60
2021,352,3,200,7,1127,1,70
2022,352,3,201,3,1130,1,30
2023,352,3,202,2,1132,1,20
2024,352,3,203,6,1138,1,60
2025,352,3,204,4,1142,1,40
2026,352,3,205,4,1146,1,40
2027,352,3,206,6,1152,1,60
2028,352,3,207,3,1155,1,30
2029,352,3,208,6,1161,1,60
2030,352,3,209,8,1169,1,80
2031,352,3,210,6,1175,1,60
2032,352,3,211,9,1184,1,90
2033,352,3,212,3,1187,1,30
2034,352,3,213,5,1192,1,50
2035,352,3,214,4,1196,1,40
2036,352,3,215,7,1203,1,70
2037,352,3,216,5,1208,1,50
2038,352,3,217,5,1213,1,50
2039,352,3,218,7,1220,1,70
2040,352,3,219,4,1224,1,40
2041,352,3,220,9,1233,1,90
2042,352,3,221,6,1239,1,60
2043,352,3,222,4,1243,1,40
2044,352,3,223,6,1249,1,60
2045,352,3,224,4,1253,1,40
2046,352,3,225,8,1261,1,80
2047,352,3,226,8,1269,1,80
2048,352,3,227,5,1274,1,50
2049,352,3,228,6,1280,1,60
2050,352,3,229,4,1284,1,40
2051,352,3,230,5,1289,1,50
2052,352,3,231,2,1291,1,20
2053,352,3,232,8,1299,48,80
2054,352,3,233,3,1302,1,30
2055,352,3,234,4,1306,1,40
2056,352,3,235,4,1310,1,40
2057,352,3,236,5,1315,1,50
2058,352,3,237,5,1320,1,50
2059,352,3,238,3,1323,1,30
2060,352,3,239,8,1331,1,80
2061,352,3,240,6,1337,1,60
2062,352,3,241,4,1341,1,40
2063,352,3,242,6,1347,1,60
2064,352,3,243,9,1356,1,90
2065,352,3,244,3,1359,1,30
2066,352,3,245,7,1366,1,70
2067,352,3,246,9,1375,1,90
2068,352,3,247,2,1377,1,20
2069,352,3,248,4,1381,1,40
2070,352,3,249,4,1385,1,40
2071,352,3,250,7,1392,1,70
2072,352,3,251,3,1395,1,30
2073,352,3,252,9,1404,1,90
2074,352,3,253,8,1412,1,80
2075,352,3,254,3,1415,1,30
2076,352,3,255,5,1420,1,50
2077,352,3,256,7,1427,1,70
2078,352,3,257,2,1429,1,20
2079,352,3,258,7,1436,1,70
2080,352,3,259,5,1441,1,50
2081,352,3,260,7,1448,1,70
2082,352,3,261,9,1457,1,90
2083,352,3,262,8,1465,1,80
2084,352,3,263,6,1471,1,60
2085,352,3,264,8,1479,1,80
2086,352,3,265,8,1487,1,80
2087,352,3,266,2,1489,1,20
2088,352,3,267,6,1495,1,60
2089,352,3,268,4,1499,1,40
2090,352,3,269,7,1506,70,70
2091,352,3,270,4,1510,1,40
2092,352,3,271,5,1515,1,50
2093,352,3,272,6,1521,1,60
2094,352,3,273,7,1528,1,70
2095,352,3,274,7,1535,1,70
2096,352,3,275,3,1538,1,30
2097,352,3,276,9,1547,1,90
2098,352,3,277,5,1552,1,50
2099,352,3,278,6,1558,1,60
2100,352,3,279,4,1562,1,40
2101,352,3,280,5,1567,33,50
2102,352,3,281,4,1571,27,40
2103,352,3,282,9,1580,1,90
2104,352,3,283,3,1583,1,30
2105,352,3,284,8,1591,1,80
2106,352,3,285,5,1596,1,50
2107,352,3,286,9,1605,1,90
2108,352,3,287,9,1614,1,90
2109,352,3,288,7,1621,1,70
2110,352,3,289,8,1629,1,80
2111,352,3,290,4,1633,1,40
2112,352,3,291,3,1636,1,30
2113,352,3,292,9,1645,1,90
2114,352,3,293,2,1647,1,20
2115,352,3,294,9,1656,1,90
2116,352,3,295,8,1664,1,80
2117,352,3,296,8,1672,1,80
2118,352,3,297,9,1681,1,90
2119,352,3,298,5,1686,1,50
2120,352,3,299,4,1690,1,40
2121,352,3,300,5,1695,1,50
2122,352,3,301,4,1699,1,40
2123,352,3,302,9,1708,1,90
2124,352,3,303,2,1710,1,20
2125,352,3,304,5,1715,1,50
2126,352,3,305,9,1724,1,90
2127,352,3,306,5,1729,1,50
2128,352,3,307,7,1736,1,70
2129,352,3,308,3,1739,1,30
2130,352,3,309,8,1747,1,80
2131,352,3,310,8,1755,1,80
2132,352,3,311,6,1761,36,60
2133,352,3,312,9,1770,1,90
2134,352,3,313,7,1777,1,70
2135,352,3,314,8,1785,19,80
2136,352,3,315,5,1790,1,50
2137,352,3,316,4,1794,1,40
2138,352,3,317,9,1803,1,90
2139,352,3,318,2,1805,1,20
2140,352,3,319,9,1814,1,90
2141,352,3,320,5,1819,1,50
2142,352,3,321,3,1822,1,30
2143,352,3,322,9,1831,1,90
2144,352,3,323,8,1839,1,80
2145,352,3,324,2,1841,1,20
2146,352,3,325,8,1849,1,80
2147,352,3,326,4,1853,1,40
2148,352,3,327,6,1859,1,60
2149,352,3,328,4,1863,1,40
2150,352,3,329,2,1865,1,20
2151,352,3,330,5,1870,1,50
2152,352,3,331,5,1875,1,50
2153,352,3,332,7,1882,1,70
2154,352,3,333,8,1890,1,80
2155,352,3,334,4,1894,1,40
2156,352,3,335,2,1896,1,20
2157,352,3,336,4,1900,1,40
2158,352,3,337,7,1907,1,70
2159,352,3,338,2,1909,1,20
2160,352,3,339,2,1911,1,20
2161,352,3,340,7,1918,1,70
2162,352,3,341,5,1923,1,50
2163,352,3,342,6,1929,1,60
2164,352,3,343,8,1937,1,80
2165,352,3,344,4,1941,1,40
2166,352,3,345,7,1948,1,70
2167,352,3,346,9,1957,1,90
2168,352,3,347,5,1962,1,50
2169,352,3,348,7,1969,1,70
2170,352,3,349,4,1973,1,40
2171,352,3,350,2,1975,1,20
2172,352,3,351,3,1978,1,30
2173,352,3,352,3,1981,1,30
2174,352,3,353,5,1986,1,50
2175,352,3,354,9,1995,1,90
2176,352,3,355,7,2002,1,70
2177,352,3,356,2,2004,1,20
2178,352,3,357,4,2008,1,40
2179,352,3,358,8,2016,1,80
2180,352,3,359,8,2024,1,80
2181,352,3,360,3,2027,1,30
2182,352,3,361,3,2030,1,30
2183,352,3,362,3,2033,1,30
2184,352,3,363,2,2035,32,20
2185,352,3,364,2,2037,1,20
2186,352,3,365,8,2045,1,80
2187,352,3,366,9,2054,1,90
2188,352,3,367,9,2063,1,90
2189,352,3,368,2,2065,1,20
2190,352,3,369,7,2072,1,70
2191,352,3,370,3,2075,1,30
2192,352,3,371,8,2083,1,80
2193,352,3,372,7,2090,1,70
2194,352,3,373,7,2097,1,70
2195,352,3,374,2,2099,1,20
2196,352,3,375,6,2105,1,60
2197,352,3,376,3,2108,1,30
2198,352,3,377,7,2115,1,70
2199,352,3,378,2,2117,1,20
2200,352,3,379,2,2119,1,20
2201,352,3,380,7,2126,1,70
2202,352,3,381,4,2130,1,40
2203,352,3,382,8,2138,1,80
2204,352,3,383,3,2141,1,30
2205,352,3,384,6,2147,1,60
2206,352,3,385,5,2152,1,50
2207,352,3,386,7,2159,1,70
2208,352,3,387,6,2165,1,60
2209,352,3,388,8,2173,41,80
2210,352,3,389,9,2182,1,90
2211,352,3,390,4,2186,23,40
2212,352,3,391,5,2191,1,50
2213,352,3,392,3,2194,11,30
2214,352,3,393,6,2200,1,60
2215,352,3,394,4,2204,1,40
2216,352,3,395,3,2207,1,30
2217,352,3,396,5,2212,1,50
2218,352,3,397,7,2219,1,70
2219,352,3,398,2,2221,1,20
2220,352,3,399,9,2230,1,90
2221,352,3,400,7,2237,1,70
2222,352,3,401,6,2243,1,60
2223,352,3,402,4,2247,1,40
2224,352,3,403,6,2253,1,60
2225,352,3,404,9,2262,21,90
2226,352,3,405,7,2269,1,70
2227,352,3,406,3,2272,1,30
2228,352,3,407,6,2278,1,60
2229,352,3,408,3,2281,1,30
2230,352,3,409,9,2290,1,90
2231,352,3,410,6,2296,20,60
2232,352,3,411,7,2303,1,70
2233,352,3,412,4,2307,1,40
2234,352,3,413,4,2311,1,40
2235,352,3,414,4,2315,1,40
2236,352,3,415,3,2318,1,30
2237,352,3,416,6,2324,1,60
2238,352,3,417,4,2328,1,40
2239,352,3,418,9,2337,1,90
2240,352,3,419,2,2339,1,20
2241,352,3,420,6,2345,1,60
2242,352,3,421,5,2350,1,50
2243,352,3,422,3,2353,1,30
2244,352,3,423,7,2360,1,70
2245,352,3,424,4,2364,1,40
2246,352,3,425,6,2370,1,60
2247,352,3,426,8,2378,1,80
2248,352,3,427,9,2387,1,90
2249,352,3,428,4,2391,1,40
2250,352,3,429,8,2399,1,80
2251,352,3,430,9,2408,1,90
2252,352,3,431,4,2412,1,40
2253,352,3,432,2,2414,1,20
2254,352,3,433,6,2420,1,60
2255,352,3,434,8,2428,1,80
2256,352,3,435,9,2437,1,90
2257,352,3,436,9,2446,1,90
2258,352,3,437,7,2453,1,70
2259,352,3,438,4,2457,1,40
2260,352,3,439,8,2465,1,80
2261,352,3,440,3,2468,1,30
2262,352,3,441,9,2477,1,90
2263,352,3,442,5,2482,1,50
2264,352,3,443,3,2485,1,30
2265,352,3,444,9,2494,1,90
2266,352,3,445,7,2501,1,70
2267,352,3,446,5,2506,1,50
2268,352,3,447,8,2514,1,80
2269,352,3,448,3,2517,1,30
2270,352,3,449,9,2526,1,90
2271,352,3,450,8,2534,1,80
2272,352,3,451,7,2541,1,70
2273,352,3,452,7,2548,1,70
2274,352,3,453,5,2553,1,50
2275,352,3,454,4,2557,50,40
2276,352,3,455,3,2560,1,30
2277,352,3,456,4,2564,1,40
2278,352,3,457,8,2572,1,80
2279,352,3,458,7,2579,1,70
2280,352,3,459,3,2582,1,30
2281,352,3,460,3,2585,1,30
2282,352,3,461,4,2589,1,40
2283,352,3,462,2,2591,1,20
2284,352,3,463,5,2596,1,50
2285,352,3,464,8,2604,1,80
2286,352,3,465,5,2609,1,50
2287,352,3,466,9,2618,1,90
2288,352,3,467,3,2621,1,30
2289,352,3,468,6,2627,1,60
2290,352,3,469,2,2629,1,20
2291,352,3,470,2,2631,1,20
2292,352,3,471,2,2633,1,20
2293,352,3,472,9,2642,1,90
2294,352,3,473,7,2649,1,70
2295,352,3,474,7,2656,1,70
2296,352,3,475,5,2661,1,50
2297,352,3,476,9,2670,1,90
2298,352,3,477,8,2678,1,80
2299,352,3,478,4,2682,1,40
2300,352,3,479,3,2685,36,30
2301,352,3,480,5,2690,1,50
2302,352,3,481,3,2693,1,30
2303,352,3,482,9,2702,1,90
2304,352,3,483,2,2704,1,20
2305,352,3,484,8,2712,1,80
2306,352,3,485,6,2718,1,60
2307,352,3,486,6,2724,1,60
2308,352,3,487,9,2733,1,90
2309,352,3,488,6,2739,1,60
2310,352,3,489,3,2742,1,30
2311,352,3,490,5,2747,1,50
2312,352,3,491,4,2751,1,40
2313,352,3,492,5,2756,1,50
2314,352,3,493,2,2758,1,20
2315,352,3,494,6,2764,1,60
2316,352,3,495,6,2770,1,60
2317,352,3,496,8,2778,1,80
2318,352,3,497,4,2782,1,40
2319,352,3,498,4,2786,1,40
2320,352,3,499,7,2793,1,70
2321,352,3,500,6,2799,1,60
2322,352,3,501,9,2808,1,90
2323,352,3,502,9,2817,1,90
2324,352,3,503,9,2826,1,90
2325,352,3,504,8,2834,1,80
2326,352,3,505,7,2841,52,70
2327,352,3,506,4,2845,1,40
2328,352,3,507,3,2848,1,30
2329,352,3,508,9,2857,1,90
2330,352,3,509,3,2860,1,30
2331,352,3,510,8,2868,1,80
2332,352,3,511,3,2871,1,30
2333,352,3,512,3,2874,1,30
2334,352,3,513,7,2881,1,70
2335,352,3,514,6,2887,1,60
2336,352,3,515,8,2895,1,80
2337,352,3,516,6,2901,1,60
2338,352,3,517,4,2905,1,40
2339,352,3,518,6,2911,1,60
2340,352,3,519,7,2918,1,70
2341,352,3,520,9,2927,1,90
2342,352,3,521,6,2933,1,60
2343,352,3,522,3,2936,1,30
2344,352,3,523,7,2943,1,70
2345,352,3,524,6,2949,38,60
2346,352,3,525,7,2956,1,70
2347,352,3,526,3,2959,1,30
2348,352,3,527,3,2962,1,30
2349,352,3,528,7,2969,1,70
2350,352,3,529,4,2973,1,40
2351,352,3,530,3,2976,1,30
2352,352,3,531,4,2980,1,40
2353,352,3,532,6,2986,1,60
2354,352,3,533,4,2990,1,40
2355,352,3,534,3,2993,1,30
2356,352,3,535,4,2997,1,40
2357,352,3,536,7,3004,1,70
2358,352,3,537,5,3009,1,50
2359,352,3,538,2,3011,1,20
2360,352,3,539,2,3013,27,20
2361,352,3,540,3,3016,1,30
2362,352,3,541,7,3023,1,70
2363,352,3,542,5,3028,1,50
2364,352,3,543,5,3033,1,50
2365,352,3,544,7,3040,1,70
2366,352,3,545,2,3042,1,20
2367,352,3,546,5,3047,1,50
2368,352,3,547,7,3054,1,70
2369,352,3,548,9,3063,1,90
2370,352,3,549,3,3066,16,30
2371,352,3,550,7,3073,1,70
2372,352,3,551,4,3077,1,40
2373,352,3,552,6,3083,1,60
2374,352,3,553,5,3088,1,50
2375,352,3,554,6,3094,1,60
2376,352,3,555,7,3101,1,70
2377,352,3,556,4,3105,1,40
2378,352,3,557,5,3110,1,50
2379,352,3,558,9,3119,1,90
2380,352,3,559,4,3123,1,40
2381,352,3,560,4,3127,1,40
2382,352,3,561,2,3129,1,20
2383,352,3,562,3,3132,1,30
2384,352,3,563,3,3135,1,30
2385,352,3,564,7,3142,1,70
2386,352,3,565,8,3150,1,80
2387,352,3,566,6,3156,1,60
2388,352,3,567,7,3163,1,70
2389,352,3,568,6,3169,1,60
2390,352,3,569,3,3172,1,30
2391,352,3,570,3,3175,1,30
2392,352,3,571,9,3184,1,90
2393,352,3,572,9,3193,28,90
2394,352,3,573,9,3202,1,90
2395,352,3,574,2,3204,1,20
2396,352,3,575,3,3207,1,30
2397,352,3,576,4,3211,1,40
2398,352,3,577,5,3216,1,50
2399,352,3,578,6,3222,1,60
2400,352,3,579,3,3225,1,30
2401,352,3,580,2,3227,20,20
2402,352,3,581,2,3229,8,20
2403,352,3,582,8,3237,1,80
2404,352,3,583,6,3243,1,60
2405,352,3,584,6,3249,1,60
2406,352,3,585,8,3257,1,80
2407,352,3,586,9,3266,1,90
2408,352,3,587,9,3275,1,90
2409,352,3,588,9,3284,1,90
2410,352,3,589,9,3293,1,90
2411,352,3,590,3,3296,1,30
2412,352,3,591,3,3299,1,30
2413,352,3,592,6,3305,1,60
2414,352,3,593,6,3311,1,60
2415,352,3,594,6,3317,1,60
2416,352,3,595,3,3320,1,30
2417,352,3,596,3,3323,1,30
2418,352,3,597,5,3328,1,50
2419,352,3,598,5,3333,1,50
2420,352,3,599,9,3342,1,90
2421,352,3,600,2,3344,1,20
2422,352,3,601,4,3348,1,40
2423,352,3,602,8,3356,1,80
2424,352,3,603,4,3360,1,40
2425,352,3,604,5,3365,1,50
2426,352,3,605,2,3367,1,20
2427,352,3,606,8,3375,1,80
2428,352,3,607,2,3377,1,20
2429,352,3,608,2,3379,1,20
2430,352,3,609,5,3384,1,50
2431,352,3,610,8,3392,1,80
2432,352,3,611,3,3395,1,30
2433,352,3,612,4,3399,1,40
2434,352,3,613,2,3401,1,20
2435,352,3,614,7,3408,1,70
2436,352,3,615,2,3410,1,20
2437,352,3,616,5,3415,1,50
2438,352,3,617,4,3419,1,40
2439,352,3,618,6,3425,1,60
2440,352,3,619,4,3429,38,40
2441,352,3,620,9,3438,1,90
2442,352,3,621,7,3445,1,70
2443,352,3,622,2,3447,1,20
2444,352,3,623,2,3449,1,20
2445,352,3,624,9,3458,1,90
2446,352,3,625,5,3463,1,50
2447,352,3,626,9,3472,1,90
2448,352,3,627,5,3477,1,50
2449,352,3,628,7,3484,1,70
2450,352,3,629,4,3488,1,40
2451,352,3,630,3,3491,1,30
2452,352,3,631,6,3497,1,60
2453,352,3,632,4,3501,1,40
2454,352,3,633,5,3506,1,50
2455,352,3,634,7,3513,1,70
2456,352,3,635,7,3520,1,70
2457,352,3,636,8,3528,1,80
2458,352,3,637,7,3535,1,70
2459,352,3,638,4,3539,1,40
2460,352,3,639,9,3548,1,90
2461,352,3,640,9,3557,1,90
2462,352,3,641,9,3566,1,90
2463,352,3,642,3,3569,1,30
2464,352,3,643,8,3577,1,80
2465,352,3,644,8,3585,1,80
2466,352,3,645,9,3594,1,90
2467,352,3,646,2,3596,1,20
2468,352,3,647,3,3599,1,30
2469,352,3,648,4,3603,1,40
2470,352,3,649,7,3610,1,70
2471,352,3,650,4,3614,1,40
2472,352,3,651,7,3621,1,70
2473,352,3,652,4,3625,51,40
2474,352,3,653,9,3634,1,90
2475,352,3,654,4,3638,1,40
2476,352,3,655,5,3643,1,50
2477,352,3,656,7,3650,1,70
2478,352,3,657,9,3659,1,90
2479,352,3,658,9,3668,1,90
2480,352,3,659,9,3677,1,90
2481,352,3,660,6,3683,1,60
2482,352,3,661,2,3685,1,20
2483,352,3,662,7,3692,1,70
2484,352,3,663,5,3697,1,50
2485,352,3,664,2,3699,1,20
2486,352,3,665,3,3702,29,30
2487,352,3,666,5,3707,1,50
2488,352,3,667,3,3710,1,30
2489,352,3,668,6,3716,1,60
2490,352,3,669,4,3720,1,40
2491,352,3,670,3,3723,1,30
2492,352,3,671,5,3728,1,50
2493,352,3,672,3,3731,1,30
2494,352,3,673,4,3735,26,40
2495,352,3,674,6,3741,1,60
2496,352,3,675,2,3743,1,20
2497,352,3,676,6,3749,1,60
2498,352,3,677,4,3753,1,40
2499,352,3,678,3,3756,1,30
2500,352,3,679,3,3759,1,30
2501,352,3,680,3,3762,1,30
2502,352,3,681,4,3766,1,40
2503,352,3,682,7,3773,1,70
2504,352,3,683,3,3776,1,30
2505,352,3,684,6,3782,1,60
2506,352,3,685,8,3790,1,80
2507,352,3,686,9,3799,1,90
2508,352,3,687,6,3805,1,60
2509,352,3,688,4,3809,1,40
2510,352,3,689,6,3815,1,60
2511,352,3,690,8,3823,1,80
2512,352,3,691,3,3826,1,30
2513,352,3,692,6,3832,1,60
2514,352,3,693,5,3837,1,50
2515,352,3,694,5,3842,1,50
2516,352,3,695,3,3845,1,30
2517,352,3,696,9,3854,1,90
2518,352,3,697,9,3863,1,90
2519,352,3,698,3,3866,1,30
2520,352,3,699,9,3875,1,90
2521,352,3,700,9,3884,1,90
2522,352,3,701,2,3886,1,20
2523,352,3,702,4,3890,1,40
2524,352,3,703,9,3899,1,90
2525,352,3,704,7,3906,1,70
2526,352,3,705,2,3908,1,20
2527,352,3,706,4,3912,1,40
2528,352,3,707,2,3914,1,20
2529,352,3,708,2,3916,1,20
2530,352,3,709,8,3924,1,80
2531,352,3,710,6,3930,1,60
2532,352,3,711,8,3938,1,80
2533,352,3,712,8,3946,1,80
2534,352,3,713,5,3951,1,50
2535,352,3,714,4,3955,1,40
2536,352,3,715,4,3959,1,40
2537,352,3,716,2,3961,1,20
2538,352,3,717,8,3969,1,80
2539,352,3,718,3,3972,1,30
2540,352,3,719,6,3978,1,60
2541,352,3,720,2,3980,1,20
2542,352,3,721,4,3984,1,40
2543,352,3,722,4,3988,1,40
2544,352,3,723,3,3991,1,30
2545,352,3,724,6,3997,1,60
2546,352,3,725,3,4000,1,30
2547,352,3,726,7,4007,1,70
2548,352,3,727,2,4009,1,20
2549,352,3,728,7,4016,1,70
2550,352,3,729,9,4025,1,90
2551,352,3,730,7,4032,1,70
2552,352,3,731,6,4038,1,60
2553,352,3,732,2,4040,1,20
2554,352,3,733,6,4046,1,60
2555,352,3,734,9,4055,1,90
2556,352,3,735,7,4062,1,70
2557,352,3,736,5,4067,1,50
2558,352,3,737,2,4069,1,20
2559,352,3,738,8,4077,1,80
2560,352,3,739,3,4080,1,30
2561,352,3,740,8,4088,1,80
2562,352,3,741,3,4091,1,30
2563,352,3,742,2,4093,1,20
2564,352,3,743,6,4099,1,60
2565,352,3,744,2,4101,1,20
2566,352,3,745,6,4107,1,60
2567,352,3,746,2,4109,1,20
2568,352,3,747,6,4115,1,60
2569,352,3,748,9,4124,1,90
2570,352,3,749,3,4127,1,30
2571,352,3,750,3,4130,1,30
2572,352,3,751,3,4133,1,30
2573,352,3,752,5,4138,1,50
2574,352,3,753,3,4141,1,30
2575,352,3,754,2,4143,1,20
2576,352,3,755,8,4151,1,80
2577,352,3,756,8,4159,1,80
2578,352,3,757,2,4161,1,20
2579,352,3,758,2,4163,1,20
2580,352,3,759,7,4170,1,70
2581,352,3,760,4,4174,1,40
2582,352,3,761,3,4177,1,30
2583,352,3,762,2,4179,1,20
2584,352,3,763,3,4182,74,30
2585,352,3,764,5,4187,1,50
2586,352,3,765,9,4196,1,90
2587,352,3,766,6,4202,1,60
2588,352,3,767,7,4209,45,70
2589,352,3,768,6,4215,1,60
2590,352,3,769,8,4223,1,80
2591,352,3,770,5,4228,1,50
2592,352,3,771,3,4231,1,30
2593,352,3,772,7,4238,1,70
2594,352,3,773,7,4245,1,70
2595,352,3,774,9,4254,1,90
2596,352,3,775,2,4256,1,20
2597,352,3,776,3,4259,1,30
2598,352,3,777,5,4264,1,50
2599,352,3,778,8,4272,1,80
2600,352,3,779,5,4277,1,50
2601,352,3,780,7,4284,1,70
2602,352,3,781,7,4291,1,70
2603,352,3,782,3,4294,1,30
2604,352,3,783,9,4303,1,90
2605,352,3,784,8,4311,1,80
2606,352,3,785,9,4320,1,90
2607,352,3,786,3,4323,1,30
2608,352,3,787,7,4330,1,70
2609,352,3,788,2,4332,1,20
2610,352,3,789,5,4337,1,50
2611,352,3,790,6,4343,1,60
2612,352,3,791,5,4348,1,50
2613,352,3,792,9,4357,1,90
2614,352,3,793,7,4364,1,70
2615,352,3,794,7,4371,1,70
2616,352,3,795,9,4380,1,90
2617,352,3,796,6,4386,1,60
2618,352,3,797,6,4392,1,60
2619,352,3,798,7,4399,1,70
2620,352,3,799,5,4404,1,50
2621,352,3,800,8,4412,1,80
2622,352,3,801,4,4416,1,40
2623,352,3,802,3,4419,1,30
2624,352,3,803,4,4423,1,40
2625,352,3,804,6,4429,1,60
2626,352,3,805,6,4435,1,60
2627,352,3,806,8,4443,1,80
2628,352,3,807,2,4445,1,20
2629,352,3,808,4,4449,68,40
2630,352,3,809,4,4453,1,40
2631,352,3,810,4,4457,1,40
2632,352,3,811,3,4460,1,30
2633,352,3,812,6,4466,1,60
2634,352,3,813,5,4471,1,50
2635,352,3,814,5,4476,1,50
2636,352,3,815,5,4481,1,50
2637,352,3,816,3,4484,1,30
2638,352,3,817,3,4487,35,30
2639,352,3,818,5,4492,1,50
2640,352,3,819,3,4495,1,30
2641,352,3,820,9,4504,1,90
2642,352,3,821,6,4510,1,60
2643,352,3,822,4,4514,1,40
2644,352,3,823,6,4520,1,60
2645,352,3,824,5,4525,1,50
2646,352,3,825,8,4533,1,80
2647,352,3,826,6,4539,1,60
2648,352,3,827,4,4543,1,40
2649,352,3,828,5,4548,1,50
2650,352,3,829,8,4556,1,80
2651,352,3,830,4,4560,1,40
2652,352,3,831,7,4567,1,70
2653,352,3,832,5,4572,1,50
2654,352,3,833,7,4579,1,70
2655,352,3,834,9,4588,1,90
2656,352,3,835,8,4596,1,80
2657,352,3,836,9,4605,1,90
2658,352,3,837,6,4611,1,60
2659,352,3,838,3,4614,1,30
2660,352,3,839,6,4620,1,60
2661,352,3,840,7,4627,1,70
2662,352,3,841,8,4635,1,80
2663,352,3,842,9,4644,1,90
2664,352,3,843,9,4653,1,90
2665,352,3,844,4,4657,1,40
2666,352,3,845,7,4664,1,70
2667,352,3,846,6,4670,1,60
2668,352,3,847,7,4677,1,70
2669,352,3,848,2,4679,48,20
2670,352,3,849,9,4688,1,90
2671,352,3,850,6,4694,1,60
2672,352,3,851,4,4698,1,40
2673,352,3,852,7,4705,1,70
2674,352,3,853,2,4707,1,20
2675,352,3,854,8,4715,1,80
2676,352,3,855,3,4718,1,30
2677,352,3,856,3,4721,1,30
2678,352,3,857,6,4727,1,60
2679,352,3,858,4,4731,47,40
2680,352,3,859,3,4734,1,30
2681,352,3,860,5,4739,1,50
2682,352,3,861,3,4742,1,30
2683,352,3,862,2,4744,1,20
2684,352,3,863,7,4751,1,70
2685,352,3,864,8,4759,1,80
2686,352,3,865,7,4766,1,70
2687,352,3,866,4,4770,21,40
2688,352,3,867,8,4778,1,80
2689,352,3,868,3,4781,1,30
2690,352,3,869,8,4789,1,80
2691,352,3,870,9,4798,1,90
2692,352,3,871,4,4802,1,40
2693,352,3,872,9,4811,1,90
2694,352,3,873,4,4815,1,40
2695,352,3,874,4,4819,1,40
2696,352,3,875,5,4824,1,50
2697,352,3,876,2,4826,1,20
2698,352,3,877,2,4828,1,20
2699,352,3,878,5,4833,1,50
2700,352,3,879,4,4837,1,40
2701,352,3,880,4,4841,1,40
2702,352,3,881,4,4845,1,40
2703,352,3,882,3,4848,1,30
2704,352,3,883,3,4851,1,30
2705,352,3,884,3,4854,1,30
2706,352,3,885,2,4856,1,20
2707,352,3,886,9,4865,1,90
2708,352,3,887,8,4873,1,80
2709,352,3,888,9,4882,1,90
2710,352,3,889,8,4890,1,80
2711,352,3,890,4,4894,1,40
2712,352,3,891,2,4896,1,20
2713,352,3,892,3,4899,1,30
2714,352,3,893,2,4901,1,20
2715,352,3,894,9,4910,1,90
2716,352,3,895,2,4912,1,20
2717,352,3,896,2,4914,20,20
2718,352,3,897,3,4917,1,30
2719,352,3,898,9,4926,1,90
2720,352,3,899,8,4934,1,80
2721,352,3,900,4,4938,1,40
2722,352,3,901,3,4941,1,30
2723,352,3,902,6,4947,1,60
2724,352,3,903,5,4952,1,50
2725,352,3,904,6,4958,1,60
2726,352,3,905,6,4964,1,60
2727,352,3,906,7,4971,1,70
2728,352,3,907,5,4976,1,50
2729,352,3,908,5,4981,1,50
2730,352,3,909,4,4985,1,40
2731,352,3,910,3,4988,1,30
2732,352,3,911,3,4991,1,30
2733,352,3,912,6,4997,1,60
