,Scenario,Trial,Inspection,Interval,Time,Defects,Rate
0,42,1,1,6,6,1,60
1,42,1,2,5,11,1,50
2,42,1,3,2,13,2,20
3,42,1,4,8,21,1,80
4,42,1,5,4,25,0,40
5,42,1,6,4,29,2,40
6,42,1,7,4,33,0,40
7,42,1,8,2,35,0,20
8,42,1,9,6,41,1,60
9,42,1,10,8,49,1,80
10,42,1,11,6,55,1,60
11,42,1,12,4,59,1,40
12,42,1,13,5,64,4,50
13,42,1,14,8,72,4,80
14,42,1,15,6,78,4,60
15,42,1,16,9,87,1,90
16,42,1,17,8,95,2,80
17,42,1,18,5,100,4,50
18,42,1,19,2,102,1,20
19,42,1,20,5,107,2,50
20,42,1,21,5,112,1,50
21,42,1,22,6,118,0,60
22,42,1,23,7,125,3,70
23,42,1,24,9,134,1,90
24,42,1,25,5,139,1,50
25,42,1,26,7,146,7,70
26,42,1,27,7,153,3,70
27,42,1,28,9,162,5,90
28,42,1,29,9,171,1,90
29,42,1,30,7,178,1,70
30,42,1,31,8,186,2,80
31,42,1,32,2,188,1,20
32,42,1,33,7,195,3,70
33,42,1,34,4,199,3,40
34,42,1,35,6,205,2,60
35,42,1,36,4,209,1,40
36,42,1,37,4,213,1,40
37,42,1,38,8,221,1,80
38,42,1,39,2,223,0,20
39,42,1,40,5,228,2,50
40,42,1,41,7,235,2,70
41,42,1,42,3,238,1,30
42,42,1,43,8,246,0,80
43,42,1,44,7,253,4,70
44,42,1,45,2,255,0,20
45,42,1,46,4,259,3,40
46,42,1,47,6,265,0,60
47,42,1,48,6,271,2,60
48,42,1,49,5,276,2,50
49,42,1,50,3,279,4,30
50,42,1,51,8,287,4,80
51,42,1,52,9,296,1,90
52,42,1,53,6,302,5,60
53,42,1,54,3,305,5,30
54,42,1,55,4,309,3,40
55,42,1,56,3,312,1,30
56,42,1,57,2,314,1,20
57,42,1,58,3,317,2,30
58,42,1,59,9,326,2,90
59,42,1,60,2,328,1,20
60,42,1,61,5,333,3,50
61,42,1,62,6,339,5,60
62,42,1,63,7,346,1,70
63,42,1,64,8,354,3,80
64,42,1,65,4,358,3,40
65,42,1,66,7,365,2,70
66,42,1,67,7,372,1,70
67,42,1,68,8,380,5,80
68,42,1,69,3,383,1,30
69,42,1,70,8,391,3,80
70,42,1,71,9,400,5,90
71,42,1,72,3,403,5,30
72,42,1,73,5,408,4,50
73,42,1,74,8,416,4,80
74,42,1,75,8,424,3,80
75,42,1,76,9,433,5,90
76,42,1,77,3,436,3,30
77,42,1,78,4,440,5,40
78,42,1,79,3,443,2,30
79,42,1,80,8,451,2,80
80,42,1,81,3,454,4,30
81,42,1,82,9,463,4,90
82,42,1,83,9,472,1,90
83,42,1,84,4,476,1,40
84,42,1,85,7,483,1,70
85,42,1,86,4,487,2,40
86,42,1,87,6,493,2,60
87,42,1,88,6,499,0,60
88,42,1,89,3,502,1,30
89,42,1,90,8,510,4,80
90,42,1,91,4,514,3,40
91,42,1,92,5,519,0,50
92,42,1,93,2,521,1,20
93,42,1,94,8,529,5,80
94,42,1,95,8,537,5,80
95,42,1,96,8,545,3,80
96,42,1,97,2,547,1,20
97,42,1,98,2,549,1,20
98,42,1,99,9,558,2,90
99,42,1,100,7,565,4,70
100,42,1,101,7,572,6,70
101,42,1,102,3,575,3,30
102,42,1,103,4,579,1,40
103,42,1,104,6,585,1,60
104,42,1,105,7,592,3,70
105,42,1,106,6,598,2,60
106,42,1,107,8,606,2,80
107,42,1,108,5,611,4,50
108,42,1,109,6,617,2,60
109,42,1,110,7,624,2,70
110,42,1,111,3,627,1,30
111,42,1,112,6,633,5,60
112,42,1,113,2,635,4,20
113,42,1,114,5,640,2,50
114,42,1,115,5,645,2,50
115,42,1,116,3,648,1,30
116,42,1,117,3,651,4,30
117,42,1,118,9,660,1,90
118,42,1,119,2,662,1,20
119,42,1,120,7,669,1,70
120,42,1,121,4,673,1,40
121,42,1,122,8,681,2,80
122,42,1,123,6,687,6,60
123,42,1,124,3,690,3,30
124,42,1,125,6,696,2,60
125,42,1,126,9,705,1,90
126,42,1,127,9,714,2,90
127,42,1,128,6,720,2,60
128,42,1,129,6,726,3,60
129,42,1,130,6,732,3,60
130,42,1,131,7,739,4,70
131,42,1,132,7,746,3,70
132,42,1,133,2,748,0,20
133,42,1,134,5,753,2,50
134,42,1,135,4,757,1,40
135,42,1,136,4,761,3,40
136,42,1,137,9,770,6,90
137,42,1,138,2,772,5,20
138,42,1,139,9,781,1,90
139,42,1,140,6,787,2,60
140,42,1,141,6,793,4,60
141,42,1,142,6,799,4,60
142,42,1,143,5,804,1,50
143,42,1,144,9,813,0,90
144,42,1,145,9,822,1,90
145,42,1,146,5,827,2,50
146,42,1,147,5,832,7,50
147,42,1,148,9,841,7,90
148,42,1,149,9,850,4,90
149,42,1,150,8,858,7,80
150,42,1,151,7,865,3,70
151,42,1,152,9,874,2,90
152,42,1,153,6,880,5,60
153,42,1,154,2,882,3,20
154,42,1,155,3,885,1,30
155,42,1,156,5,890,3,50
156,42,1,157,7,897,1,70
157,42,1,158,8,905,1,80
158,42,1,159,3,908,3,30
159,42,1,160,7,915,2,70
160,42,1,161,8,923,3,80
161,42,1,162,8,931,4,80
162,42,1,163,9,940,4,90
163,42,1,164,6,946,6,60
164,42,1,165,2,948,2,20
165,42,1,166,9,957,1,90
166,42,1,167,4,961,3,40
167,42,1,168,7,968,2,70
168,42,1,169,5,973,2,50
169,42,1,170,5,978,1,50
170,42,1,171,9,987,2,90
171,42,1,172,9,996,1,90
172,42,1,173,6,1002,8,60
173,42,1,174,9,1011,3,90
174,42,1,175,6,1017,3,60
175,42,1,176,9,1026,2,90
176,42,1,177,5,1031,3,50
177,42,1,178,6,1037,1,60
178,42,1,179,5,1042,1,50
179,42,1,180,6,1048,1,60
180,42,1,181,8,1056,4,80
181,42,1,182,2,1058,4,20
182,42,1,183,9,1067,6,90
183,42,1,184,4,1071,1,40
184,42,1,185,2,1073,1,20
185,42,1,186,9,1082,1,90
186,42,1,187,3,1085,3,30
187,42,1,188,2,1087,2,20
188,42,1,189,7,1094,4,70
189,42,1,190,5,1099,3,50
190,42,1,191,6,1105,3,60
191,42,1,192,8,1113,3,80
192,42,1,193,6,1119,2,60
193,42,1,194,5,1124,2,50
194,42,1,195,6,1130,1,60
195,42,1,196,5,1135,7,50
196,42,1,197,3,1138,1,30
197,42,1,198,7,1145,1,70
198,42,1,199,2,1147,5,20
199,42,1,200,3,1150,1,30
200,42,1,201,8,1158,3,80
201,42,1,202,8,1166,1,80
202,42,1,203,9,1175,6,90
203,42,1,204,2,1177,5,20
204,42,1,205,9,1186,1,90
205,42,1,206,4,1190,3,40
206,42,1,207,2,1192,7,20
207,42,1,208,8,1200,3,80
208,42,1,209,8,1208,3,80
209,42,1,210,9,1217,7,90
210,42,1,211,2,1219,4,20
211,42,1,212,2,1221,5,20
212,42,1,213,5,1226,4,50
213,42,1,214,9,1235,1,90
214,42,1,215,4,1239,4,40
215,42,1,216,3,1242,3,30
216,42,1,217,4,1246,4,40
217,42,1,218,3,1249,2,30
218,42,1,219,5,1254,3,50
219,42,1,220,6,1260,2,60
220,42,1,221,2,1262,3,20
221,42,1,222,2,1264,4,20
222,42,1,223,2,1266,5,20
223,42,1,224,9,1275,1,90
224,42,1,225,5,1280,1,50
225,42,1,226,3,1283,2,30
226,42,1,227,2,1285,0,20
227,42,1,228,6,1291,1,60
228,42,1,229,3,1294,0,30
229,42,1,230,2,1296,1,20
230,42,1,231,4,1300,1,40
231,42,1,232,8,1308,1,80
232,42,1,233,6,1314,6,60
233,42,1,234,6,1320,5,60
234,42,1,235,2,1322,2,20
235,42,1,236,3,1325,1,30
236,42,1,237,3,1328,2,30
237,42,1,238,4,1332,6,40
238,42,1,239,5,1337,3,50
239,42,1,240,4,1341,2,40
240,42,1,241,8,1349,5,80
241,42,1,242,9,1358,4,90
242,42,1,243,4,1362,1,40
243,42,1,244,7,1369,1,70
244,42,1,245,2,1371,3,20
245,42,1,246,8,1379,3,80
246,42,1,247,8,1387,8,80
247,42,1,248,5,1392,4,50
248,42,1,249,8,1400,9,80
249,42,1,250,5,1405,2,50
250,42,1,251,4,1409,1,40
251,42,1,252,3,1412,6,30
252,42,1,253,8,1420,3,80
253,42,1,254,2,1422,1,20
254,42,1,255,6,1428,2,60
255,42,1,256,4,1432,6,40
256,42,1,257,8,1440,1,80
257,42,1,258,4,1444,2,40
258,42,1,259,3,1447,1,30
259,42,1,260,4,1451,4,40
260,42,1,261,9,1460,3,90
261,42,1,262,5,1465,2,50
262,42,1,263,8,1473,3,80
263,42,1,264,2,1475,3,20
264,42,1,265,6,1481,3,60
265,42,1,266,6,1487,4,60
266,42,1,267,7,1494,2,70
267,42,1,268,2,1496,6,20
268,42,1,269,9,1505,3,90
269,42,1,270,9,1514,5,90
270,42,1,271,7,1521,2,70
271,42,1,272,2,1523,5,20
272,42,1,273,4,1527,3,40
273,42,1,274,3,1530,8,30
274,42,1,275,2,1532,0,20
275,42,1,276,6,1538,1,60
276,42,1,277,4,1542,3,40
277,42,1,278,5,1547,2,50
278,42,1,279,5,1552,3,50
279,42,1,280,6,1558,4,60
280,42,1,281,3,1561,3,30
281,42,1,282,6,1567,2,60
282,42,1,283,4,1571,2,40
283,42,1,284,3,1574,2,30
284,42,1,285,7,1581,4,70
285,42,1,286,3,1584,3,30
286,42,1,287,5,1589,2,50
287,42,1,288,5,1594,2,50
288,42,1,289,6,1600,3,60
289,42,1,290,4,1604,0,40
290,42,1,291,5,1609,3,50
291,42,1,292,2,1611,0,20
292,42,1,293,7,1618,3,70
293,42,1,294,3,1621,5,30
294,42,1,295,5,1626,1,50
295,42,1,296,3,1629,6,30
296,42,1,297,4,1633,5,40
297,42,1,298,2,1635,2,20
298,42,1,299,5,1640,2,50
299,42,1,300,3,1643,1,30
300,42,1,301,9,1652,2,90
301,42,1,302,6,1658,1,60
302,42,1,303,6,1664,2,60
303,42,1,304,7,1671,3,70
304,42,1,305,2,1673,0,20
305,42,1,306,3,1676,3,30
306,42,1,307,5,1681,3,50
307,42,1,308,6,1687,5,60
308,42,1,309,8,1695,2,80
309,42,1,310,9,1704,4,90
310,42,1,311,9,1713,1,90
311,42,1,312,4,1717,2,40
312,42,1,313,3,1720,1,30
313,42,1,314,2,1722,2,20
314,42,1,315,5,1727,2,50
315,42,1,316,4,1731,1,40
316,42,1,317,4,1735,4,40
317,42,1,318,7,1742,4,70
318,42,1,319,2,1744,3,20
319,42,1,320,5,1749,1,50
320,42,1,321,4,1753,1,40
321,42,1,322,9,1762,1,90
322,42,1,323,5,1767,3,50
323,42,1,324,5,1772,3,50
324,42,1,325,3,1775,1,30
325,42,1,326,5,1780,3,50
326,42,1,327,2,1782,1,20
327,42,1,328,7,1789,2,70
328,42,1,329,6,1795,5,60
329,42,1,330,2,1797,4,20
330,42,1,331,7,1804,2,70
331,42,1,332,9,1813,3,90
332,42,1,333,8,1821,2,80
333,42,1,334,5,1826,1,50
334,42,1,335,3,1829,0,30
335,42,1,336,8,1837,1,80
336,42,1,337,7,1844,4,70
337,42,1,338,9,1853,3,90
338,42,1,339,2,1855,1,20
339,42,1,340,4,1859,0,40
340,42,1,341,9,1868,1,90
341,42,1,342,6,1874,1,60
342,42,1,343,7,1881,7,70
343,42,1,344,2,1883,2,20
344,42,1,345,4,1887,3,40
345,42,1,346,6,1893,5,60
346,42,1,347,8,1901,1,80
347,42,1,348,2,1903,3,20
348,42,1,349,3,1906,1,30
349,42,1,350,3,1909,4,30
350,42,1,351,3,1912,4,30
351,42,1,352,5,1917,1,50
352,42,1,353,4,1921,1,40
353,42,1,354,3,1924,3,30
354,42,1,355,9,1933,3,90
355,42,1,356,5,1938,1,50
356,42,1,357,3,1941,2,30
357,42,1,358,7,1948,1,70
358,42,1,359,4,1952,1,40
359,42,1,360,7,1959,1,70
360,42,1,361,4,1963,4,40
361,42,1,362,8,1971,3,80
362,42,1,363,6,1977,4,60
363,42,1,364,7,1984,4,70
364,42,1,365,7,1991,7,70
365,42,1,366,7,1998,2,70
366,42,1,367,5,2003,4,50
367,42,1,368,9,2012,2,90
368,42,1,369,4,2016,5,40
369,42,1,370,7,2023,4,70
370,42,1,371,6,2029,4,60
371,42,1,372,4,2033,5,40
372,42,1,373,2,2035,0,20
373,42,1,374,2,2037,3,20
374,42,1,375,4,2041,1,40
375,42,1,376,6,2047,1,60
376,42,1,377,9,2056,4,90
377,42,1,378,7,2063,3,70
378,42,1,379,3,2066,6,30
379,42,1,380,7,2073,1,70
380,42,1,381,2,2075,3,20
381,42,1,382,9,2084,5,90
382,42,1,383,7,2091,4,70
383,42,1,384,4,2095,3,40
384,42,1,385,5,2100,3,50
385,42,1,386,6,2106,3,60
386,42,1,387,5,2111,3,50
387,42,1,388,2,2113,4,20
388,42,1,389,7,2120,8,70
389,42,1,390,6,2126,5,60
390,42,1,391,5,2131,2,50
391,42,1,392,6,2137,3,60
392,42,1,393,5,2142,2,50
393,42,1,394,5,2147,1,50
394,42,1,395,2,2149,3,20
395,42,1,396,9,2158,1,90
396,42,1,397,7,2165,6,70
397,42,1,398,7,2172,6,70
398,42,1,399,5,2177,1,50
399,42,1,400,9,2186,2,90
400,42,1,401,7,2193,6,70
401,42,1,402,8,2201,2,80
402,42,1,403,6,2207,0,60
403,42,1,404,7,2214,1,70
404,42,1,405,8,2222,3,80
405,42,1,406,8,2230,2,80
406,42,1,407,8,2238,1,80
407,42,1,408,9,2247,7,90
408,42,1,409,4,2251,3,40
409,42,1,410,5,2256,3,50
410,42,1,411,2,2258,4,20
411,42,1,412,2,2260,6,20
412,42,1,413,4,2264,1,40
413,42,1,414,6,2270,3,60
414,42,1,415,5,2275,1,50
415,42,1,416,3,2278,3,30
416,42,1,417,5,2283,1,50
417,42,1,418,5,2288,2,50
418,42,1,419,6,2294,1,60
419,42,1,420,4,2298,1,40
420,42,1,421,4,2302,1,40
421,42,1,422,2,2304,1,20
422,42,1,423,3,2307,0,30
423,42,1,424,4,2311,2,40
424,42,1,425,4,2315,1,40
425,42,1,426,3,2318,0,30
426,42,1,427,7,2325,1,70
427,42,1,428,3,2328,2,30
428,42,1,429,8,2336,4,80
429,42,1,430,4,2340,1,40
430,42,1,431,9,2349,5,90
431,42,1,432,3,2352,2,30
432,42,1,433,7,2359,3,70
433,42,1,434,8,2367,3,80
434,42,1,435,6,2373,0,60
435,42,1,436,9,2382,1,90
436,42,1,437,2,2384,3,20
437,42,1,438,6,2390,5,60
438,42,1,439,8,2398,5,80
439,42,1,440,2,2400,2,20
440,42,1,441,4,2404,2,40
441,42,1,442,7,2411,2,70
442,42,1,443,9,2420,3,90
443,42,1,444,4,2424,4,40
444,42,1,445,4,2428,3,40
445,42,1,446,3,2431,1,30
446,42,1,447,6,2437,5,60
447,42,1,448,5,2442,1,50
448,42,1,449,2,2444,1,20
449,42,1,450,7,2451,2,70
450,42,1,451,3,2454,2,30
451,42,1,452,9,2463,1,90
452,42,1,453,9,2472,2,90
453,42,1,454,5,2477,4,50
454,42,1,455,2,2479,4,20
455,42,1,456,4,2483,1,40
456,42,1,457,5,2488,3,50
457,42,1,458,7,2495,1,70
458,42,1,459,8,2503,4,80
459,42,1,460,5,2508,7,50
460,42,1,461,5,2513,4,50
461,42,1,462,4,2517,4,40
462,42,1,463,3,2520,1,30
463,42,1,464,3,2523,2,30
464,42,1,465,9,2532,1,90
465,42,1,466,5,2537,2,50
466,42,1,467,8,2545,5,80
467,42,1,468,6,2551,1,60
468,42,1,469,4,2555,4,40
469,42,1,470,9,2564,1,90
470,42,1,471,6,2570,5,60
471,42,1,472,7,2577,2,70
472,42,1,473,4,2581,5,40
473,42,1,474,3,2584,1,30
474,42,1,475,5,2589,1,50
475,42,1,476,5,2594,1,50
476,42,1,477,4,2598,5,40
477,42,1,478,7,2605,4,70
478,42,1,479,9,2614,3,90
479,42,1,480,5,2619,3,50
480,42,1,481,6,2625,5,60
481,42,1,482,4,2629,2,40
482,42,1,483,9,2638,1,90
483,42,1,484,8,2646,4,80
484,42,1,485,4,2650,2,40
485,42,1,486,8,2658,2,80
486,42,1,487,7,2665,1,70
487,42,1,488,7,2672,2,70
488,42,1,489,3,2675,1,30
489,42,1,490,6,2681,1,60
490,42,1,491,8,2689,1,80
491,42,1,492,6,2695,2,60
492,42,1,493,2,2697,6,20
493,42,1,494,5,2702,2,50
494,42,1,495,8,2710,3,80
495,42,1,496,4,2714,6,40
496,42,1,497,6,2720,2,60
497,42,1,498,2,2722,1,20
498,42,1,499,2,2724,0,20
499,42,1,500,3,2727,0,30
500,42,1,501,3,2730,2,30
501,42,1,502,4,2734,1,40
502,42,1,503,2,2736,2,20
503,42,1,504,2,2738,1,20
504,42,1,505,9,2747,1,90
505,42,1,506,9,2756,1,90
506,42,1,507,6,2762,2,60
507,42,1,508,5,2767,2,50
508,42,1,509,4,2771,3,40
509,42,1,510,9,2780,5,90
510,42,1,511,4,2784,3,40
511,42,1,512,6,2790,5,60
512,42,1,513,9,2799,1,90
513,42,1,514,2,2801,2,20
514,42,1,515,5,2806,1,50
515,42,1,516,9,2815,2,90
516,42,1,517,8,2823,1,80
517,42,1,518,2,2825,5,20
518,42,1,519,5,2830,5,50
519,42,1,520,7,2837,7,70
520,42,1,521,2,2839,4,20
521,42,1,522,7,2846,3,70
522,42,1,523,9,2855,2,90
523,42,1,524,3,2858,1,30
524,42,1,525,7,2865,3,70
525,42,1,526,9,2874,1,90
526,42,1,527,7,2881,4,70
527,42,1,528,6,2887,1,60
528,42,1,529,5,2892,5,50
529,42,1,530,2,2894,1,20
530,42,1,531,4,2898,1,40
531,42,1,532,8,2906,2,80
532,42,1,533,7,2913,1,70
533,42,1,534,5,2918,1,50
534,42,1,535,4,2922,4,40
535,42,1,536,2,2924,2,20
536,42,1,537,9,2933,3,90
537,42,1,538,5,2938,1,50
538,42,1,539,3,2941,4,30
539,42,1,540,7,2948,5,70
540,42,1,541,8,2956,6,80
541,42,1,542,5,2961,1,50
542,42,1,543,3,2964,2,30
543,42,1,544,5,2969,1,50
544,42,1,545,6,2975,4,60
545,42,1,546,8,2983,4,80
546,42,1,547,3,2986,3,30
547,42,1,548,2,2988,2,20
548,42,1,549,8,2996,2,80
549,42,1,550,2,2998,3,20
550,42,1,551,8,3006,7,80
551,42,1,552,6,3012,4,60
552,42,1,553,2,3014,3,20
553,42,1,554,8,3022,4,80
554,42,1,555,8,3030,2,80
555,42,1,556,7,3037,4,70
556,42,1,557,5,3042,3,50
557,42,1,558,2,3044,1,20
558,42,1,559,4,3048,0,40
559,42,1,560,2,3050,3,20
560,42,1,561,2,3052,2,20
561,42,1,562,7,3059,6,70
562,42,1,563,8,3067,1,80
563,42,1,564,6,3073,4,60
564,42,1,565,8,3081,3,80
565,42,1,566,9,3090,2,90
566,42,1,567,4,3094,3,40
567,42,1,568,5,3099,2,50
568,42,1,569,9,3108,3,90
569,42,1,570,2,3110,3,20
570,42,1,571,3,3113,1,30
571,42,1,572,2,3115,1,20
572,42,1,573,2,3117,4,20
573,42,1,574,2,3119,2,20
574,42,1,575,7,3126,1,70
575,42,1,576,8,3134,3,80
576,42,1,577,4,3138,1,40
577,42,1,578,2,3140,1,20
578,42,1,579,7,3147,2,70
579,42,1,580,7,3154,2,70
580,42,1,581,9,3163,6,90
581,42,1,582,3,3166,0,30
582,42,1,583,4,3170,2,40
583,42,1,584,3,3173,1,30
584,42,1,585,7,3180,1,70
585,42,1,586,4,3184,1,40
586,42,1,587,9,3193,2,90
587,42,1,588,9,3202,1,90
588,42,1,589,9,3211,1,90
589,42,1,590,3,3214,8,30
590,42,1,591,8,3222,1,80
591,42,1,592,8,3230,2,80
592,42,1,593,3,3233,6,30
593,42,1,594,9,3242,3,90
594,42,1,595,5,3247,1,50
595,42,1,596,9,3256,1,90
596,42,1,597,7,3263,3,70
597,42,1,598,3,3266,1,30
598,42,1,599,7,3273,1,70
599,42,1,600,4,3277,1,40
600,42,1,601,3,3280,12,30
601,42,1,602,9,3289,6,90
602,42,1,603,4,3293,1,40
603,42,1,604,6,3299,4,60
604,42,1,605,4,3303,6,40
605,42,1,606,6,3309,1,60
606,42,1,607,3,3312,6,30
607,42,1,608,6,3318,1,60
608,42,1,609,7,3325,3,70
609,42,1,610,2,3327,1,20
610,42,1,611,9,3336,8,90
611,42,1,612,9,3345,1,90
612,42,1,613,2,3347,6,20
613,42,1,614,8,3355,4,80
614,42,1,615,9,3364,3,90
615,42,1,616,2,3366,4,20
616,42,1,617,2,3368,3,20
617,42,1,618,6,3374,0,60
618,42,1,619,8,3382,1,80
619,42,1,620,5,3387,3,50
620,42,1,621,5,3392,1,50
621,42,1,622,4,3396,3,40
622,42,1,623,2,3398,2,20
623,42,1,624,9,3407,4,90
624,42,1,625,9,3416,2,90
625,42,1,626,6,3422,4,60
626,42,1,627,7,3429,2,70
627,42,1,628,2,3431,2,20
628,42,1,629,8,3439,3,80
629,42,1,630,8,3447,4,80
630,42,1,631,5,3452,5,50
631,42,1,632,4,3456,4,40
632,42,1,633,2,3458,2,20
633,42,1,634,8,3466,1,80
634,42,1,635,4,3470,3,40
635,42,1,636,7,3477,2,70
636,42,1,637,7,3484,4,70
637,42,1,638,9,3493,1,90
638,42,1,639,6,3499,2,60
639,42,1,640,5,3504,7,50
640,42,1,641,6,3510,1,60
641,42,1,642,4,3514,1,40
642,42,1,643,9,3523,0,90
643,42,1,644,7,3530,3,70
644,42,1,645,7,3537,4,70
645,42,1,646,5,3542,1,50
646,42,1,647,5,3547,2,50
647,42,1,648,4,3551,0,40
648,42,1,649,7,3558,5,70
649,42,1,650,4,3562,3,40
650,42,1,651,9,3571,4,90
651,42,1,652,9,3580,5,90
652,42,1,653,3,3583,1,30
653,42,1,654,8,3591,2,80
654,42,1,655,8,3599,6,80
655,42,1,656,7,3606,6,70
656,42,1,657,7,3613,3,70
657,42,1,658,6,3619,2,60
658,42,1,659,3,3622,0,30
659,42,1,660,9,3631,4,90
660,42,1,661,8,3639,4,80
661,42,1,662,7,3646,5,70
662,42,1,663,8,3654,4,80
663,42,1,664,8,3662,4,80
664,42,1,665,5,3667,1,50
665,42,1,666,5,3672,1,50
666,42,1,667,2,3674,2,20
667,42,1,668,3,3677,3,30
668,42,1,669,3,3680,6,30
669,42,1,670,8,3688,3,80
670,42,1,671,3,3691,5,30
671,42,1,672,5,3696,0,50
672,42,1,673,9,3705,5,90
673,42,1,674,6,3711,1,60
674,42,1,675,4,3715,1,40
675,42,1,676,5,3720,4,50
676,42,1,677,5,3725,6,50
677,42,1,678,4,3729,1,40
678,42,1,679,7,3736,1,70
679,42,1,680,2,3738,1,20
680,42,1,681,8,3746,4,80
681,42,1,682,5,3751,1,50
682,42,1,683,8,3759,3,80
683,42,1,684,3,3762,3,30
684,42,1,685,5,3767,1,50
685,42,1,686,5,3772,3,50
686,42,1,687,5,3777,3,50
687,42,1,688,3,3780,2,30
688,42,1,689,8,3788,1,80
689,42,1,690,3,3791,4,30
690,42,1,691,6,3797,4,60
691,42,1,692,6,3803,1,60
692,42,1,693,9,3812,1,90
693,42,1,694,8,3820,3,80
694,42,1,695,7,3827,3,70
695,42,1,696,9,3836,2,90
696,42,1,697,5,3841,1,50
697,42,1,698,4,3845,3,40
698,42,1,699,6,3851,1,60
699,42,1,700,9,3860,2,90
700,42,1,701,7,3867,3,70
701,42,1,702,8,3875,6,80
702,42,1,703,2,3877,3,20
703,42,1,704,3,3880,3,30
704,42,1,705,2,3882,5,20
705,42,1,706,9,3891,2,90
706,42,1,707,9,3900,1,90
707,42,1,708,2,3902,3,20
708,42,1,709,4,3906,4,40
709,42,1,710,8,3914,3,80
710,42,1,711,8,3922,2,80
711,42,1,712,9,3931,5,90
712,42,1,713,7,3938,1,70
713,42,1,714,7,3945,5,70
714,42,1,715,9,3954,3,90
715,42,1,716,8,3962,7,80
716,42,1,717,3,3965,5,30
717,42,1,718,5,3970,7,50
718,42,1,719,6,3976,1,60
719,42,1,720,6,3982,5,60
720,42,1,721,5,3987,1,50
721,42,1,722,5,3992,1,50
722,42,1,723,5,3997,1,50
723,42,1,724,4,4001,1,40
724,42,1,725,8,4009,4,80
725,42,1,726,7,4016,1,70
726,42,1,727,4,4020,9,40
727,42,1,728,4,4024,2,40
728,42,1,729,6,4030,0,60
729,42,1,730,2,4032,7,20
730,42,1,731,3,4035,1,30
731,42,1,732,6,4041,1,60
732,42,1,733,5,4046,3,50
733,42,1,734,8,4054,1,80
734,42,1,735,8,4062,0,80
735,42,1,736,8,4070,4,80
736,42,1,737,5,4075,1,50
737,42,1,738,5,4080,3,50
738,42,1,739,9,4089,1,90
739,42,1,740,3,4092,2,30
740,42,1,741,4,4096,2,40
741,42,1,742,4,4100,1,40
742,42,1,743,8,4108,1,80
743,42,1,744,2,4110,1,20
744,42,1,745,2,4112,5,20
745,42,1,746,2,4114,2,20
746,42,1,747,7,4121,1,70
747,42,1,748,7,4128,1,70
748,42,1,749,7,4135,4,70
749,42,1,750,7,4142,3,70
750,42,1,751,2,4144,1,20
751,42,1,752,4,4148,5,40
752,42,1,753,3,4151,3,30
753,42,1,754,9,4160,1,90
754,42,1,755,2,4162,2,20
755,42,1,756,6,4168,3,60
756,42,1,757,9,4177,4,90
757,42,1,758,2,4179,2,20
758,42,1,759,4,4183,3,40
759,42,1,760,6,4189,4,60
760,42,1,761,9,4198,2,90
761,42,1,762,6,4204,2,60
762,42,1,763,5,4209,1,50
763,42,1,764,6,4215,1,60
764,42,1,765,9,4224,2,90
765,42,1,766,4,4228,5,40
766,42,1,767,7,4235,0,70
767,42,1,768,9,4244,6,90
768,42,1,769,5,4249,3,50
769,42,1,770,3,4252,5,30
770,42,1,771,9,4261,2,90
771,42,1,772,6,4267,1,60
772,42,1,773,5,4272,4,50
773,42,1,774,6,4278,1,60
774,42,1,775,2,4280,2,20
775,42,1,776,6,4286,6,60
776,42,1,777,5,4291,2,50
777,42,1,778,7,4298,5,70
778,42,1,779,8,4306,2,80
779,42,1,780,4,4310,2,40
780,42,1,781,5,4315,6,50
781,42,1,782,3,4318,0,30
782,42,1,783,7,4325,1,70
783,42,1,784,5,4330,2,50
784,42,1,785,9,4339,3,90
785,42,1,786,9,4348,3,90
786,42,1,787,4,4352,0,40
787,42,1,788,3,4355,0,30
788,42,1,789,5,4360,4,50
789,42,1,790,6,4366,1,60
790,42,1,791,8,4374,3,80
791,42,1,792,5,4379,0,50
792,42,1,793,5,4384,1,50
793,42,1,794,2,4386,5,20
794,42,1,795,3,4389,1,30
795,42,1,796,7,4396,3,70
796,42,1,797,2,4398,3,20
797,42,1,798,8,4406,2,80
798,42,1,799,8,4414,3,80
799,42,1,800,9,4423,2,90
800,42,1,801,7,4430,2,70
801,42,1,802,6,4436,3,60
802,42,1,803,4,4440,2,40
803,42,1,804,4,4444,4,40
804,42,1,805,5,4449,4,50
805,42,1,806,5,4454,4,50
806,42,1,807,9,4463,5,90
807,42,1,808,5,4468,2,50
808,42,1,809,2,4470,1,20
809,42,1,810,4,4474,3,40
810,42,1,811,7,4481,3,70
811,42,1,812,5,4486,3,50
812,42,1,813,4,4490,7,40
813,42,1,814,9,4499,4,90
814,42,1,815,3,4502,4,30
815,42,1,816,8,4510,1,80
816,42,1,817,7,4517,2,70
817,42,1,818,4,4521,1,40
818,42,1,819,5,4526,3,50
819,42,1,820,4,4530,1,40
820,42,1,821,2,4532,1,20
821,42,1,822,3,4535,2,30
822,42,1,823,4,4539,2,40
823,42,1,824,3,4542,1,30
824,42,1,825,6,4548,4,60
825,42,1,826,3,4551,1,30
826,42,1,827,6,4557,1,60
827,42,1,828,5,4562,2,50
828,42,1,829,6,4568,1,60
829,42,1,830,5,4573,2,50
830,42,1,831,3,4576,4,30
831,42,1,832,5,4581,1,50
832,42,1,833,8,4589,3,80
833,42,1,834,3,4592,2,30
834,42,1,835,2,4594,5,20
835,42,1,836,4,4598,2,40
836,42,1,837,3,4601,1,30
837,42,1,838,6,4607,2,60
838,42,1,839,4,4611,4,40
839,42,1,840,3,4614,1,30
840,42,1,841,9,4623,1,90
841,42,1,842,4,4627,1,40
842,42,1,843,7,4634,6,70
843,42,1,844,6,4640,6,60
844,42,1,845,6,4646,7,60
845,42,1,846,5,4651,1,50
846,42,1,847,4,4655,5,40
847,42,1,848,3,4658,4,30
848,42,1,849,9,4667,1,90
849,42,1,850,8,4675,5,80
850,42,1,851,6,4681,3,60
851,42,1,852,7,4688,1,70
852,42,1,853,7,4695,7,70
853,42,1,854,2,4697,7,20
854,42,1,855,2,4699,3,20
855,42,1,856,2,4701,2,20
856,42,1,857,4,4705,2,40
857,42,1,858,4,4709,0,40
858,42,1,859,7,4716,5,70
859,42,1,860,3,4719,7,30
860,42,1,861,3,4722,4,30
861,42,1,862,7,4729,5,70
862,42,1,863,8,4737,1,80
863,42,1,864,7,4744,5,70
864,42,1,865,5,4749,2,50
865,42,1,866,2,4751,2,20
866,42,1,867,2,4753,1,20
867,42,1,868,8,4761,1,80
868,42,1,869,7,4768,5,70
869,42,1,870,9,4777,5,90
870,42,1,871,7,4784,3,70
871,42,1,872,8,4792,4,80
872,42,1,873,3,4795,0,30
873,42,1,874,9,4804,1,90
874,42,1,875,4,4808,5,40
875,42,1,876,2,4810,4,20
876,42,1,877,3,4813,3,30
877,42,1,878,3,4816,1,30
878,42,1,879,7,4823,4,70
879,42,1,880,7,4830,5,70
880,42,1,881,9,4839,1,90
881,42,1,882,2,4841,1,20
882,42,1,883,8,4849,4,80
883,42,1,884,5,4854,2,50
884,42,1,885,2,4856,3,20
885,42,1,886,7,4863,3,70
886,42,1,887,3,4866,1,30
887,42,1,888,2,4868,1,20
888,42,1,889,6,4874,3,60
889,42,1,890,4,4878,2,40
890,42,1,891,4,4882,2,40
891,42,1,892,3,4885,1,30
892,42,1,893,3,4888,4,30
893,42,1,894,9,4897,5,90
894,42,1,895,9,4906,5,90
895,42,1,896,6,4912,4,60
896,42,1,897,7,4919,1,70
897,42,1,898,6,4925,3,60
898,42,1,899,6,4931,4,60
899,42,1,900,7,4938,3,70
900,42,1,901,3,4941,1,30
901,42,1,902,3,4944,1,30
902,42,1,903,5,4949,4,50
903,42,1,904,8,4957,2,80
904,42,1,905,4,4961,4,40
905,42,1,906,3,4964,2,30
906,42,1,907,3,4967,6,30
907,42,1,908,6,4973,2,60
908,42,1,909,8,4981,5,80
909,42,1,910,3,4984,2,30
910,42,1,911,3,4987,1,30
911,42,1,912,5,4992,1,50
912,42,2,1,4,4,0,40
913,42,2,2,2,6,0,20
914,42,2,3,5,11,2,50
915,42,2,4,3,14,0,30
916,42,2,5,6,20,1,60
917,42,2,6,8,28,1,80
918,42,2,7,9,37,1,90
919,42,2,8,6,43,4,60
920,42,2,9,6,49,1,60
921,42,2,10,9,58,1,90
922,42,2,11,3,61,1,30
923,42,2,12,3,64,3,30
924,42,2,13,4,68,3,40
925,42,2,14,9,77,2,90
926,42,2,15,2,79,4,20
927,42,2,16,9,88,5,90
928,42,2,17,9,97,4,90
929,42,2,18,4,101,4,40
930,42,2,19,6,107,1,60
931,42,2,20,5,112,2,50
932,42,2,21,9,121,5,90
933,42,2,22,5,126,1,50
934,42,2,23,8,134,3,80
935,42,2,24,4,138,1,40
936,42,2,25,4,142,2,40
937,42,2,26,4,146,3,40
938,42,2,27,4,150,0,40
939,42,2,28,5,155,1,50
940,42,2,29,6,161,2,60
941,42,2,30,7,168,4,70
942,42,2,31,8,176,0,80
943,42,2,32,9,185,4,90
944,42,2,33,5,190,2,50
945,42,2,34,3,193,1,30
946,42,2,35,7,200,2,70
947,42,2,36,5,205,1,50
948,42,2,37,2,207,2,20
949,42,2,38,4,211,4,40
950,42,2,39,4,215,4,40
951,42,2,40,8,223,1,80
952,42,2,41,6,229,4,60
953,42,2,42,5,234,3,50
954,42,2,43,7,241,3,70
955,42,2,44,9,250,4,90
956,42,2,45,4,254,2,40
957,42,2,46,5,259,1,50
958,42,2,47,8,267,1,80
959,42,2,48,5,272,1,50
960,42,2,49,9,281,3,90
961,42,2,50,4,285,5,40
962,42,2,51,2,287,4,20
963,42,2,52,9,296,1,90
964,42,2,53,2,298,4,20
965,42,2,54,8,306,9,80
966,42,2,55,5,311,5,50
967,42,2,56,2,313,2,20
968,42,2,57,6,319,3,60
969,42,2,58,4,323,1,40
970,42,2,59,3,326,1,30
971,42,2,60,7,333,4,70
972,42,2,61,3,336,4,30
973,42,2,62,5,341,2,50
974,42,2,63,8,349,4,80
975,42,2,64,5,354,4,50
976,42,2,65,7,361,3,70
977,42,2,66,6,367,1,60
978,42,2,67,5,372,3,50
979,42,2,68,2,374,1,20
980,42,2,69,2,376,9,20
981,42,2,70,4,380,2,40
982,42,2,71,9,389,3,90
983,42,2,72,8,397,2,80
984,42,2,73,9,406,6,90
985,42,2,74,4,410,2,40
986,42,2,75,3,413,0,30
987,42,2,76,2,415,1,20
988,42,2,77,4,419,3,40
989,42,2,78,9,428,5,90
990,42,2,79,2,430,2,20
991,42,2,80,2,432,7,20
992,42,2,81,8,440,1,80
993,42,2,82,3,443,1,30
994,42,2,83,8,451,3,80
995,42,2,84,7,458,1,70
996,42,2,85,9,467,4,90
997,42,2,86,4,471,1,40
998,42,2,87,5,476,5,50
999,42,2,88,4,480,1,40
1000,42,2,89,7,487,5,70
1001,42,2,90,2,489,1,20
1002,42,2,91,4,493,2,40
1003,42,2,92,2,495,4,20
1004,42,2,93,4,499,3,40
1005,42,2,94,3,502,3,30
1006,42,2,95,4,506,2,40
1007,42,2,96,7,513,1,70
1008,42,2,97,8,521,1,80
1009,42,2,98,5,526,4,50
1010,42,2,99,7,533,1,70
1011,42,2,100,8,541,1,80
1012,42,2,101,9,550,6,90
1013,42,2,102,6,556,3,60
1014,42,2,103,7,563,3,70
1015,42,2,104,5,568,2,50
1016,42,2,105,8,576,7,80
1017,42,2,106,6,582,3,60
1018,42,2,107,8,590,1,80
1019,42,2,108,6,596,4,60
1020,42,2,109,4,600,4,40
1021,42,2,110,7,607,2,70
1022,42,2,111,4,611,1,40
1023,42,2,112,6,617,1,60
1024,42,2,113,4,621,3,40
1025,42,2,114,5,626,1,50
1026,42,2,115,7,633,4,70
1027,42,2,116,3,636,3,30
1028,42,2,117,8,644,0,80
1029,42,2,118,9,653,8,90
1030,42,2,119,5,658,2,50
1031,42,2,120,2,660,2,20
1032,42,2,121,3,663,1,30
1033,42,2,122,6,669,3,60
1034,42,2,123,4,673,2,40
1035,42,2,124,7,680,2,70
1036,42,2,125,3,683,4,30
1037,42,2,126,4,687,1,40
1038,42,2,127,6,693,3,60
1039,42,2,128,8,701,4,80
1040,42,2,129,3,704,5,30
1041,42,2,130,6,710,1,60
1042,42,2,131,4,714,9,40
1043,42,2,132,2,716,1,20
1044,42,2,133,5,721,3,50
1045,42,2,134,2,723,6,20
1046,42,2,135,3,726,1,30
1047,42,2,136,4,730,2,40
1048,42,2,137,5,735,2,50
1049,42,2,138,8,743,1,80
1050,42,2,139,2,745,4,20
1051,42,2,140,6,751,1,60
1052,42,2,141,9,760,1,90
1053,42,2,142,5,765,4,50
1054,42,2,143,5,770,1,50
1055,42,2,144,6,776,2,60
1056,42,2,145,8,784,4,80
1057,42,2,146,3,787,1,30
1058,42,2,147,4,791,4,40
1059,42,2,148,9,800,1,90
1060,42,2,149,8,808,2,80
1061,42,2,150,2,810,7,20
1062,42,2,151,3,813,2,30
1063,42,2,152,4,817,0,40
1064,42,2,153,9,826,1,90
1065,42,2,154,7,833,2,70
1066,42,2,155,5,838,3,50
1067,42,2,156,3,841,1,30
1068,42,2,157,5,846,1,50
1069,42,2,158,4,850,3,40
1070,42,2,159,4,854,2,40
1071,42,2,160,4,858,1,40
1072,42,2,161,2,860,3,20
1073,42,2,162,5,865,2,50
1074,42,2,163,4,869,4,40
1075,42,2,164,9,878,2,90
1076,42,2,165,3,881,1,30
1077,42,2,166,9,890,3,90
1078,42,2,167,9,899,3,90
1079,42,2,168,7,906,3,70
1080,42,2,169,8,914,2,80
1081,42,2,170,3,917,3,30
1082,42,2,171,3,920,1,30
1083,42,2,172,5,925,1,50
1084,42,2,173,6,931,2,60
1085,42,2,174,9,940,2,90
1086,42,2,175,5,945,5,50
1087,42,2,176,2,947,5,20
1088,42,2,177,6,953,2,60
1089,42,2,178,7,960,0,70
1090,42,2,179,8,968,1,80
1091,42,2,180,6,974,2,60
1092,42,2,181,6,980,2,60
1093,42,2,182,9,989,4,90
1094,42,2,183,4,993,3,40
1095,42,2,184,2,995,4,20
1096,42,2,185,6,1001,2,60
1097,42,2,186,6,1007,4,60
1098,42,2,187,9,1016,0,90
1099,42,2,188,7,1023,4,70
1100,42,2,189,5,1028,5,50
1101,42,2,190,7,1035,3,70
1102,42,2,191,8,1043,1,80
1103,42,2,192,6,1049,4,60
1104,42,2,193,7,1056,4,70
1105,42,2,194,4,1060,1,40
1106,42,2,195,4,1064,1,40
1107,42,2,196,2,1066,2,20
1108,42,2,197,3,1069,2,30
1109,42,2,198,6,1075,1,60
1110,42,2,199,4,1079,3,40
1111,42,2,200,7,1086,1,70
1112,42,2,201,8,1094,1,80
1113,42,2,202,7,1101,5,70
1114,42,2,203,4,1105,7,40
1115,42,2,204,3,1108,1,30
1116,42,2,205,7,1115,4,70
1117,42,2,206,3,1118,1,30
1118,42,2,207,6,1124,2,60
1119,42,2,208,8,1132,2,80
1120,42,2,209,2,1134,3,20
1121,42,2,210,3,1137,4,30
1122,42,2,211,3,1140,2,30
1123,42,2,212,5,1145,2,50
1124,42,2,213,5,1150,1,50
1125,42,2,214,6,1156,4,60
1126,42,2,215,8,1164,1,80
1127,42,2,216,4,1168,1,40
1128,42,2,217,5,1173,1,50
1129,42,2,218,6,1179,4,60
1130,42,2,219,7,1186,3,70
1131,42,2,220,4,1190,2,40
1132,42,2,221,7,1197,4,70
1133,42,2,222,4,1201,4,40
1134,42,2,223,9,1210,3,90
1135,42,2,224,4,1214,4,40
1136,42,2,225,9,1223,3,90
1137,42,2,226,6,1229,5,60
1138,42,2,227,2,1231,3,20
1139,42,2,228,5,1236,4,50
1140,42,2,229,3,1239,2,30
1141,42,2,230,5,1244,6,50
1142,42,2,231,7,1251,1,70
1143,42,2,232,7,1258,0,70
1144,42,2,233,5,1263,2,50
1145,42,2,234,7,1270,1,70
1146,42,2,235,3,1273,6,30
1147,42,2,236,7,1280,1,70
1148,42,2,237,5,1285,1,50
1149,42,2,238,7,1292,3,70
1150,42,2,239,7,1299,3,70
1151,42,2,240,6,1305,5,60
1152,42,2,241,6,1311,1,60
1153,42,2,242,6,1317,6,60
1154,42,2,243,9,1326,3,90
1155,42,2,244,5,1331,1,50
1156,42,2,245,9,1340,2,90
1157,42,2,246,6,1346,1,60
1158,42,2,247,6,1352,7,60
1159,42,2,248,3,1355,5,30
1160,42,2,249,8,1363,1,80
1161,42,2,250,9,1372,4,90
1162,42,2,251,2,1374,3,20
1163,42,2,252,7,1381,6,70
1164,42,2,253,5,1386,3,50
1165,42,2,254,2,1388,2,20
1166,42,2,255,8,1396,3,80
1167,42,2,256,8,1404,1,80
1168,42,2,257,2,1406,2,20
1169,42,2,258,5,1411,2,50
1170,42,2,259,3,1414,3,30
1171,42,2,260,6,1420,1,60
1172,42,2,261,5,1425,4,50
1173,42,2,262,7,1432,1,70
1174,42,2,263,8,1440,3,80
1175,42,2,264,5,1445,3,50
1176,42,2,265,9,1454,3,90
1177,42,2,266,5,1459,1,50
1178,42,2,267,2,1461,4,20
1179,42,2,268,9,1470,4,90
1180,42,2,269,8,1478,0,80
1181,42,2,270,9,1487,4,90
1182,42,2,271,3,1490,2,30
1183,42,2,272,3,1493,2,30
1184,42,2,273,4,1497,4,40
1185,42,2,274,4,1501,1,40
1186,42,2,275,5,1506,0,50
1187,42,2,276,5,1511,0,50
1188,42,2,277,8,1519,3,80
1189,42,2,278,4,1523,2,40
1190,42,2,279,3,1526,0,30
1191,42,2,280,7,1533,2,70
1192,42,2,281,8,1541,2,80
1193,42,2,282,4,1545,4,40
1194,42,2,283,3,1548,1,30
1195,42,2,284,2,1550,0,20
1196,42,2,285,2,1552,3,20
1197,42,2,286,6,1558,3,60
1198,42,2,287,9,1567,3,90
1199,42,2,288,6,1573,4,60
1200,42,2,289,6,1579,4,60
1201,42,2,290,9,1588,1,90
1202,42,2,291,5,1593,1,50
1203,42,2,292,8,1601,3,80
1204,42,2,293,6,1607,2,60
1205,42,2,294,4,1611,3,40
1206,42,2,295,4,1615,3,40
1207,42,2,296,2,1617,1,20
1208,42,2,297,7,1624,2,70
1209,42,2,298,2,1626,2,20
1210,42,2,299,3,1629,1,30
1211,42,2,300,5,1634,2,50
1212,42,2,301,9,1643,2,90
1213,42,2,302,5,1648,3,50
1214,42,2,303,2,1650,5,20
1215,42,2,304,2,1652,2,20
1216,42,2,305,2,1654,4,20
1217,42,2,306,6,1660,0,60
1218,42,2,307,8,1668,1,80
1219,42,2,308,3,1671,8,30
1220,42,2,309,7,1678,1,70
1221,42,2,310,6,1684,2,60
1222,42,2,311,7,1691,3,70
1223,42,2,312,2,1693,1,20
1224,42,2,313,7,1700,3,70
1225,42,2,314,3,1703,2,30
1226,42,2,315,3,1706,4,30
1227,42,2,316,8,1714,4,80
1228,42,2,317,8,1722,1,80
1229,42,2,318,4,1726,2,40
1230,42,2,319,9,1735,1,90
1231,42,2,320,5,1740,4,50
1232,42,2,321,8,1748,2,80
1233,42,2,322,3,1751,1,30
1234,42,2,323,7,1758,2,70
1235,42,2,324,8,1766,4,80
1236,42,2,325,2,1768,2,20
1237,42,2,326,5,1773,7,50
1238,42,2,327,8,1781,3,80
1239,42,2,328,9,1790,4,90
1240,42,2,329,9,1799,2,90
1241,42,2,330,6,1805,4,60
1242,42,2,331,7,1812,1,70
1243,42,2,332,7,1819,4,70
1244,42,2,333,5,1824,6,50
1245,42,2,334,4,1828,4,40
1246,42,2,335,4,1832,2,40
1247,42,2,336,9,1841,0,90
1248,42,2,337,5,1846,4,50
1249,42,2,338,7,1853,4,70
1250,42,2,339,6,1859,1,60
1251,42,2,340,4,1863,3,40
1252,42,2,341,7,1870,4,70
1253,42,2,342,3,1873,5,30
1254,42,2,343,7,1880,1,70
1255,42,2,344,6,1886,1,60
1256,42,2,345,7,1893,5,70
1257,42,2,346,7,1900,3,70
1258,42,2,347,3,1903,5,30
1259,42,2,348,8,1911,4,80
1260,42,2,349,3,1914,3,30
1261,42,2,350,8,1922,2,80
1262,42,2,351,9,1931,6,90
1263,42,2,352,8,1939,2,80
1264,42,2,353,3,1942,0,30
1265,42,2,354,8,1950,1,80
1266,42,2,355,9,1959,1,90
1267,42,2,356,7,1966,3,70
1268,42,2,357,3,1969,3,30
1269,42,2,358,8,1977,5,80
1270,42,2,359,4,1981,2,40
1271,42,2,360,3,1984,2,30
1272,42,2,361,4,1988,3,40
1273,42,2,362,9,1997,4,90
1274,42,2,363,6,2003,4,60
1275,42,2,364,4,2007,4,40
1276,42,2,365,3,2010,2,30
1277,42,2,366,4,2014,4,40
1278,42,2,367,2,2016,0,20
1279,42,2,368,2,2018,3,20
1280,42,2,369,3,2021,1,30
1281,42,2,370,9,2030,1,90
1282,42,2,371,9,2039,4,90
1283,42,2,372,3,2042,3,30
1284,42,2,373,9,2051,0,90
1285,42,2,374,8,2059,2,80
1286,42,2,375,6,2065,6,60
1287,42,2,376,7,2072,3,70
1288,42,2,377,7,2079,1,70
1289,42,2,378,6,2085,1,60
1290,42,2,379,6,2091,6,60
1291,42,2,380,6,2097,4,60
1292,42,2,381,8,2105,3,80
1293,42,2,382,2,2107,4,20
1294,42,2,383,6,2113,3,60
1295,42,2,384,6,2119,1,60
1296,42,2,385,9,2128,8,90
1297,42,2,386,2,2130,5,20
1298,42,2,387,2,2132,2,20
1299,42,2,388,4,2136,1,40
1300,42,2,389,8,2144,2,80
1301,42,2,390,4,2148,4,40
1302,42,2,391,4,2152,3,40
1303,42,2,392,6,2158,1,60
1304,42,2,393,9,2167,3,90
1305,42,2,394,6,2173,2,60
1306,42,2,395,5,2178,4,50
1307,42,2,396,3,2181,7,30
1308,42,2,397,2,2183,2,20
1309,42,2,398,3,2186,1,30
1310,42,2,399,6,2192,3,60
1311,42,2,400,5,2197,1,50
1312,42,2,401,8,2205,5,80
1313,42,2,402,7,2212,5,70
1314,42,2,403,5,2217,5,50
1315,42,2,404,8,2225,4,80
1316,42,2,405,7,2232,3,70
1317,42,2,406,3,2235,5,30
1318,42,2,407,5,2240,4,50
1319,42,2,408,4,2244,1,40
1320,42,2,409,4,2248,5,40
1321,42,2,410,4,2252,2,40
1322,42,2,411,2,2254,1,20
1323,42,2,412,5,2259,1,50
1324,42,2,413,4,2263,1,40
1325,42,2,414,6,2269,1,60
1326,42,2,415,2,2271,1,20
1327,42,2,416,7,2278,4,70
1328,42,2,417,8,2286,2,80
1329,42,2,418,9,2295,4,90
1330,42,2,419,7,2302,4,70
1331,42,2,420,3,2305,2,30
1332,42,2,421,6,2311,5,60
1333,42,2,422,3,2314,5,30
1334,42,2,423,4,2318,4,40
1335,42,2,424,9,2327,4,90
1336,42,2,425,8,2335,1,80
1337,42,2,426,4,2339,0,40
1338,42,2,427,8,2347,5,80
1339,42,2,428,4,2351,3,40
1340,42,2,429,6,2357,5,60
1341,42,2,430,9,2366,6,90
1342,42,2,431,4,2370,1,40
1343,42,2,432,3,2373,3,30
1344,42,2,433,3,2376,2,30
1345,42,2,434,5,2381,3,50
1346,42,2,435,7,2388,2,70
1347,42,2,436,8,2396,6,80
1348,42,2,437,3,2399,2,30
1349,42,2,438,8,2407,2,80
1350,42,2,439,9,2416,1,90
1351,42,2,440,6,2422,4,60
1352,42,2,441,9,2431,3,90
1353,42,2,442,6,2437,2,60
1354,42,2,443,5,2442,1,50
1355,42,2,444,9,2451,4,90
1356,42,2,445,6,2457,1,60
1357,42,2,446,4,2461,4,40
1358,42,2,447,5,2466,6,50
1359,42,2,448,7,2473,2,70
1360,42,2,449,3,2476,1,30
1361,42,2,450,9,2485,6,90
1362,42,2,451,8,2493,6,80
1363,42,2,452,4,2497,3,40
1364,42,2,453,8,2505,4,80
1365,42,2,454,9,2514,4,90
1366,42,2,455,5,2519,4,50
1367,42,2,456,6,2525,5,60
1368,42,2,457,5,2530,6,50
1369,42,2,458,9,2539,5,90
1370,42,2,459,6,2545,5,60
1371,42,2,460,9,2554,4,90
1372,42,2,461,8,2562,1,80
1373,42,2,462,7,2569,4,70
1374,42,2,463,3,2572,3,30
1375,42,2,464,8,2580,3,80
1376,42,2,465,6,2586,2,60
1377,42,2,466,5,2591,1,50
1378,42,2,467,8,2599,5,80
1379,42,2,468,2,2601,1,20
1380,42,2,469,8,2609,1,80
1381,42,2,470,2,2611,4,20
1382,42,2,471,6,2617,2,60
1383,42,2,472,6,2623,1,60
1384,42,2,473,8,2631,1,80
1385,42,2,474,8,2639,1,80
1386,42,2,475,5,2644,1,50
1387,42,2,476,9,2653,8,90
1388,42,2,477,6,2659,5,60
1389,42,2,478,3,2662,6,30
1390,42,2,479,6,2668,1,60
1391,42,2,480,3,2671,9,30
1392,42,2,481,9,2680,5,90
1393,42,2,482,2,2682,1,20
1394,42,2,483,7,2689,2,70
1395,42,2,484,4,2693,1,40
1396,42,2,485,5,2698,2,50
1397,42,2,486,6,2704,2,60
1398,42,2,487,7,2711,1,70
1399,42,2,488,7,2718,1,70
1400,42,2,489,9,2727,3,90
1401,42,2,490,9,2736,1,90
1402,42,2,491,2,2738,3,20
1403,42,2,492,3,2741,1,30
1404,42,2,493,4,2745,2,40
1405,42,2,494,7,2752,2,70
1406,42,2,495,9,2761,4,90
1407,42,2,496,7,2768,2,70
1408,42,2,497,7,2775,4,70
1409,42,2,498,3,2778,3,30
1410,42,2,499,8,2786,1,80
1411,42,2,500,2,2788,1,20
1412,42,2,501,8,2796,1,80
1413,42,2,502,8,2804,5,80
1414,42,2,503,8,2812,2,80
1415,42,2,504,2,2814,4,20
1416,42,2,505,4,2818,1,40
1417,42,2,506,5,2823,1,50
1418,42,2,507,4,2827,4,40
1419,42,2,508,3,2830,5,30
1420,42,2,509,4,2834,1,40
1421,42,2,510,2,2836,3,20
1422,42,2,511,5,2841,3,50
1423,42,2,512,3,2844,5,30
1424,42,2,513,8,2852,0,80
1425,42,2,514,2,2854,5,20
1426,42,2,515,4,2858,1,40
1427,42,2,516,7,2865,1,70
1428,42,2,517,4,2869,6,40
1429,42,2,518,4,2873,3,40
1430,42,2,519,5,2878,1,50
1431,42,2,520,6,2884,1,60
1432,42,2,521,4,2888,2,40
1433,42,2,522,2,2890,1,20
1434,42,2,523,9,2899,6,90
1435,42,2,524,4,2903,1,40
1436,42,2,525,8,2911,1,80
1437,42,2,526,4,2915,1,40
1438,42,2,527,8,2923,2,80
1439,42,2,528,4,2927,3,40
1440,42,2,529,5,2932,9,50
1441,42,2,530,3,2935,3,30
1442,42,2,531,9,2944,0,90
1443,42,2,532,9,2953,3,90
1444,42,2,533,8,2961,2,80
1445,42,2,534,6,2967,5,60
1446,42,2,535,9,2976,1,90
1447,42,2,536,7,2983,1,70
1448,42,2,537,9,2992,4,90
1449,42,2,538,9,3001,4,90
1450,42,2,539,5,3006,2,50
1451,42,2,540,2,3008,1,20
1452,42,2,541,5,3013,1,50
1453,42,2,542,9,3022,2,90
1454,42,2,543,7,3029,3,70
1455,42,2,544,8,3037,7,80
1456,42,2,545,9,3046,4,90
1457,42,2,546,4,3050,3,40
1458,42,2,547,6,3056,4,60
1459,42,2,548,2,3058,5,20
1460,42,2,549,3,3061,0,30
1461,42,2,550,3,3064,3,30
1462,42,2,551,8,3072,1,80
1463,42,2,552,2,3074,1,20
1464,42,2,553,7,3081,8,70
1465,42,2,554,3,3084,1,30
1466,42,2,555,9,3093,2,90
1467,42,2,556,2,3095,1,20
1468,42,2,557,2,3097,3,20
1469,42,2,558,6,3103,2,60
1470,42,2,559,5,3108,1,50
1471,42,2,560,5,3113,0,50
1472,42,2,561,2,3115,4,20
1473,42,2,562,2,3117,1,20
1474,42,2,563,4,3121,1,40
1475,42,2,564,3,3124,2,30
1476,42,2,565,6,3130,1,60
1477,42,2,566,7,3137,6,70
1478,42,2,567,9,3146,2,90
1479,42,2,568,4,3150,2,40
1480,42,2,569,8,3158,1,80
1481,42,2,570,4,3162,1,40
1482,42,2,571,5,3167,4,50
1483,42,2,572,5,3172,5,50
1484,42,2,573,6,3178,3,60
1485,42,2,574,8,3186,5,80
1486,42,2,575,7,3193,6,70
1487,42,2,576,7,3200,3,70
1488,42,2,577,8,3208,3,80
1489,42,2,578,7,3215,2,70
1490,42,2,579,2,3217,2,20
1491,42,2,580,7,3224,1,70
1492,42,2,581,3,3227,5,30
1493,42,2,582,3,3230,3,30
1494,42,2,583,4,3234,3,40
1495,42,2,584,7,3241,1,70
1496,42,2,585,7,3248,4,70
1497,42,2,586,5,3253,4,50
1498,42,2,587,2,3255,1,20
1499,42,2,588,8,3263,4,80
1500,42,2,589,6,3269,2,60
1501,42,2,590,3,3272,1,30
1502,42,2,591,6,3278,3,60
1503,42,2,592,9,3287,2,90
1504,42,2,593,2,3289,4,20
1505,42,2,594,5,3294,1,50
1506,42,2,595,4,3298,3,40
1507,42,2,596,9,3307,3,90
1508,42,2,597,7,3314,5,70
1509,42,2,598,9,3323,5,90
1510,42,2,599,3,3326,5,30
1511,42,2,600,9,3335,0,90
1512,42,2,601,2,3337,1,20
1513,42,2,602,8,3345,1,80
1514,42,2,603,9,3354,2,90
1515,42,2,604,5,3359,4,50
1516,42,2,605,8,3367,5,80
1517,42,2,606,7,3374,1,70
1518,42,2,607,9,3383,9,90
1519,42,2,608,2,3385,1,20
1520,42,2,609,4,3389,3,40
1521,42,2,610,9,3398,6,90
1522,42,2,611,5,3403,1,50
1523,42,2,612,8,3411,3,80
1524,42,2,613,6,3417,4,60
1525,42,2,614,9,3426,8,90
1526,42,2,615,2,3428,1,20
1527,42,2,616,9,3437,8,90
1528,42,2,617,4,3441,3,40
1529,42,2,618,3,3444,3,30
1530,42,2,619,7,3451,1,70
1531,42,2,620,7,3458,1,70
1532,42,2,621,5,3463,5,50
1533,42,2,622,8,3471,8,80
1534,42,2,623,9,3480,5,90
1535,42,2,624,6,3486,3,60
1536,42,2,625,3,3489,1,30
1537,42,2,626,8,3497,0,80
1538,42,2,627,9,3506,6,90
1539,42,2,628,5,3511,1,50
1540,42,2,629,6,3517,5,60
1541,42,2,630,5,3522,2,50
1542,42,2,631,3,3525,1,30
1543,42,2,632,7,3532,2,70
1544,42,2,633,2,3534,2,20
1545,42,2,634,6,3540,1,60
1546,42,2,635,6,3546,1,60
1547,42,2,636,9,3555,5,90
1548,42,2,637,2,3557,4,20
1549,42,2,638,9,3566,4,90
1550,42,2,639,7,3573,2,70
1551,42,2,640,4,3577,2,40
1552,42,2,641,2,3579,3,20
1553,42,2,642,8,3587,3,80
1554,42,2,643,7,3594,2,70
1555,42,2,644,5,3599,5,50
1556,42,2,645,6,3605,6,60
1557,42,2,646,3,3608,1,30
1558,42,2,647,5,3613,5,50
1559,42,2,648,2,3615,2,20
1560,42,2,649,8,3623,3,80
1561,42,2,650,9,3632,4,90
1562,42,2,651,3,3635,4,30
1563,42,2,652,3,3638,4,30
1564,42,2,653,8,3646,1,80
1565,42,2,654,2,3648,2,20
1566,42,2,655,5,3653,1,50
1567,42,2,656,4,3657,6,40
1568,42,2,657,6,3663,2,60
1569,42,2,658,8,3671,3,80
1570,42,2,659,8,3679,2,80
1571,42,2,660,9,3688,2,90
1572,42,2,661,5,3693,4,50
1573,42,2,662,3,3696,1,30
1574,42,2,663,9,3705,3,90
1575,42,2,664,5,3710,5,50
1576,42,2,665,9,3719,4,90
1577,42,2,666,2,3721,1,20
1578,42,2,667,3,3724,2,30
1579,42,2,668,6,3730,1,60
1580,42,2,669,8,3738,2,80
1581,42,2,670,8,3746,5,80
1582,42,2,671,2,3748,1,20
1583,42,2,672,4,3752,5,40
1584,42,2,673,3,3755,4,30
1585,42,2,674,8,3763,3,80
1586,42,2,675,5,3768,2,50
1587,42,2,676,2,3770,1,20
1588,42,2,677,2,3772,2,20
1589,42,2,678,9,3781,5,90
1590,42,2,679,3,3784,4,30
1591,42,2,680,2,3786,2,20
1592,42,2,681,2,3788,2,20
1593,42,2,682,3,3791,0,30
1594,42,2,683,5,3796,1,50
1595,42,2,684,4,3800,1,40
1596,42,2,685,8,3808,4,80
1597,42,2,686,4,3812,1,40
1598,42,2,687,5,3817,2,50
1599,42,2,688,7,3824,3,70
1600,42,2,689,9,3833,3,90
1601,42,2,690,3,3836,3,30
1602,42,2,691,7,3843,3,70
1603,42,2,692,3,3846,4,30
1604,42,2,693,4,3850,4,40
1605,42,2,694,6,3856,3,60
1606,42,2,695,9,3865,4,90
1607,42,2,696,2,3867,3,20
1608,42,2,697,2,3869,1,20
1609,42,2,698,5,3874,5,50
1610,42,2,699,2,3876,1,20
1611,42,2,700,4,3880,2,40
1612,42,2,701,9,3889,1,90
1613,42,2,702,5,3894,1,50
1614,42,2,703,2,3896,1,20
1615,42,2,704,3,3899,4,30
1616,42,2,705,6,3905,2,60
1617,42,2,706,8,3913,1,80
1618,42,2,707,3,3916,4,30
1619,42,2,708,3,3919,5,30
1620,42,2,709,4,3923,4,40
1621,42,2,710,2,3925,4,20
1622,42,2,711,7,3932,1,70
1623,42,2,712,3,3935,2,30
1624,42,2,713,9,3944,1,90
1625,42,2,714,2,3946,4,20
1626,42,2,715,2,3948,2,20
1627,42,2,716,2,3950,3,20
1628,42,2,717,8,3958,9,80
1629,42,2,718,2,3960,0,20
1630,42,2,719,4,3964,2,40
1631,42,2,720,2,3966,1,20
1632,42,2,721,2,3968,1,20
1633,42,2,722,6,3974,1,60
1634,42,2,723,6,3980,3,60
1635,42,2,724,8,3988,1,80
1636,42,2,725,7,3995,1,70
1637,42,2,726,9,4004,8,90
1638,42,2,727,5,4009,4,50
1639,42,2,728,3,4012,4,30
1640,42,2,729,3,4015,2,30
1641,42,2,730,5,4020,2,50
1642,42,2,731,9,4029,1,90
1643,42,2,732,4,4033,1,40
1644,42,2,733,5,4038,3,50
1645,42,2,734,6,4044,0,60
1646,42,2,735,7,4051,1,70
1647,42,2,736,8,4059,3,80
1648,42,2,737,7,4066,5,70
1649,42,2,738,3,4069,1,30
1650,42,2,739,3,4072,1,30
1651,42,2,740,5,4077,2,50
1652,42,2,741,4,4081,5,40
1653,42,2,742,5,4086,4,50
1654,42,2,743,6,4092,1,60
1655,42,2,744,2,4094,3,20
1656,42,2,745,9,4103,4,90
1657,42,2,746,2,4105,1,20
1658,42,2,747,6,4111,1,60
1659,42,2,748,3,4114,5,30
1660,42,2,749,3,4117,0,30
1661,42,2,750,8,4125,4,80
1662,42,2,751,5,4130,1,50
1663,42,2,752,9,4139,6,90
1664,42,2,753,9,4148,7,90
1665,42,2,754,4,4152,3,40
1666,42,2,755,9,4161,2,90
1667,42,2,756,5,4166,3,50
1668,42,2,757,6,4172,6,60
1669,42,2,758,7,4179,3,70
1670,42,2,759,2,4181,0,20
1671,42,2,760,8,4189,4,80
1672,42,2,761,6,4195,2,60
1673,42,2,762,9,4204,4,90
1674,42,2,763,7,4211,4,70
1675,42,2,764,6,4217,2,60
1676,42,2,765,7,4224,2,70
1677,42,2,766,7,4231,0,70
1678,42,2,767,9,4240,3,90
1679,42,2,768,3,4243,1,30
1680,42,2,769,2,4245,5,20
1681,42,2,770,7,4252,1,70
1682,42,2,771,3,4255,1,30
1683,42,2,772,5,4260,7,50
1684,42,2,773,6,4266,1,60
1685,42,2,774,8,4274,1,80
1686,42,2,775,7,4281,2,70
1687,42,2,776,7,4288,1,70
1688,42,2,777,2,4290,3,20
1689,42,2,778,5,4295,1,50
1690,42,2,779,5,4300,4,50
1691,42,2,780,2,4302,1,20
1692,42,2,781,8,4310,3,80
1693,42,2,782,7,4317,6,70
1694,42,2,783,2,4319,5,20
1695,42,2,784,2,4321,1,20
1696,42,2,785,2,4323,5,20
1697,42,2,786,2,4325,2,20
1698,42,2,787,3,4328,1,30
1699,42,2,788,2,4330,1,20
1700,42,2,789,2,4332,1,20
1701,42,2,790,8,4340,2,80
1702,42,2,791,6,4346,0,60
1703,42,2,792,7,4353,2,70
1704,42,2,793,3,4356,1,30
1705,42,2,794,9,4365,5,90
1706,42,2,795,5,4370,2,50
1707,42,2,796,6,4376,1,60
1708,42,2,797,5,4381,4,50
1709,42,2,798,5,4386,0,50
1710,42,2,799,9,4395,1,90
1711,42,2,800,2,4397,1,20
1712,42,2,801,5,4402,3,50
1713,42,2,802,2,4404,3,20
1714,42,2,803,3,4407,1,30
1715,42,2,804,3,4410,0,30
1716,42,2,805,7,4417,2,70
1717,42,2,806,6,4423,2,60
1718,42,2,807,2,4425,1,20
1719,42,2,808,2,4427,3,20
1720,42,2,809,4,4431,1,40
1721,42,2,810,3,4434,2,30
1722,42,2,811,8,4442,5,80
1723,42,2,812,5,4447,3,50
1724,42,2,813,2,4449,2,20
1725,42,2,814,4,4453,3,40
1726,42,2,815,9,4462,2,90
1727,42,2,816,4,4466,5,40
1728,42,2,817,9,4475,3,90
1729,42,2,818,4,4479,3,40
1730,42,2,819,3,4482,2,30
1731,42,2,820,4,4486,3,40
1732,42,2,821,5,4491,4,50
1733,42,2,822,5,4496,0,50
1734,42,2,823,7,4503,3,70
1735,42,2,824,8,4511,3,80
1736,42,2,825,5,4516,1,50
1737,42,2,826,4,4520,0,40
1738,42,2,827,4,4524,3,40
1739,42,2,828,3,4527,3,30
1740,42,2,829,3,4530,1,30
1741,42,2,830,4,4534,2,40
1742,42,2,831,5,4539,2,50
1743,42,2,832,6,4545,1,60
1744,42,2,833,9,4554,1,90
1745,42,2,834,2,4556,0,20
1746,42,2,835,4,4560,1,40
1747,42,2,836,5,4565,0,50
1748,42,2,837,8,4573,2,80
1749,42,2,838,5,4578,5,50
1750,42,2,839,8,4586,6,80
1751,42,2,840,3,4589,3,30
1752,42,2,841,9,4598,2,90
1753,42,2,842,4,4602,4,40
1754,42,2,843,8,4610,4,80
1755,42,2,844,7,4617,4,70
1756,42,2,845,5,4622,3,50
1757,42,2,846,7,4629,2,70
1758,42,2,847,8,4637,5,80
1759,42,2,848,5,4642,3,50
1760,42,2,849,5,4647,4,50
1761,42,2,850,4,4651,1,40
1762,42,2,851,7,4658,1,70
1763,42,2,852,2,4660,0,20
1764,42,2,853,2,4662,6,20
1765,42,2,854,2,4664,0,20
1766,42,2,855,2,4666,2,20
1767,42,2,856,5,4671,4,50
1768,42,2,857,8,4679,1,80
1769,42,2,858,9,4688,2,90
1770,42,2,859,2,4690,4,20
1771,42,2,860,5,4695,3,50
1772,42,2,861,8,4703,3,80
1773,42,2,862,4,4707,4,40
1774,42,2,863,3,4710,2,30
1775,42,2,864,9,4719,0,90
1776,42,2,865,9,4728,9,90
1777,42,2,866,9,4737,2,90
1778,42,2,867,4,4741,1,40
1779,42,2,868,3,4744,2,30
1780,42,2,869,6,4750,1,60
1781,42,2,870,4,4754,2,40
1782,42,2,871,9,4763,4,90
1783,42,2,872,3,4766,6,30
1784,42,2,873,4,4770,3,40
1785,42,2,874,2,4772,3,20
1786,42,2,875,6,4778,1,60
1787,42,2,876,9,4787,5,90
1788,42,2,877,3,4790,4,30
1789,42,2,878,7,4797,3,70
1790,42,2,879,8,4805,5,80
1791,42,2,880,6,4811,4,60
1792,42,2,881,9,4820,3,90
1793,42,2,882,9,4829,5,90
1794,42,2,883,6,4835,2,60
1795,42,2,884,9,4844,3,90
1796,42,2,885,9,4853,9,90
1797,42,2,886,4,4857,1,40
1798,42,2,887,9,4866,5,90
1799,42,2,888,8,4874,1,80
1800,42,2,889,7,4881,1,70
1801,42,2,890,6,4887,1,60
1802,42,2,891,6,4893,6,60
1803,42,2,892,4,4897,1,40
1804,42,2,893,3,4900,2,30
1805,42,2,894,4,4904,3,40
1806,42,2,895,9,4913,5,90
1807,42,2,896,9,4922,5,90
1808,42,2,897,7,4929,1,70
1809,42,2,898,9,4938,3,90
1810,42,2,899,6,4944,5,60
1811,42,2,900,9,4953,6,90
1812,42,2,901,3,4956,3,30
1813,42,2,902,6,4962,4,60
1814,42,2,903,4,4966,5,40
1815,42,2,904,8,4974,2,80
1816,42,2,905,4,4978,5,40
1817,42,2,906,3,4981,1,30
1818,42,2,907,2,4983,1,20
1819,42,2,908,7,4990,0,70
1820,42,2,909,4,4994,2,40
1821,42,2,910,3,4997,1,30
1822,42,3,1,3,3,0,30
1823,42,3,2,9,12,1,90
1824,42,3,3,9,21,5,90
1825,42,3,4,2,23,2,20
1826,42,3,5,2,25,3,20
1827,42,3,6,3,28,6,30
1828,42,3,7,5,33,2,50
1829,42,3,8,2,35,2,20
1830,42,3,9,9,44,4,90
1831,42,3,10,2,46,2,20
1832,42,3,11,5,51,4,50
1833,42,3,12,4,55,1,40
1834,42,3,13,4,59,3,40
1835,42,3,14,8,67,0,80
1836,42,3,15,3,70,5,30
1837,42,3,16,4,74,3,40
1838,42,3,17,3,77,0,30
1839,42,3,18,5,82,1,50
1840,42,3,19,3,85,2,30
1841,42,3,20,7,92,1,70
1842,42,3,21,6,98,9,60
1843,42,3,22,4,102,2,40
1844,42,3,23,8,110,7,80
1845,42,3,24,3,113,1,30
1846,42,3,25,4,117,0,40
1847,42,3,26,5,122,4,50
1848,42,3,27,4,126,0,40
1849,42,3,28,8,134,1,80
1850,42,3,29,4,138,2,40
1851,42,3,30,8,146,2,80
1852,42,3,31,2,148,1,20
1853,42,3,32,5,153,1,50
1854,42,3,33,4,157,2,40
1855,42,3,34,7,164,1,70
1856,42,3,35,6,170,2,60
1857,42,3,36,5,175,1,50
1858,42,3,37,4,179,4,40
1859,42,3,38,4,183,3,40
1860,42,3,39,6,189,8,60
1861,42,3,40,9,198,2,90
1862,42,3,41,2,200,0,20
1863,42,3,42,2,202,3,20
1864,42,3,43,7,209,1,70
1865,42,3,44,4,213,4,40
1866,42,3,45,7,220,3,70
1867,42,3,46,3,223,3,30
1868,42,3,47,8,231,3,80
1869,42,3,48,4,235,4,40
1870,42,3,49,7,242,0,70
1871,42,3,50,5,247,3,50
1872,42,3,51,7,254,1,70
1873,42,3,52,9,263,7,90
1874,42,3,53,4,267,4,40
1875,42,3,54,9,276,4,90
1876,42,3,55,6,282,1,60
1877,42,3,56,2,284,3,20
1878,42,3,57,4,288,3,40
1879,42,3,58,3,291,5,30
1880,42,3,59,8,299,4,80
1881,42,3,60,3,302,0,30
1882,42,3,61,7,309,3,70
1883,42,3,62,6,315,3,60
1884,42,3,63,6,321,0,60
1885,42,3,64,2,323,1,20
1886,42,3,65,2,325,2,20
1887,42,3,66,3,328,2,30
1888,42,3,67,5,333,4,50
1889,42,3,68,3,336,1,30
1890,42,3,69,8,344,1,80
1891,42,3,70,7,351,0,70
1892,42,3,71,4,355,1,40
1893,42,3,72,7,362,1,70
1894,42,3,73,7,369,3,70
1895,42,3,74,7,376,5,70
1896,42,3,75,9,385,1,90
1897,42,3,76,6,391,1,60
1898,42,3,77,6,397,1,60
1899,42,3,78,6,403,6,60
1900,42,3,79,3,406,2,30
1901,42,3,80,6,412,5,60
1902,42,3,81,4,416,1,40
1903,42,3,82,8,424,2,80
1904,42,3,83,9,433,1,90
1905,42,3,84,3,436,1,30
1906,42,3,85,9,445,9,90
1907,42,3,86,5,450,3,50
1908,42,3,87,9,459,4,90
1909,42,3,88,8,467,6,80
1910,42,3,89,3,470,5,30
1911,42,3,90,8,478,3,80
1912,42,3,91,6,484,3,60
1913,42,3,92,4,488,4,40
1914,42,3,93,4,492,4,40
1915,42,3,94,8,500,3,80
1916,42,3,95,5,505,2,50
1917,42,3,96,5,510,0,50
1918,42,3,97,8,518,7,80
1919,42,3,98,7,525,1,70
1920,42,3,99,7,532,2,70
1921,42,3,100,9,541,1,90
1922,42,3,101,7,548,7,70
1923,42,3,102,6,554,3,60
1924,42,3,103,5,559,1,50
1925,42,3,104,4,563,1,40
1926,42,3,105,8,571,3,80
1927,42,3,106,6,577,3,60
1928,42,3,107,9,586,2,90
1929,42,3,108,5,591,9,50
1930,42,3,109,2,593,7,20
1931,42,3,110,8,601,1,80
1932,42,3,111,7,608,2,70
1933,42,3,112,6,614,10,60
1934,42,3,113,3,617,4,30
1935,42,3,114,7,624,3,70
1936,42,3,115,6,630,8,60
1937,42,3,116,2,632,2,20
1938,42,3,117,3,635,1,30
1939,42,3,118,9,644,4,90
1940,42,3,119,9,653,2,90
1941,42,3,120,3,656,4,30
1942,42,3,121,5,661,3,50
1943,42,3,122,3,664,2,30
1944,42,3,123,6,670,2,60
1945,42,3,124,4,674,4,40
1946,42,3,125,8,682,2,80
1947,42,3,126,7,689,2,70
1948,42,3,127,6,695,6,60
1949,42,3,128,3,698,3,30
1950,42,3,129,2,700,5,20
1951,42,3,130,4,704,5,40
1952,42,3,131,7,711,1,70
1953,42,3,132,8,719,2,80
1954,42,3,133,7,726,3,70
1955,42,3,134,7,733,1,70
1956,42,3,135,9,742,4,90
1957,42,3,136,3,745,2,30
1958,42,3,137,6,751,2,60
1959,42,3,138,3,754,3,30
1960,42,3,139,6,760,1,60
1961,42,3,140,6,766,2,60
1962,42,3,141,4,770,4,40
1963,42,3,142,3,773,1,30
1964,42,3,143,7,780,4,70
1965,42,3,144,2,782,1,20
1966,42,3,145,2,784,1,20
1967,42,3,146,5,789,3,50
1968,42,3,147,2,791,1,20
1969,42,3,148,6,797,2,60
1970,42,3,149,4,801,1,40
1971,42,3,150,4,805,1,40
1972,42,3,151,9,814,1,90
1973,42,3,152,9,823,5,90
1974,42,3,153,6,829,3,60
1975,42,3,154,2,831,1,20
1976,42,3,155,7,838,4,70
1977,42,3,156,3,841,2,30
1978,42,3,157,6,847,3,60
1979,42,3,158,5,852,6,50
1980,42,3,159,3,855,7,30
1981,42,3,160,5,860,1,50
1982,42,3,161,6,866,1,60
1983,42,3,162,6,872,5,60
1984,42,3,163,8,880,4,80
1985,42,3,164,8,888,4,80
1986,42,3,165,3,891,4,30
1987,42,3,166,8,899,1,80
1988,42,3,167,4,903,2,40
1989,42,3,168,4,907,5,40
1990,42,3,169,3,910,1,30
1991,42,3,170,9,919,4,90
1992,42,3,171,6,925,5,60
1993,42,3,172,6,931,1,60
1994,42,3,173,8,939,5,80
1995,42,3,174,2,941,1,20
1996,42,3,175,3,944,2,30
1997,42,3,176,2,946,3,20
1998,42,3,177,4,950,5,40
1999,42,3,178,9,959,5,90
2000,42,3,179,2,961,3,20
2001,42,3,180,5,966,3,50
2002,42,3,181,6,972,1,60
2003,42,3,182,5,977,1,50
2004,42,3,183,4,981,2,40
2005,42,3,184,2,983,1,20
2006,42,3,185,6,989,1,60
2007,42,3,186,3,992,4,30
2008,42,3,187,7,999,2,70
2009,42,3,188,6,1005,1,60
2010,42,3,189,2,1007,0,20
2011,42,3,190,7,1014,4,70
2012,42,3,191,9,1023,1,90
2013,42,3,192,5,1028,6,50
2014,42,3,193,6,1034,1,60
2015,42,3,194,3,1037,5,30
2016,42,3,195,5,1042,1,50
2017,42,3,196,3,1045,5,30
2018,42,3,197,2,1047,2,20
2019,42,3,198,2,1049,2,20
2020,42,3,199,9,1058,4,90
2021,42,3,200,7,1065,4,70
2022,42,3,201,7,1072,2,70
2023,42,3,202,9,1081,2,90
2024,42,3,203,5,1086,3,50
2025,42,3,204,5,1091,3,50
2026,42,3,205,9,1100,6,90
2027,42,3,206,4,1104,0,40
2028,42,3,207,9,1113,1,90
2029,42,3,208,6,1119,3,60
2030,42,3,209,8,1127,1,80
2031,42,3,210,6,1133,5,60
2032,42,3,211,9,1142,1,90
2033,42,3,212,8,1150,4,80
2034,42,3,213,8,1158,5,80
2035,42,3,214,7,1165,2,70
2036,42,3,215,2,1167,3,20
2037,42,3,216,4,1171,1,40
2038,42,3,217,7,1178,2,70
2039,42,3,218,4,1182,2,40
2040,42,3,219,4,1186,2,40
2041,42,3,220,6,1192,1,60
2042,42,3,221,6,1198,1,60
2043,42,3,222,4,1202,7,40
2044,42,3,223,6,1208,1,60
2045,42,3,224,9,1217,1,90
2046,42,3,225,3,1220,4,30
2047,42,3,226,6,1226,3,60
2048,42,3,227,3,1229,4,30
2049,42,3,228,4,1233,3,40
2050,42,3,229,8,1241,4,80
2051,42,3,230,3,1244,1,30
2052,42,3,231,6,1250,3,60
2053,42,3,232,5,1255,4,50
2054,42,3,233,9,1264,0,90
2055,42,3,234,2,1266,1,20
2056,42,3,235,8,1274,3,80
2057,42,3,236,3,1277,2,30
2058,42,3,237,9,1286,5,90
2059,42,3,238,9,1295,4,90
2060,42,3,239,4,1299,3,40
2061,42,3,240,7,1306,1,70
2062,42,3,241,3,1309,3,30
2063,42,3,242,5,1314,3,50
2064,42,3,243,6,1320,3,60
2065,42,3,244,3,1323,2,30
2066,42,3,245,7,1330,1,70
2067,42,3,246,3,1333,6,30
2068,42,3,247,5,1338,7,50
2069,42,3,248,4,1342,1,40
2070,42,3,249,5,1347,3,50
2071,42,3,250,5,1352,1,50
2072,42,3,251,6,1358,2,60
2073,42,3,252,2,1360,2,20
2074,42,3,253,6,1366,2,60
2075,42,3,254,7,1373,1,70
2076,42,3,255,7,1380,3,70
2077,42,3,256,2,1382,1,20
2078,42,3,257,5,1387,0,50
2079,42,3,258,3,1390,2,30
2080,42,3,259,2,1392,1,20
2081,42,3,260,2,1394,1,20
2082,42,3,261,2,1396,1,20
2083,42,3,262,3,1399,1,30
2084,42,3,263,7,1406,1,70
2085,42,3,264,5,1411,3,50
2086,42,3,265,4,1415,3,40
2087,42,3,266,5,1420,1,50
2088,42,3,267,5,1425,3,50
2089,42,3,268,6,1431,5,60
2090,42,3,269,2,1433,4,20
2091,42,3,270,4,1437,4,40
2092,42,3,271,7,1444,3,70
2093,42,3,272,8,1452,4,80
2094,42,3,273,2,1454,4,20
2095,42,3,274,3,1457,0,30
2096,42,3,275,2,1459,1,20
2097,42,3,276,4,1463,1,40
2098,42,3,277,8,1471,0,80
2099,42,3,278,2,1473,1,20
2100,42,3,279,8,1481,3,80
2101,42,3,280,8,1489,1,80
2102,42,3,281,5,1494,7,50
2103,42,3,282,7,1501,1,70
2104,42,3,283,7,1508,2,70
2105,42,3,284,6,1514,3,60
2106,42,3,285,7,1521,1,70
2107,42,3,286,3,1524,1,30
2108,42,3,287,4,1528,4,40
2109,42,3,288,8,1536,2,80
2110,42,3,289,4,1540,3,40
2111,42,3,290,2,1542,4,20
2112,42,3,291,8,1550,1,80
2113,42,3,292,4,1554,5,40
2114,42,3,293,3,1557,3,30
2115,42,3,294,7,1564,2,70
2116,42,3,295,9,1573,1,90
2117,42,3,296,4,1577,4,40
2118,42,3,297,6,1583,2,60
2119,42,3,298,5,1588,3,50
2120,42,3,299,4,1592,2,40
2121,42,3,300,6,1598,2,60
2122,42,3,301,4,1602,4,40
2123,42,3,302,3,1605,7,30
2124,42,3,303,4,1609,4,40
2125,42,3,304,9,1618,1,90
2126,42,3,305,4,1622,1,40
2127,42,3,306,4,1626,6,40
2128,42,3,307,5,1631,3,50
2129,42,3,308,7,1638,4,70
2130,42,3,309,6,1644,3,60
2131,42,3,310,9,1653,5,90
2132,42,3,311,8,1661,0,80
2133,42,3,312,4,1665,6,40
2134,42,3,313,7,1672,1,70
2135,42,3,314,3,1675,2,30
2136,42,3,315,2,1677,3,20
2137,42,3,316,9,1686,5,90
2138,42,3,317,2,1688,0,20
2139,42,3,318,2,1690,1,20
2140,42,3,319,9,1699,0,90
2141,42,3,320,5,1704,1,50
2142,42,3,321,9,1713,3,90
2143,42,3,322,9,1722,1,90
2144,42,3,323,5,1727,1,50
2145,42,3,324,9,1736,2,90
2146,42,3,325,4,1740,5,40
2147,42,3,326,4,1744,2,40
2148,42,3,327,7,1751,4,70
2149,42,3,328,7,1758,1,70
2150,42,3,329,8,1766,4,80
2151,42,3,330,2,1768,2,20
2152,42,3,331,9,1777,6,90
2153,42,3,332,7,1784,0,70
2154,42,3,333,8,1792,1,80
2155,42,3,334,4,1796,5,40
2156,42,3,335,5,1801,2,50
2157,42,3,336,2,1803,3,20
2158,42,3,337,7,1810,2,70
2159,42,3,338,2,1812,0,20
2160,42,3,339,9,1821,1,90
2161,42,3,340,3,1824,1,30
2162,42,3,341,2,1826,6,20
2163,42,3,342,9,1835,1,90
2164,42,3,343,3,1838,6,30
2165,42,3,344,3,1841,0,30
2166,42,3,345,6,1847,7,60
2167,42,3,346,5,1852,1,50
2168,42,3,347,9,1861,2,90
2169,42,3,348,6,1867,4,60
2170,42,3,349,5,1872,3,50
2171,42,3,350,8,1880,4,80
2172,42,3,351,5,1885,3,50
2173,42,3,352,3,1888,0,30
2174,42,3,353,8,1896,2,80
2175,42,3,354,2,1898,4,20
2176,42,3,355,2,1900,3,20
2177,42,3,356,8,1908,2,80
2178,42,3,357,8,1916,3,80
2179,42,3,358,2,1918,1,20
2180,42,3,359,9,1927,8,90
2181,42,3,360,3,1930,1,30
2182,42,3,361,2,1932,2,20
2183,42,3,362,3,1935,2,30
2184,42,3,363,7,1942,4,70
2185,42,3,364,9,1951,2,90
2186,42,3,365,8,1959,0,80
2187,42,3,366,8,1967,6,80
2188,42,3,367,4,1971,4,40
2189,42,3,368,3,1974,2,30
2190,42,3,369,9,1983,5,90
2191,42,3,370,5,1988,1,50
2192,42,3,371,3,1991,0,30
2193,42,3,372,8,1999,1,80
2194,42,3,373,9,2008,4,90
2195,42,3,374,9,2017,1,90
2196,42,3,375,6,2023,3,60
2197,42,3,376,6,2029,3,60
2198,42,3,377,4,2033,2,40
2199,42,3,378,3,2036,2,30
2200,42,3,379,7,2043,2,70
2201,42,3,380,9,2052,2,90
2202,42,3,381,9,2061,4,90
2203,42,3,382,7,2068,6,70
2204,42,3,383,8,2076,2,80
2205,42,3,384,5,2081,4,50
2206,42,3,385,8,2089,5,80
2207,42,3,386,9,2098,1,90
2208,42,3,387,3,2101,4,30
2209,42,3,388,3,2104,1,30
2210,42,3,389,6,2110,3,60
2211,42,3,390,4,2114,2,40
2212,42,3,391,2,2116,3,20
2213,42,3,392,3,2119,2,30
2214,42,3,393,3,2122,2,30
2215,42,3,394,7,2129,1,70
2216,42,3,395,6,2135,2,60
2217,42,3,396,6,2141,1,60
2218,42,3,397,8,2149,1,80
2219,42,3,398,5,2154,5,50
2220,42,3,399,5,2159,1,50
2221,42,3,400,7,2166,0,70
2222,42,3,401,6,2172,3,60
2223,42,3,402,8,2180,2,80
2224,42,3,403,3,2183,0,30
2225,42,3,404,2,2185,1,20
2226,42,3,405,3,2188,4,30
2227,42,3,406,5,2193,2,50
2228,42,3,407,7,2200,1,70
2229,42,3,408,4,2204,2,40
2230,42,3,409,4,2208,1,40
2231,42,3,410,4,2212,5,40
2232,42,3,411,4,2216,2,40
2233,42,3,412,5,2221,4,50
2234,42,3,413,6,2227,1,60
2235,42,3,414,2,2229,1,20
2236,42,3,415,6,2235,3,60
2237,42,3,416,9,2244,1,90
2238,42,3,417,5,2249,1,50
2239,42,3,418,5,2254,6,50
2240,42,3,419,8,2262,4,80
2241,42,3,420,8,2270,4,80
2242,42,3,421,5,2275,2,50
2243,42,3,422,7,2282,1,70
2244,42,3,423,4,2286,1,40
2245,42,3,424,2,2288,5,20
2246,42,3,425,3,2291,5,30
2247,42,3,426,3,2294,1,30
2248,42,3,427,6,2300,3,60
2249,42,3,428,6,2306,1,60
2250,42,3,429,2,2308,1,20
2251,42,3,430,5,2313,8,50
2252,42,3,431,8,2321,6,80
2253,42,3,432,7,2328,3,70
2254,42,3,433,3,2331,1,30
2255,42,3,434,2,2333,0,20
2256,42,3,435,8,2341,4,80
2257,42,3,436,2,2343,1,20
2258,42,3,437,5,2348,2,50
2259,42,3,438,9,2357,2,90
2260,42,3,439,7,2364,2,70
2261,42,3,440,9,2373,6,90
2262,42,3,441,7,2380,3,70
2263,42,3,442,2,2382,4,20
2264,42,3,443,3,2385,4,30
2265,42,3,444,6,2391,2,60
2266,42,3,445,3,2394,1,30
2267,42,3,446,9,2403,6,90
2268,42,3,447,7,2410,1,70
2269,42,3,448,6,2416,2,60
2270,42,3,449,8,2424,3,80
2271,42,3,450,2,2426,0,20
2272,42,3,451,2,2428,4,20
2273,42,3,452,8,2436,4,80
2274,42,3,453,3,2439,3,30
2275,42,3,454,6,2445,3,60
2276,42,3,455,3,2448,4,30
2277,42,3,456,8,2456,4,80
2278,42,3,457,6,2462,4,60
2279,42,3,458,9,2471,2,90
2280,42,3,459,2,2473,1,20
2281,42,3,460,2,2475,0,20
2282,42,3,461,2,2477,3,20
2283,42,3,462,3,2480,0,30
2284,42,3,463,3,2483,0,30
2285,42,3,464,7,2490,1,70
2286,42,3,465,4,2494,1,40
2287,42,3,466,6,2500,5,60
2288,42,3,467,5,2505,1,50
2289,42,3,468,5,2510,3,50
2290,42,3,469,2,2512,2,20
2291,42,3,470,7,2519,3,70
2292,42,3,471,8,2527,3,80
2293,42,3,472,2,2529,3,20
2294,42,3,473,4,2533,4,40
2295,42,3,474,5,2538,1,50
2296,42,3,475,5,2543,1,50
2297,42,3,476,9,2552,4,90
2298,42,3,477,2,2554,1,20
2299,42,3,478,4,2558,3,40
2300,42,3,479,9,2567,3,90
2301,42,3,480,5,2572,8,50
2302,42,3,481,5,2577,6,50
2303,42,3,482,4,2581,2,40
2304,42,3,483,5,2586,2,50
2305,42,3,484,2,2588,1,20
2306,42,3,485,4,2592,3,40
2307,42,3,486,3,2595,4,30
2308,42,3,487,5,2600,3,50
2309,42,3,488,7,2607,5,70
2310,42,3,489,5,2612,1,50
2311,42,3,490,7,2619,4,70
2312,42,3,491,8,2627,1,80
2313,42,3,492,8,2635,2,80
2314,42,3,493,5,2640,0,50
2315,42,3,494,2,2642,1,20
2316,42,3,495,8,2650,3,80
2317,42,3,496,6,2656,3,60
2318,42,3,497,9,2665,3,90
2319,42,3,498,5,2670,2,50
2320,42,3,499,6,2676,3,60
2321,42,3,500,3,2679,2,30
2322,42,3,501,2,2681,2,20
2323,42,3,502,5,2686,1,50
2324,42,3,503,5,2691,2,50
2325,42,3,504,9,2700,2,90
2326,42,3,505,8,2708,1,80
2327,42,3,506,3,2711,0,30
2328,42,3,507,9,2720,9,90
2329,42,3,508,7,2727,3,70
2330,42,3,509,4,2731,4,40
2331,42,3,510,9,2740,2,90
2332,42,3,511,2,2742,1,20
2333,42,3,512,6,2748,5,60
2334,42,3,513,7,2755,1,70
2335,42,3,514,7,2762,3,70
2336,42,3,515,6,2768,7,60
2337,42,3,516,9,2777,6,90
2338,42,3,517,8,2785,7,80
2339,42,3,518,5,2790,6,50
2340,42,3,519,7,2797,3,70
2341,42,3,520,7,2804,1,70
2342,42,3,521,5,2809,4,50
2343,42,3,522,3,2812,1,30
2344,42,3,523,4,2816,3,40
2345,42,3,524,8,2824,1,80
2346,42,3,525,4,2828,5,40
2347,42,3,526,7,2835,1,70
2348,42,3,527,9,2844,2,90
2349,42,3,528,6,2850,5,60
2350,42,3,529,3,2853,1,30
2351,42,3,530,8,2861,4,80
2352,42,3,531,8,2869,4,80
2353,42,3,532,5,2874,6,50
2354,42,3,533,5,2879,3,50
2355,42,3,534,6,2885,6,60
2356,42,3,535,5,2890,1,50
2357,42,3,536,2,2892,1,20
2358,42,3,537,9,2901,3,90
2359,42,3,538,6,2907,2,60
2360,42,3,539,5,2912,4,50
2361,42,3,540,9,2921,4,90
2362,42,3,541,4,2925,1,40
2363,42,3,542,9,2934,2,90
2364,42,3,543,8,2942,2,80
2365,42,3,544,7,2949,7,70
2366,42,3,545,5,2954,1,50
2367,42,3,546,3,2957,3,30
2368,42,3,547,4,2961,5,40
2369,42,3,548,5,2966,4,50
2370,42,3,549,7,2973,1,70
2371,42,3,550,8,2981,3,80
2372,42,3,551,7,2988,1,70
2373,42,3,552,3,2991,6,30
2374,42,3,553,3,2994,4,30
2375,42,3,554,6,3000,4,60
2376,42,3,555,7,3007,0,70
2377,42,3,556,5,3012,3,50
2378,42,3,557,5,3017,2,50
2379,42,3,558,4,3021,3,40
2380,42,3,559,6,3027,6,60
2381,42,3,560,6,3033,1,60
2382,42,3,561,8,3041,4,80
2383,42,3,562,8,3049,3,80
2384,42,3,563,5,3054,2,50
2385,42,3,564,3,3057,1,30
2386,42,3,565,2,3059,1,20
2387,42,3,566,4,3063,1,40
2388,42,3,567,5,3068,2,50
2389,42,3,568,5,3073,0,50
2390,42,3,569,5,3078,1,50
2391,42,3,570,9,3087,4,90
2392,42,3,571,4,3091,3,40
2393,42,3,572,4,3095,5,40
2394,42,3,573,8,3103,4,80
2395,42,3,574,5,3108,6,50
2396,42,3,575,2,3110,1,20
2397,42,3,576,7,3117,4,70
2398,42,3,577,5,3122,3,50
2399,42,3,578,3,3125,3,30
2400,42,3,579,8,3133,3,80
2401,42,3,580,4,3137,1,40
2402,42,3,581,5,3142,3,50
2403,42,3,582,8,3150,4,80
2404,42,3,583,4,3154,3,40
2405,42,3,584,5,3159,0,50
2406,42,3,585,7,3166,5,70
2407,42,3,586,3,3169,3,30
2408,42,3,587,9,3178,1,90
2409,42,3,588,7,3185,3,70
2410,42,3,589,7,3192,6,70
2411,42,3,590,6,3198,4,60
2412,42,3,591,9,3207,2,90
2413,42,3,592,5,3212,6,50
2414,42,3,593,4,3216,2,40
2415,42,3,594,7,3223,1,70
2416,42,3,595,3,3226,2,30
2417,42,3,596,3,3229,5,30
2418,42,3,597,2,3231,1,20
2419,42,3,598,7,3238,2,70
2420,42,3,599,5,3243,3,50
2421,42,3,600,4,3247,1,40
2422,42,3,601,9,3256,3,90
2423,42,3,602,5,3261,3,50
2424,42,3,603,8,3269,2,80
2425,42,3,604,8,3277,3,80
2426,42,3,605,2,3279,1,20
2427,42,3,606,4,3283,6,40
2428,42,3,607,9,3292,0,90
2429,42,3,608,8,3300,3,80
2430,42,3,609,4,3304,5,40
2431,42,3,610,3,3307,2,30
2432,42,3,611,8,3315,1,80
2433,42,3,612,2,3317,4,20
2434,42,3,613,6,3323,1,60
2435,42,3,614,2,3325,1,20
2436,42,3,615,6,3331,3,60
2437,42,3,616,6,3337,3,60
2438,42,3,617,3,3340,3,30
2439,42,3,618,4,3344,1,40
2440,42,3,619,2,3346,1,20
2441,42,3,620,4,3350,2,40
2442,42,3,621,9,3359,4,90
2443,42,3,622,7,3366,4,70
2444,42,3,623,5,3371,1,50
2445,42,3,624,5,3376,12,50
2446,42,3,625,7,3383,4,70
2447,42,3,626,3,3386,2,30
2448,42,3,627,6,3392,3,60
2449,42,3,628,5,3397,3,50
2450,42,3,629,4,3401,1,40
2451,42,3,630,7,3408,1,70
2452,42,3,631,3,3411,1,30
2453,42,3,632,4,3415,2,40
2454,42,3,633,6,3421,3,60
2455,42,3,634,2,3423,1,20
2456,42,3,635,7,3430,5,70
2457,42,3,636,3,3433,2,30
2458,42,3,637,3,3436,2,30
2459,42,3,638,9,3445,6,90
2460,42,3,639,2,3447,2,20
2461,42,3,640,9,3456,4,90
2462,42,3,641,5,3461,2,50
2463,42,3,642,7,3468,4,70
2464,42,3,643,5,3473,5,50
2465,42,3,644,4,3477,2,40
2466,42,3,645,9,3486,2,90
2467,42,3,646,4,3490,5,40
2468,42,3,647,5,3495,5,50
2469,42,3,648,6,3501,3,60
2470,42,3,649,3,3504,4,30
2471,42,3,650,9,3513,2,90
2472,42,3,651,5,3518,2,50
2473,42,3,652,7,3525,2,70
2474,42,3,653,5,3530,6,50
2475,42,3,654,8,3538,1,80
2476,42,3,655,2,3540,6,20
2477,42,3,656,8,3548,4,80
2478,42,3,657,3,3551,1,30
2479,42,3,658,3,3554,3,30
2480,42,3,659,4,3558,5,40
2481,42,3,660,4,3562,1,40
2482,42,3,661,8,3570,6,80
2483,42,3,662,9,3579,4,90
2484,42,3,663,5,3584,1,50
2485,42,3,664,9,3593,5,90
2486,42,3,665,2,3595,4,20
2487,42,3,666,9,3604,3,90
2488,42,3,667,6,3610,1,60
2489,42,3,668,8,3618,1,80
2490,42,3,669,9,3627,4,90
2491,42,3,670,5,3632,1,50
2492,42,3,671,4,3636,3,40
2493,42,3,672,7,3643,2,70
2494,42,3,673,3,3646,8,30
2495,42,3,674,3,3649,3,30
2496,42,3,675,3,3652,4,30
2497,42,3,676,6,3658,2,60
2498,42,3,677,8,3666,1,80
2499,42,3,678,6,3672,3,60
2500,42,3,679,7,3679,3,70
2501,42,3,680,3,3682,1,30
2502,42,3,681,3,3685,3,30
2503,42,3,682,5,3690,3,50
2504,42,3,683,5,3695,1,50
2505,42,3,684,5,3700,6,50
2506,42,3,685,9,3709,2,90
2507,42,3,686,3,3712,4,30
2508,42,3,687,6,3718,1,60
2509,42,3,688,8,3726,7,80
2510,42,3,689,5,3731,2,50
2511,42,3,690,6,3737,1,60
2512,42,3,691,5,3742,2,50
2513,42,3,692,7,3749,1,70
2514,42,3,693,8,3757,2,80
2515,42,3,694,4,3761,1,40
2516,42,3,695,8,3769,1,80
2517,42,3,696,2,3771,1,20
2518,42,3,697,2,3773,5,20
2519,42,3,698,8,3781,2,80
2520,42,3,699,6,3787,3,60
2521,42,3,700,7,3794,3,70
2522,42,3,701,3,3797,2,30
2523,42,3,702,3,3800,2,30
2524,42,3,703,5,3805,1,50
2525,42,3,704,8,3813,2,80
2526,42,3,705,9,3822,6,90
2527,42,3,706,8,3830,1,80
2528,42,3,707,7,3837,4,70
2529,42,3,708,3,3840,2,30
2530,42,3,709,5,3845,1,50
2531,42,3,710,4,3849,7,40
2532,42,3,711,6,3855,1,60
2533,42,3,712,7,3862,6,70
2534,42,3,713,9,3871,1,90
2535,42,3,714,6,3877,4,60
2536,42,3,715,5,3882,8,50
2537,42,3,716,9,3891,4,90
2538,42,3,717,3,3894,0,30
2539,42,3,718,5,3899,6,50
2540,42,3,719,9,3908,6,90
2541,42,3,720,4,3912,5,40
2542,42,3,721,8,3920,3,80
2543,42,3,722,3,3923,1,30
2544,42,3,723,2,3925,4,20
2545,42,3,724,2,3927,0,20
2546,42,3,725,3,3930,3,30
2547,42,3,726,7,3937,3,70
2548,42,3,727,9,3946,1,90
2549,42,3,728,4,3950,1,40
2550,42,3,729,3,3953,3,30
2551,42,3,730,9,3962,1,90
2552,42,3,731,6,3968,1,60
2553,42,3,732,3,3971,3,30
2554,42,3,733,9,3980,3,90
2555,42,3,734,8,3988,4,80
2556,42,3,735,2,3990,3,20
2557,42,3,736,5,3995,4,50
2558,42,3,737,5,4000,4,50
2559,42,3,738,6,4006,2,60
2560,42,3,739,3,4009,5,30
2561,42,3,740,4,4013,3,40
2562,42,3,741,2,4015,3,20
2563,42,3,742,8,4023,1,80
2564,42,3,743,9,4032,0,90
2565,42,3,744,4,4036,3,40
2566,42,3,745,4,4040,3,40
2567,42,3,746,6,4046,1,60
2568,42,3,747,8,4054,1,80
2569,42,3,748,2,4056,7,20
2570,42,3,749,9,4065,4,90
2571,42,3,750,4,4069,1,40
2572,42,3,751,8,4077,5,80
2573,42,3,752,5,4082,2,50
2574,42,3,753,3,4085,4,30
2575,42,3,754,3,4088,3,30
2576,42,3,755,3,4091,3,30
2577,42,3,756,3,4094,3,30
2578,42,3,757,8,4102,3,80
2579,42,3,758,6,4108,0,60
2580,42,3,759,3,4111,1,30
2581,42,3,760,8,4119,4,80
2582,42,3,761,8,4127,6,80
2583,42,3,762,6,4133,5,60
2584,42,3,763,8,4141,1,80
2585,42,3,764,9,4150,1,90
2586,42,3,765,3,4153,1,30
2587,42,3,766,3,4156,3,30
2588,42,3,767,7,4163,4,70
2589,42,3,768,4,4167,3,40
2590,42,3,769,9,4176,5,90
2591,42,3,770,9,4185,1,90
2592,42,3,771,5,4190,3,50
2593,42,3,772,4,4194,6,40
2594,42,3,773,4,4198,4,40
2595,42,3,774,4,4202,1,40
2596,42,3,775,8,4210,4,80
2597,42,3,776,4,4214,4,40
2598,42,3,777,7,4221,1,70
2599,42,3,778,5,4226,4,50
2600,42,3,779,7,4233,1,70
2601,42,3,780,7,4240,6,70
2602,42,3,781,8,4248,2,80
2603,42,3,782,5,4253,1,50
2604,42,3,783,9,4262,4,90
2605,42,3,784,3,4265,5,30
2606,42,3,785,5,4270,4,50
2607,42,3,786,8,4278,5,80
2608,42,3,787,8,4286,3,80
2609,42,3,788,3,4289,6,30
2610,42,3,789,3,4292,2,30
2611,42,3,790,6,4298,1,60
2612,42,3,791,2,4300,5,20
2613,42,3,792,4,4304,3,40
2614,42,3,793,4,4308,1,40
2615,42,3,794,8,4316,4,80
2616,42,3,795,2,4318,1,20
2617,42,3,796,6,4324,1,60
2618,42,3,797,7,4331,2,70
2619,42,3,798,5,4336,1,50
2620,42,3,799,6,4342,1,60
2621,42,3,800,5,4347,1,50
2622,42,3,801,4,4351,2,40
2623,42,3,802,7,4358,1,70
2624,42,3,803,9,4367,6,90
2625,42,3,804,9,4376,4,90
2626,42,3,805,8,4384,3,80
2627,42,3,806,2,4386,2,20
2628,42,3,807,7,4393,3,70
2629,42,3,808,3,4396,2,30
2630,42,3,809,3,4399,5,30
2631,42,3,810,3,4402,1,30
2632,42,3,811,4,4406,2,40
2633,42,3,812,9,4415,3,90
2634,42,3,813,5,4420,2,50
2635,42,3,814,5,4425,1,50
2636,42,3,815,2,4427,3,20
2637,42,3,816,9,4436,6,90
2638,42,3,817,3,4439,3,30
2639,42,3,818,7,4446,2,70
2640,42,3,819,6,4452,0,60
2641,42,3,820,6,4458,1,60
2642,42,3,821,5,4463,5,50
2643,42,3,822,2,4465,3,20
2644,42,3,823,3,4468,1,30
2645,42,3,824,8,4476,5,80
2646,42,3,825,4,4480,1,40
2647,42,3,826,7,4487,5,70
2648,42,3,827,4,4491,2,40
2649,42,3,828,8,4499,2,80
2650,42,3,829,3,4502,3,30
2651,42,3,830,7,4509,5,70
2652,42,3,831,3,4512,1,30
2653,42,3,832,8,4520,4,80
2654,42,3,833,8,4528,2,80
2655,42,3,834,8,4536,5,80
2656,42,3,835,6,4542,3,60
2657,42,3,836,6,4548,6,60
2658,42,3,837,5,4553,7,50
2659,42,3,838,5,4558,2,50
2660,42,3,839,2,4560,1,20
2661,42,3,840,8,4568,2,80
2662,42,3,841,5,4573,2,50
2663,42,3,842,6,4579,3,60
2664,42,3,843,3,4582,3,30
2665,42,3,844,5,4587,2,50
2666,42,3,845,2,4589,1,20
2667,42,3,846,4,4593,0,40
2668,42,3,847,9,4602,0,90
2669,42,3,848,8,4610,4,80
2670,42,3,849,3,4613,3,30
2671,42,3,850,3,4616,4,30
2672,42,3,851,3,4619,1,30
2673,42,3,852,7,4626,1,70
2674,42,3,853,8,4634,1,80
2675,42,3,854,4,4638,1,40
2676,42,3,855,2,4640,5,20
2677,42,3,856,9,4649,3,90
2678,42,3,857,7,4656,3,70
2679,42,3,858,5,4661,0,50
2680,42,3,859,4,4665,7,40
2681,42,3,860,4,4669,3,40
2682,42,3,861,4,4673,1,40
2683,42,3,862,9,4682,3,90
2684,42,3,863,5,4687,1,50
2685,42,3,864,7,4694,2,70
2686,42,3,865,3,4697,0,30
2687,42,3,866,2,4699,5,20
2688,42,3,867,8,4707,3,80
2689,42,3,868,8,4715,4,80
2690,42,3,869,3,4718,1,30
2691,42,3,870,7,4725,1,70
2692,42,3,871,2,4727,1,20
2693,42,3,872,2,4729,2,20
2694,42,3,873,9,4738,1,90
2695,42,3,874,8,4746,4,80
2696,42,3,875,6,4752,5,60
2697,42,3,876,2,4754,3,20
2698,42,3,877,9,4763,4,90
2699,42,3,878,7,4770,4,70
2700,42,3,879,9,4779,5,90
2701,42,3,880,3,4782,1,30
2702,42,3,881,9,4791,3,90
2703,42,3,882,7,4798,3,70
2704,42,3,883,4,4802,2,40
2705,42,3,884,3,4805,2,30
2706,42,3,885,4,4809,1,40
2707,42,3,886,4,4813,0,40
2708,42,3,887,2,4815,2,20
2709,42,3,888,7,4822,1,70
2710,42,3,889,9,4831,3,90
2711,42,3,890,3,4834,0,30
2712,42,3,891,9,4843,2,90
2713,42,3,892,2,4845,3,20
2714,42,3,893,4,4849,3,40
2715,42,3,894,3,4852,0,30
2716,42,3,895,7,4859,1,70
2717,42,3,896,5,4864,1,50
2718,42,3,897,2,4866,3,20
2719,42,3,898,7,4873,1,70
2720,42,3,899,9,4882,5,90
2721,42,3,900,2,4884,1,20
2722,42,3,901,2,4886,2,20
2723,42,3,902,8,4894,5,80
2724,42,3,903,9,4903,3,90
2725,42,3,904,4,4907,7,40
2726,42,3,905,8,4915,1,80
2727,42,3,906,9,4924,1,90
2728,42,3,907,6,4930,3,60
2729,42,3,908,2,4932,1,20
2730,42,3,909,9,4941,3,90
2731,42,3,910,3,4944,1,30
2732,42,3,911,4,4948,2,40
2733,42,3,912,7,4955,1,70
2734,42,3,913,4,4959,6,40
2735,42,3,914,8,4967,0,80
2736,42,3,915,4,4971,2,40
2737,42,3,916,7,4978,4,70
2738,42,3,917,3,4981,1,30
2739,42,3,918,8,4989,10,80
2740,42,3,919,8,4997,3,80
2741,42,3,920,2,4999,0,20
