,Scenario,Trial,Inspection,Interval,Time,Defects,Rate
0,195,1,1,3,3,0,30
1,195,1,2,6,9,1,60
2,195,1,3,9,18,1,90
3,195,1,4,3,21,2,30
4,195,1,5,9,30,1,90
5,195,1,6,4,34,1,40
6,195,1,7,5,39,5,50
7,195,1,8,5,44,1,50
8,195,1,9,7,51,1,70
9,195,1,10,6,57,1,60
10,195,1,11,2,59,1,20
11,195,1,12,2,61,1,20
12,195,1,13,2,63,1,20
13,195,1,14,5,68,7,50
14,195,1,15,2,70,4,20
15,195,1,16,6,76,2,60
16,195,1,17,7,83,4,70
17,195,1,18,4,87,1,40
18,195,1,19,4,91,1,40
19,195,1,20,4,95,1,40
20,195,1,21,4,99,4,40
21,195,1,22,2,101,5,20
22,195,1,23,3,104,4,30
23,195,1,24,9,113,5,90
24,195,1,25,5,118,1,50
25,195,1,26,7,125,4,70
26,195,1,27,4,129,1,40
27,195,1,28,3,132,1,30
28,195,1,29,3,135,4,30
29,195,1,30,7,142,5,70
30,195,1,31,6,148,0,60
31,195,1,32,5,153,1,50
32,195,1,33,9,162,1,90
33,195,1,34,4,166,4,40
34,195,1,35,7,173,1,70
35,195,1,36,4,177,1,40
36,195,1,37,6,183,1,60
37,195,1,38,2,185,4,20
38,195,1,39,8,193,1,80
39,195,1,40,3,196,1,30
40,195,1,41,4,200,7,40
41,195,1,42,6,206,1,60
42,195,1,43,6,212,3,60
43,195,1,44,6,218,3,60
44,195,1,45,6,224,4,60
45,195,1,46,3,227,3,30
46,195,1,47,3,230,1,30
47,195,1,48,6,236,1,60
48,195,1,49,6,242,7,60
49,195,1,50,9,251,1,90
50,195,1,51,5,256,7,50
51,195,1,52,8,264,9,80
52,195,1,53,7,271,1,70
53,195,1,54,5,276,7,50
54,195,1,55,6,282,6,60
55,195,1,56,3,285,1,30
56,195,1,57,8,293,1,80
57,195,1,58,2,295,1,20
58,195,1,59,3,298,4,30
59,195,1,60,5,303,1,50
60,195,1,61,6,309,8,60
61,195,1,62,9,318,1,90
62,195,1,63,2,320,1,20
63,195,1,64,4,324,2,40
64,195,1,65,4,328,3,40
65,195,1,66,5,333,0,50
66,195,1,67,6,339,0,60
67,195,1,68,9,348,2,90
68,195,1,69,9,357,3,90
69,195,1,70,2,359,3,20
70,195,1,71,5,364,1,50
71,195,1,72,5,369,1,50
72,195,1,73,8,377,1,80
73,195,1,74,8,385,1,80
74,195,1,75,3,388,1,30
75,195,1,76,8,396,1,80
76,195,1,77,7,403,6,70
77,195,1,78,3,406,3,30
78,195,1,79,4,410,4,40
79,195,1,80,4,414,1,40
80,195,1,81,7,421,1,70
81,195,1,82,9,430,1,90
82,195,1,83,4,434,4,40
83,195,1,84,3,437,3,30
84,195,1,85,6,443,1,60
85,195,1,86,8,451,1,80
86,195,1,87,5,456,1,50
87,195,1,88,5,461,1,50
88,195,1,89,2,463,1,20
89,195,1,90,6,469,1,60
90,195,1,91,5,474,5,50
91,195,1,92,4,478,8,40
92,195,1,93,3,481,1,30
93,195,1,94,7,488,6,70
94,195,1,95,7,495,1,70
95,195,1,96,7,502,1,70
96,195,1,97,5,507,4,50
97,195,1,98,2,509,1,20
98,195,1,99,3,512,1,30
99,195,1,100,6,518,1,60
100,195,1,101,6,524,4,60
101,195,1,102,4,528,1,40
102,195,1,103,4,532,4,40
103,195,1,104,4,536,3,40
104,195,1,105,5,541,4,50
105,195,1,106,5,546,1,50
106,195,1,107,7,553,9,70
107,195,1,108,6,559,3,60
108,195,1,109,2,561,4,20
109,195,1,110,9,570,3,90
110,195,1,111,5,575,1,50
111,195,1,112,4,579,1,40
112,195,1,113,7,586,3,70
113,195,1,114,4,590,5,40
114,195,1,115,8,598,1,80
115,195,1,116,2,600,1,20
116,195,1,117,5,605,4,50
117,195,1,118,8,613,1,80
118,195,1,119,2,615,1,20
119,195,1,120,5,620,4,50
120,195,1,121,6,626,1,60
121,195,1,122,7,633,1,70
122,195,1,123,7,640,5,70
123,195,1,124,4,644,1,40
124,195,1,125,5,649,7,50
125,195,1,126,9,658,1,90
126,195,1,127,5,663,1,50
127,195,1,128,2,665,4,20
128,195,1,129,2,667,1,20
129,195,1,130,9,676,1,90
130,195,1,131,7,683,8,70
131,195,1,132,6,689,4,60
132,195,1,133,6,695,7,60
133,195,1,134,7,702,1,70
134,195,1,135,6,708,1,60
135,195,1,136,9,717,2,90
136,195,1,137,2,719,1,20
137,195,1,138,5,724,4,50
138,195,1,139,8,732,1,80
139,195,1,140,9,741,1,90
140,195,1,141,3,744,4,30
141,195,1,142,3,747,3,30
142,195,1,143,3,750,1,30
143,195,1,144,9,759,3,90
144,195,1,145,4,763,6,40
145,195,1,146,4,767,1,40
146,195,1,147,5,772,6,50
147,195,1,148,8,780,1,80
148,195,1,149,7,787,1,70
149,195,1,150,6,793,6,60
150,195,1,151,5,798,2,50
151,195,1,152,9,807,1,90
152,195,1,153,8,815,1,80
153,195,1,154,5,820,1,50
154,195,1,155,2,822,1,20
155,195,1,156,9,831,5,90
156,195,1,157,6,837,1,60
157,195,1,158,7,844,5,70
158,195,1,159,3,847,3,30
159,195,1,160,3,850,4,30
160,195,1,161,6,856,7,60
161,195,1,162,8,864,1,80
162,195,1,163,3,867,1,30
163,195,1,164,5,872,1,50
164,195,1,165,9,881,8,90
165,195,1,166,3,884,1,30
166,195,1,167,6,890,1,60
167,195,1,168,8,898,1,80
168,195,1,169,4,902,3,40
169,195,1,170,7,909,1,70
170,195,1,171,8,917,9,80
171,195,1,172,5,922,1,50
172,195,1,173,8,930,5,80
173,195,1,174,3,933,1,30
174,195,1,175,2,935,3,20
175,195,1,176,5,940,1,50
176,195,1,177,5,945,1,50
177,195,1,178,3,948,7,30
178,195,1,179,8,956,1,80
179,195,1,180,7,963,7,70
180,195,1,181,7,970,1,70
181,195,1,182,9,979,6,90
182,195,1,183,6,985,4,60
183,195,1,184,5,990,1,50
184,195,1,185,8,998,5,80
185,195,1,186,7,1005,1,70
186,195,1,187,6,1011,1,60
187,195,1,188,2,1013,1,20
188,195,1,189,4,1017,1,40
189,195,1,190,8,1025,1,80
190,195,1,191,2,1027,1,20
191,195,1,192,6,1033,8,60
192,195,1,193,8,1041,1,80
193,195,1,194,3,1044,7,30
194,195,1,195,8,1052,1,80
195,195,1,196,8,1060,6,80
196,195,1,197,3,1063,5,30
197,195,1,198,5,1068,1,50
198,195,1,199,6,1074,1,60
199,195,1,200,3,1077,1,30
200,195,1,201,7,1084,1,70
201,195,1,202,2,1086,1,20
202,195,1,203,2,1088,1,20
203,195,1,204,2,1090,8,20
204,195,1,205,4,1094,1,40
205,195,1,206,5,1099,1,50
206,195,1,207,9,1108,3,90
207,195,1,208,5,1113,1,50
208,195,1,209,6,1119,1,60
209,195,1,210,5,1124,5,50
210,195,1,211,7,1131,1,70
211,195,1,212,6,1137,1,60
212,195,1,213,6,1143,1,60
213,195,1,214,2,1145,4,20
214,195,1,215,8,1153,3,80
215,195,1,216,2,1155,1,20
216,195,1,217,4,1159,5,40
217,195,1,218,2,1161,5,20
218,195,1,219,7,1168,1,70
219,195,1,220,3,1171,1,30
220,195,1,221,8,1179,1,80
221,195,1,222,2,1181,1,20
222,195,1,223,8,1189,1,80
223,195,1,224,5,1194,1,50
224,195,1,225,9,1203,4,90
225,195,1,226,9,1212,6,90
226,195,1,227,4,1216,1,40
227,195,1,228,2,1218,5,20
228,195,1,229,3,1221,2,30
229,195,1,230,7,1228,6,70
230,195,1,231,7,1235,4,70
231,195,1,232,9,1244,4,90
232,195,1,233,8,1252,1,80
233,195,1,234,2,1254,6,20
234,195,1,235,9,1263,4,90
235,195,1,236,8,1271,5,80
236,195,1,237,7,1278,1,70
237,195,1,238,7,1285,3,70
238,195,1,239,4,1289,5,40
239,195,1,240,3,1292,1,30
240,195,1,241,4,1296,1,40
241,195,1,242,4,1300,1,40
242,195,1,243,2,1302,1,20
243,195,1,244,8,1310,1,80
244,195,1,245,9,1319,1,90
245,195,1,246,5,1324,1,50
246,195,1,247,8,1332,6,80
247,195,1,248,9,1341,1,90
248,195,1,249,7,1348,10,70
249,195,1,250,9,1357,13,90
250,195,1,251,5,1362,1,50
251,195,1,252,2,1364,4,20
252,195,1,253,5,1369,1,50
253,195,1,254,4,1373,2,40
254,195,1,255,6,1379,1,60
255,195,1,256,2,1381,3,20
256,195,1,257,6,1387,1,60
257,195,1,258,9,1396,1,90
258,195,1,259,8,1404,3,80
259,195,1,260,7,1411,1,70
260,195,1,261,5,1416,6,50
261,195,1,262,3,1419,1,30
262,195,1,263,8,1427,2,80
263,195,1,264,5,1432,1,50
264,195,1,265,4,1436,1,40
265,195,1,266,7,1443,6,70
266,195,1,267,8,1451,1,80
267,195,1,268,9,1460,1,90
268,195,1,269,6,1466,1,60
269,195,1,270,8,1474,1,80
270,195,1,271,2,1476,7,20
271,195,1,272,6,1482,1,60
272,195,1,273,7,1489,5,70
273,195,1,274,8,1497,5,80
274,195,1,275,9,1506,1,90
275,195,1,276,6,1512,9,60
276,195,1,277,6,1518,1,60
277,195,1,278,8,1526,1,80
278,195,1,279,5,1531,1,50
279,195,1,280,5,1536,1,50
280,195,1,281,3,1539,11,30
281,195,1,282,5,1544,5,50
282,195,1,283,9,1553,1,90
283,195,1,284,2,1555,4,20
284,195,1,285,4,1559,5,40
285,195,1,286,5,1564,1,50
286,195,1,287,2,1566,7,20
287,195,1,288,9,1575,5,90
288,195,1,289,5,1580,1,50
289,195,1,290,3,1583,3,30
290,195,1,291,5,1588,4,50
291,195,1,292,3,1591,1,30
292,195,1,293,2,1593,3,20
293,195,1,294,5,1598,1,50
294,195,1,295,7,1605,1,70
295,195,1,296,4,1609,1,40
296,195,1,297,4,1613,1,40
297,195,1,298,7,1620,10,70
298,195,1,299,6,1626,5,60
299,195,1,300,2,1628,7,20
300,195,1,301,5,1633,5,50
301,195,1,302,5,1638,6,50
302,195,1,303,2,1640,1,20
303,195,1,304,4,1644,1,40
304,195,1,305,4,1648,1,40
305,195,1,306,5,1653,1,50
306,195,1,307,8,1661,6,80
307,195,1,308,2,1663,1,20
308,195,1,309,3,1666,1,30
309,195,1,310,5,1671,1,50
310,195,1,311,5,1676,5,50
311,195,1,312,5,1681,1,50
312,195,1,313,8,1689,1,80
313,195,1,314,2,1691,1,20
314,195,1,315,8,1699,1,80
315,195,1,316,9,1708,1,90
316,195,1,317,5,1713,1,50
317,195,1,318,3,1716,1,30
318,195,1,319,2,1718,11,20
319,195,1,320,9,1727,1,90
320,195,1,321,2,1729,1,20
321,195,1,322,5,1734,5,50
322,195,1,323,4,1738,1,40
323,195,1,324,3,1741,1,30
324,195,1,325,6,1747,6,60
325,195,1,326,6,1753,1,60
326,195,1,327,2,1755,1,20
327,195,1,328,8,1763,1,80
328,195,1,329,7,1770,1,70
329,195,1,330,8,1778,10,80
330,195,1,331,9,1787,1,90
331,195,1,332,2,1789,1,20
332,195,1,333,2,1791,10,20
333,195,1,334,3,1794,5,30
334,195,1,335,4,1798,7,40
335,195,1,336,2,1800,1,20
336,195,1,337,6,1806,3,60
337,195,1,338,3,1809,1,30
338,195,1,339,7,1816,1,70
339,195,1,340,3,1819,1,30
340,195,1,341,6,1825,1,60
341,195,1,342,2,1827,1,20
342,195,1,343,4,1831,1,40
343,195,1,344,8,1839,6,80
344,195,1,345,3,1842,5,30
345,195,1,346,6,1848,7,60
346,195,1,347,4,1852,1,40
347,195,1,348,2,1854,3,20
348,195,1,349,4,1858,3,40
349,195,1,350,4,1862,1,40
350,195,1,351,6,1868,1,60
351,195,1,352,2,1870,1,20
352,195,1,353,6,1876,4,60
353,195,1,354,2,1878,1,20
354,195,1,355,9,1887,4,90
355,195,1,356,3,1890,1,30
356,195,1,357,5,1895,1,50
357,195,1,358,4,1899,7,40
358,195,1,359,6,1905,1,60
359,195,1,360,4,1909,6,40
360,195,1,361,3,1912,1,30
361,195,1,362,8,1920,1,80
362,195,1,363,5,1925,3,50
363,195,1,364,5,1930,1,50
364,195,1,365,5,1935,1,50
365,195,1,366,6,1941,1,60
366,195,1,367,8,1949,1,80
367,195,1,368,7,1956,1,70
368,195,1,369,4,1960,1,40
369,195,1,370,6,1966,3,60
370,195,1,371,8,1974,1,80
371,195,1,372,5,1979,1,50
372,195,1,373,5,1984,1,50
373,195,1,374,2,1986,3,20
374,195,1,375,6,1992,5,60
375,195,1,376,9,2001,6,90
376,195,1,377,7,2008,3,70
377,195,1,378,3,2011,2,30
378,195,1,379,2,2013,3,20
379,195,1,380,7,2020,1,70
380,195,1,381,5,2025,1,50
381,195,1,382,3,2028,4,30
382,195,1,383,2,2030,1,20
383,195,1,384,2,2032,1,20
384,195,1,385,5,2037,5,50
385,195,1,386,6,2043,1,60
386,195,1,387,3,2046,2,30
387,195,1,388,9,2055,6,90
388,195,1,389,4,2059,1,40
389,195,1,390,6,2065,6,60
390,195,1,391,9,2074,1,90
391,195,1,392,8,2082,1,80
392,195,1,393,9,2091,1,90
393,195,1,394,2,2093,1,20
394,195,1,395,6,2099,7,60
395,195,1,396,9,2108,1,90
396,195,1,397,9,2117,10,90
397,195,1,398,6,2123,1,60
398,195,1,399,8,2131,1,80
399,195,1,400,9,2140,1,90
400,195,1,401,3,2143,9,30
401,195,1,402,5,2148,1,50
402,195,1,403,7,2155,1,70
403,195,1,404,5,2160,1,50
404,195,1,405,3,2163,1,30
405,195,1,406,5,2168,1,50
406,195,1,407,6,2174,1,60
407,195,1,408,9,2183,8,90
408,195,1,409,9,2192,1,90
409,195,1,410,7,2199,11,70
410,195,1,411,2,2201,1,20
411,195,1,412,9,2210,7,90
412,195,1,413,8,2218,4,80
413,195,1,414,4,2222,1,40
414,195,1,415,5,2227,1,50
415,195,1,416,9,2236,8,90
416,195,1,417,4,2240,1,40
417,195,1,418,8,2248,1,80
418,195,1,419,4,2252,1,40
419,195,1,420,9,2261,12,90
420,195,1,421,9,2270,1,90
421,195,1,422,3,2273,1,30
422,195,1,423,6,2279,1,60
423,195,1,424,7,2286,1,70
424,195,1,425,5,2291,14,50
425,195,1,426,8,2299,3,80
426,195,1,427,8,2307,8,80
427,195,1,428,8,2315,1,80
428,195,1,429,5,2320,1,50
429,195,1,430,6,2326,1,60
430,195,1,431,4,2330,1,40
431,195,1,432,3,2333,12,30
432,195,1,433,7,2340,1,70
433,195,1,434,9,2349,1,90
434,195,1,435,8,2357,1,80
435,195,1,436,2,2359,1,20
436,195,1,437,8,2367,1,80
437,195,1,438,5,2372,1,50
438,195,1,439,5,2377,1,50
439,195,1,440,9,2386,1,90
440,195,1,441,3,2389,14,30
441,195,1,442,7,2396,11,70
442,195,1,443,7,2403,6,70
443,195,1,444,4,2407,1,40
444,195,1,445,7,2414,1,70
445,195,1,446,9,2423,1,90
446,195,1,447,2,2425,1,20
447,195,1,448,4,2429,7,40
448,195,1,449,8,2437,6,80
449,195,1,450,8,2445,1,80
450,195,1,451,8,2453,7,80
451,195,1,452,7,2460,5,70
452,195,1,453,9,2469,1,90
453,195,1,454,5,2474,6,50
454,195,1,455,9,2483,3,90
455,195,1,456,4,2487,1,40
456,195,1,457,2,2489,5,20
457,195,1,458,2,2491,4,20
458,195,1,459,7,2498,1,70
459,195,1,460,7,2505,1,70
460,195,1,461,9,2514,1,90
461,195,1,462,3,2517,6,30
462,195,1,463,5,2522,1,50
463,195,1,464,8,2530,11,80
464,195,1,465,3,2533,1,30
465,195,1,466,2,2535,1,20
466,195,1,467,8,2543,7,80
467,195,1,468,4,2547,1,40
468,195,1,469,8,2555,1,80
469,195,1,470,9,2564,5,90
470,195,1,471,7,2571,1,70
471,195,1,472,3,2574,1,30
472,195,1,473,6,2580,1,60
473,195,1,474,3,2583,1,30
474,195,1,475,8,2591,1,80
475,195,1,476,9,2600,8,90
476,195,1,477,8,2608,9,80
477,195,1,478,6,2614,6,60
478,195,1,479,4,2618,2,40
479,195,1,480,8,2626,6,80
480,195,1,481,6,2632,1,60
481,195,1,482,6,2638,1,60
482,195,1,483,9,2647,5,90
483,195,1,484,4,2651,1,40
484,195,1,485,5,2656,9,50
485,195,1,486,9,2665,1,90
486,195,1,487,5,2670,1,50
487,195,1,488,5,2675,1,50
488,195,1,489,3,2678,1,30
489,195,1,490,8,2686,1,80
490,195,1,491,8,2694,1,80
491,195,1,492,8,2702,1,80
492,195,1,493,4,2706,12,40
493,195,1,494,9,2715,1,90
494,195,1,495,5,2720,1,50
495,195,1,496,5,2725,1,50
496,195,1,497,9,2734,1,90
497,195,1,498,3,2737,7,30
498,195,1,499,8,2745,7,80
499,195,1,500,6,2751,5,60
500,195,1,501,8,2759,5,80
501,195,1,502,9,2768,1,90
502,195,1,503,2,2770,1,20
503,195,1,504,3,2773,2,30
504,195,1,505,7,2780,1,70
505,195,1,506,4,2784,7,40
506,195,1,507,8,2792,4,80
507,195,1,508,7,2799,1,70
508,195,1,509,5,2804,2,50
509,195,1,510,8,2812,1,80
510,195,1,511,8,2820,1,80
511,195,1,512,8,2828,4,80
512,195,1,513,2,2830,4,20
513,195,1,514,3,2833,1,30
514,195,1,515,8,2841,1,80
515,195,1,516,4,2845,5,40
516,195,1,517,9,2854,5,90
517,195,1,518,3,2857,1,30
518,195,1,519,5,2862,1,50
519,195,1,520,2,2864,1,20
520,195,1,521,8,2872,1,80
521,195,1,522,9,2881,5,90
522,195,1,523,4,2885,1,40
523,195,1,524,3,2888,1,30
524,195,1,525,6,2894,1,60
525,195,1,526,6,2900,8,60
526,195,1,527,9,2909,1,90
527,195,1,528,7,2916,10,70
528,195,1,529,9,2925,1,90
529,195,1,530,9,2934,4,90
530,195,1,531,2,2936,2,20
531,195,1,532,4,2940,9,40
532,195,1,533,8,2948,1,80
533,195,1,534,5,2953,1,50
534,195,1,535,7,2960,1,70
535,195,1,536,3,2963,1,30
536,195,1,537,7,2970,7,70
537,195,1,538,3,2973,1,30
538,195,1,539,8,2981,1,80
539,195,1,540,6,2987,1,60
540,195,1,541,9,2996,11,90
541,195,1,542,4,3000,1,40
542,195,1,543,5,3005,1,50
543,195,1,544,9,3014,1,90
544,195,1,545,3,3017,8,30
545,195,1,546,8,3025,1,80
546,195,1,547,7,3032,1,70
547,195,1,548,6,3038,1,60
548,195,1,549,4,3042,9,40
549,195,1,550,3,3045,1,30
550,195,1,551,2,3047,1,20
551,195,1,552,5,3052,4,50
552,195,1,553,6,3058,5,60
553,195,1,554,7,3065,1,70
554,195,1,555,6,3071,1,60
555,195,1,556,3,3074,4,30
556,195,1,557,3,3077,1,30
557,195,1,558,5,3082,1,50
558,195,1,559,8,3090,8,80
559,195,1,560,8,3098,1,80
560,195,1,561,5,3103,6,50
561,195,1,562,7,3110,3,70
562,195,1,563,6,3116,1,60
563,195,1,564,4,3120,1,40
564,195,1,565,3,3123,1,30
565,195,1,566,9,3132,1,90
566,195,1,567,6,3138,1,60
567,195,1,568,2,3140,1,20
568,195,1,569,4,3144,1,40
569,195,1,570,7,3151,1,70
570,195,1,571,6,3157,1,60
571,195,1,572,8,3165,1,80
572,195,1,573,2,3167,1,20
573,195,1,574,6,3173,13,60
574,195,1,575,6,3179,1,60
575,195,1,576,6,3185,1,60
576,195,1,577,9,3194,1,90
577,195,1,578,5,3199,7,50
578,195,1,579,3,3202,1,30
579,195,1,580,3,3205,1,30
580,195,1,581,2,3207,1,20
581,195,1,582,2,3209,4,20
582,195,1,583,3,3212,4,30
583,195,1,584,6,3218,1,60
584,195,1,585,7,3225,8,70
585,195,1,586,2,3227,1,20
586,195,1,587,8,3235,7,80
587,195,1,588,2,3237,1,20
588,195,1,589,6,3243,1,60
589,195,1,590,8,3251,13,80
590,195,1,591,9,3260,1,90
591,195,1,592,3,3263,5,30
592,195,1,593,3,3266,10,30
593,195,1,594,3,3269,1,30
594,195,1,595,8,3277,4,80
595,195,1,596,9,3286,5,90
596,195,1,597,8,3294,5,80
597,195,1,598,4,3298,4,40
598,195,1,599,4,3302,1,40
599,195,1,600,8,3310,1,80
600,195,1,601,2,3312,6,20
601,195,1,602,3,3315,7,30
602,195,1,603,5,3320,1,50
603,195,1,604,5,3325,1,50
604,195,1,605,4,3329,1,40
605,195,1,606,8,3337,2,80
606,195,1,607,5,3342,3,50
607,195,1,608,8,3350,2,80
608,195,1,609,2,3352,1,20
609,195,1,610,9,3361,1,90
610,195,1,611,4,3365,1,40
611,195,1,612,3,3368,1,30
612,195,1,613,5,3373,5,50
613,195,1,614,6,3379,1,60
614,195,1,615,7,3386,1,70
615,195,1,616,7,3393,9,70
616,195,1,617,3,3396,1,30
617,195,1,618,8,3404,2,80
618,195,1,619,9,3413,4,90
619,195,1,620,7,3420,6,70
620,195,1,621,2,3422,1,20
621,195,1,622,9,3431,4,90
622,195,1,623,8,3439,0,80
623,195,1,624,4,3443,1,40
624,195,1,625,7,3450,1,70
625,195,1,626,2,3452,1,20
626,195,1,627,8,3460,1,80
627,195,1,628,8,3468,1,80
628,195,1,629,6,3474,1,60
629,195,1,630,5,3479,1,50
630,195,1,631,8,3487,12,80
631,195,1,632,7,3494,9,70
632,195,1,633,2,3496,1,20
633,195,1,634,5,3501,3,50
634,195,1,635,6,3507,7,60
635,195,1,636,4,3511,4,40
636,195,1,637,3,3514,1,30
637,195,1,638,2,3516,6,20
638,195,1,639,3,3519,1,30
639,195,1,640,9,3528,7,90
640,195,1,641,4,3532,2,40
641,195,1,642,6,3538,2,60
642,195,1,643,8,3546,0,80
643,195,1,644,9,3555,2,90
644,195,1,645,3,3558,7,30
645,195,1,646,6,3564,1,60
646,195,1,647,8,3572,3,80
647,195,1,648,9,3581,1,90
648,195,1,649,9,3590,1,90
649,195,1,650,8,3598,1,80
650,195,1,651,2,3600,1,20
651,195,1,652,8,3608,9,80
652,195,1,653,5,3613,3,50
653,195,1,654,4,3617,1,40
654,195,1,655,3,3620,10,30
655,195,1,656,4,3624,1,40
656,195,1,657,7,3631,1,70
657,195,1,658,3,3634,1,30
658,195,1,659,9,3643,7,90
659,195,1,660,4,3647,7,40
660,195,1,661,5,3652,1,50
661,195,1,662,2,3654,1,20
662,195,1,663,3,3657,2,30
663,195,1,664,9,3666,1,90
664,195,1,665,6,3672,3,60
665,195,1,666,9,3681,1,90
666,195,1,667,7,3688,7,70
667,195,1,668,7,3695,1,70
668,195,1,669,3,3698,8,30
669,195,1,670,2,3700,1,20
670,195,1,671,4,3704,3,40
671,195,1,672,9,3713,1,90
672,195,1,673,8,3721,1,80
673,195,1,674,7,3728,8,70
674,195,1,675,9,3737,1,90
675,195,1,676,5,3742,1,50
676,195,1,677,6,3748,1,60
677,195,1,678,9,3757,7,90
678,195,1,679,9,3766,1,90
679,195,1,680,3,3769,1,30
680,195,1,681,6,3775,9,60
681,195,1,682,2,3777,6,20
682,195,1,683,6,3783,5,60
683,195,1,684,8,3791,1,80
684,195,1,685,8,3799,3,80
685,195,1,686,7,3806,1,70
686,195,1,687,2,3808,2,20
687,195,1,688,7,3815,1,70
688,195,1,689,7,3822,1,70
689,195,1,690,9,3831,7,90
690,195,1,691,9,3840,4,90
691,195,1,692,3,3843,1,30
692,195,1,693,9,3852,1,90
693,195,1,694,6,3858,4,60
694,195,1,695,4,3862,6,40
695,195,1,696,5,3867,6,50
696,195,1,697,8,3875,4,80
697,195,1,698,2,3877,1,20
698,195,1,699,9,3886,1,90
699,195,1,700,9,3895,6,90
700,195,1,701,7,3902,5,70
701,195,1,702,6,3908,1,60
702,195,1,703,8,3916,6,80
703,195,1,704,4,3920,1,40
704,195,1,705,4,3924,7,40
705,195,1,706,4,3928,1,40
706,195,1,707,5,3933,12,50
707,195,1,708,2,3935,1,20
708,195,1,709,8,3943,1,80
709,195,1,710,4,3947,1,40
710,195,1,711,4,3951,3,40
711,195,1,712,6,3957,4,60
712,195,1,713,7,3964,1,70
713,195,1,714,2,3966,1,20
714,195,1,715,4,3970,3,40
715,195,1,716,7,3977,1,70
716,195,1,717,9,3986,2,90
717,195,1,718,2,3988,4,20
718,195,1,719,6,3994,3,60
719,195,1,720,7,4001,1,70
720,195,1,721,8,4009,2,80
721,195,1,722,7,4016,6,70
722,195,1,723,2,4018,1,20
723,195,1,724,6,4024,3,60
724,195,1,725,9,4033,1,90
725,195,1,726,6,4039,3,60
726,195,1,727,3,4042,1,30
727,195,1,728,2,4044,8,20
728,195,1,729,4,4048,1,40
729,195,1,730,5,4053,4,50
730,195,1,731,6,4059,1,60
731,195,1,732,6,4065,6,60
732,195,1,733,5,4070,6,50
733,195,1,734,9,4079,1,90
734,195,1,735,5,4084,3,50
735,195,1,736,3,4087,6,30
736,195,1,737,3,4090,1,30
737,195,1,738,8,4098,6,80
738,195,1,739,4,4102,4,40
739,195,1,740,9,4111,5,90
740,195,1,741,8,4119,1,80
741,195,1,742,5,4124,8,50
742,195,1,743,8,4132,5,80
743,195,1,744,7,4139,1,70
744,195,1,745,8,4147,3,80
745,195,1,746,9,4156,1,90
746,195,1,747,5,4161,1,50
747,195,1,748,6,4167,4,60
748,195,1,749,4,4171,4,40
749,195,1,750,8,4179,1,80
750,195,1,751,4,4183,1,40
751,195,1,752,2,4185,1,20
752,195,1,753,7,4192,7,70
753,195,1,754,4,4196,1,40
754,195,1,755,6,4202,1,60
755,195,1,756,3,4205,1,30
756,195,1,757,2,4207,7,20
757,195,1,758,9,4216,1,90
758,195,1,759,7,4223,4,70
759,195,1,760,7,4230,1,70
760,195,1,761,8,4238,5,80
761,195,1,762,4,4242,1,40
762,195,1,763,4,4246,1,40
763,195,1,764,6,4252,4,60
764,195,1,765,5,4257,1,50
765,195,1,766,7,4264,1,70
766,195,1,767,9,4273,1,90
767,195,1,768,2,4275,7,20
768,195,1,769,5,4280,1,50
769,195,1,770,2,4282,4,20
770,195,1,771,4,4286,2,40
771,195,1,772,9,4295,1,90
772,195,1,773,6,4301,1,60
773,195,1,774,5,4306,1,50
774,195,1,775,8,4314,1,80
775,195,1,776,6,4320,1,60
776,195,1,777,9,4329,1,90
777,195,1,778,9,4338,6,90
778,195,1,779,6,4344,7,60
779,195,1,780,5,4349,5,50
780,195,1,781,9,4358,3,90
781,195,1,782,3,4361,5,30
782,195,1,783,4,4365,1,40
783,195,1,784,8,4373,1,80
784,195,1,785,4,4377,1,40
785,195,1,786,3,4380,6,30
786,195,1,787,3,4383,1,30
787,195,1,788,9,4392,4,90
788,195,1,789,3,4395,6,30
789,195,1,790,9,4404,7,90
790,195,1,791,6,4410,1,60
791,195,1,792,3,4413,1,30
792,195,1,793,6,4419,1,60
793,195,1,794,3,4422,7,30
794,195,1,795,6,4428,1,60
795,195,1,796,4,4432,1,40
796,195,1,797,7,4439,6,70
797,195,1,798,4,4443,7,40
798,195,1,799,6,4449,4,60
799,195,1,800,2,4451,7,20
800,195,1,801,9,4460,1,90
801,195,1,802,7,4467,2,70
802,195,1,803,8,4475,1,80
803,195,1,804,3,4478,2,30
804,195,1,805,7,4485,1,70
805,195,1,806,6,4491,1,60
806,195,1,807,4,4495,1,40
807,195,1,808,8,4503,4,80
808,195,1,809,5,4508,1,50
809,195,1,810,2,4510,7,20
810,195,1,811,6,4516,2,60
811,195,1,812,5,4521,1,50
812,195,1,813,5,4526,1,50
813,195,1,814,5,4531,7,50
814,195,1,815,7,4538,1,70
815,195,1,816,2,4540,1,20
816,195,1,817,6,4546,1,60
817,195,1,818,6,4552,1,60
818,195,1,819,7,4559,9,70
819,195,1,820,2,4561,1,20
820,195,1,821,8,4569,1,80
821,195,1,822,3,4572,7,30
822,195,1,823,9,4581,8,90
823,195,1,824,4,4585,7,40
824,195,1,825,6,4591,1,60
825,195,1,826,8,4599,1,80
826,195,1,827,8,4607,6,80
827,195,1,828,6,4613,1,60
828,195,1,829,8,4621,7,80
829,195,1,830,8,4629,1,80
830,195,1,831,6,4635,6,60
831,195,1,832,7,4642,4,70
832,195,1,833,6,4648,1,60
833,195,1,834,7,4655,4,70
834,195,1,835,4,4659,1,40
835,195,1,836,7,4666,4,70
836,195,1,837,4,4670,9,40
837,195,1,838,9,4679,1,90
838,195,1,839,6,4685,1,60
839,195,1,840,8,4693,1,80
840,195,1,841,6,4699,11,60
841,195,1,842,5,4704,1,50
842,195,1,843,8,4712,1,80
843,195,1,844,3,4715,8,30
844,195,1,845,3,4718,6,30
845,195,1,846,9,4727,3,90
846,195,1,847,8,4735,2,80
847,195,1,848,6,4741,1,60
848,195,1,849,8,4749,1,80
849,195,1,850,2,4751,1,20
850,195,1,851,8,4759,4,80
851,195,1,852,5,4764,5,50
852,195,1,853,8,4772,1,80
853,195,1,854,6,4778,6,60
854,195,1,855,9,4787,5,90
855,195,1,856,3,4790,1,30
856,195,1,857,8,4798,3,80
857,195,1,858,9,4807,5,90
858,195,1,859,7,4814,6,70
859,195,1,860,7,4821,1,70
860,195,1,861,5,4826,2,50
861,195,1,862,7,4833,9,70
862,195,1,863,3,4836,1,30
863,195,1,864,8,4844,6,80
864,195,1,865,6,4850,1,60
865,195,1,866,7,4857,1,70
866,195,1,867,3,4860,5,30
867,195,1,868,8,4868,2,80
868,195,1,869,9,4877,3,90
869,195,1,870,4,4881,3,40
870,195,1,871,4,4885,1,40
871,195,1,872,6,4891,6,60
872,195,1,873,2,4893,1,20
873,195,1,874,8,4901,5,80
874,195,1,875,8,4909,1,80
875,195,1,876,4,4913,7,40
876,195,1,877,5,4918,1,50
877,195,1,878,4,4922,1,40
878,195,1,879,6,4928,1,60
879,195,1,880,7,4935,1,70
880,195,1,881,7,4942,2,70
881,195,1,882,9,4951,6,90
882,195,1,883,9,4960,7,90
883,195,1,884,7,4967,5,70
884,195,1,885,5,4972,1,50
885,195,1,886,8,4980,1,80
886,195,1,887,3,4983,3,30
887,195,1,888,9,4992,1,90
888,195,1,889,5,4997,1,50
889,195,2,1,4,4,0,40
890,195,2,2,4,8,1,40
891,195,2,3,6,14,2,60
892,195,2,4,9,23,1,90
893,195,2,5,3,26,1,30
894,195,2,6,3,29,1,30
895,195,2,7,3,32,3,30
896,195,2,8,2,34,1,20
897,195,2,9,7,41,5,70
898,195,2,10,7,48,1,70
899,195,2,11,9,57,1,90
900,195,2,12,9,66,1,90
901,195,2,13,6,72,3,60
902,195,2,14,6,78,1,60
903,195,2,15,8,86,5,80
904,195,2,16,8,94,3,80
905,195,2,17,2,96,1,20
906,195,2,18,8,104,7,80
907,195,2,19,5,109,3,50
908,195,2,20,6,115,1,60
909,195,2,21,5,120,1,50
910,195,2,22,8,128,2,80
911,195,2,23,8,136,5,80
912,195,2,24,4,140,6,40
913,195,2,25,4,144,4,40
914,195,2,26,4,148,1,40
915,195,2,27,9,157,1,90
916,195,2,28,4,161,1,40
917,195,2,29,5,166,5,50
918,195,2,30,2,168,1,20
919,195,2,31,2,170,1,20
920,195,2,32,7,177,3,70
921,195,2,33,8,185,4,80
922,195,2,34,5,190,1,50
923,195,2,35,4,194,2,40
924,195,2,36,5,199,6,50
925,195,2,37,7,206,1,70
926,195,2,38,6,212,1,60
927,195,2,39,5,217,1,50
928,195,2,40,9,226,1,90
929,195,2,41,3,229,1,30
930,195,2,42,9,238,1,90
931,195,2,43,6,244,1,60
932,195,2,44,2,246,11,20
933,195,2,45,3,249,1,30
934,195,2,46,6,255,1,60
935,195,2,47,3,258,1,30
936,195,2,48,7,265,2,70
937,195,2,49,8,273,4,80
938,195,2,50,6,279,1,60
939,195,2,51,7,286,1,70
940,195,2,52,5,291,1,50
941,195,2,53,5,296,7,50
942,195,2,54,5,301,1,50
943,195,2,55,7,308,9,70
944,195,2,56,6,314,5,60
945,195,2,57,6,320,1,60
946,195,2,58,3,323,6,30
947,195,2,59,2,325,6,20
948,195,2,60,4,329,2,40
949,195,2,61,6,335,3,60
950,195,2,62,4,339,2,40
951,195,2,63,7,346,1,70
952,195,2,64,9,355,1,90
953,195,2,65,3,358,1,30
954,195,2,66,9,367,6,90
955,195,2,67,3,370,1,30
956,195,2,68,6,376,4,60
957,195,2,69,6,382,3,60
958,195,2,70,8,390,1,80
959,195,2,71,8,398,1,80
960,195,2,72,4,402,1,40
961,195,2,73,9,411,1,90
962,195,2,74,4,415,5,40
963,195,2,75,4,419,1,40
964,195,2,76,9,428,3,90
965,195,2,77,3,431,1,30
966,195,2,78,8,439,6,80
967,195,2,79,8,447,1,80
968,195,2,80,2,449,1,20
969,195,2,81,9,458,2,90
970,195,2,82,7,465,3,70
971,195,2,83,7,472,1,70
972,195,2,84,8,480,7,80
973,195,2,85,5,485,2,50
974,195,2,86,9,494,9,90
975,195,2,87,8,502,1,80
976,195,2,88,7,509,3,70
977,195,2,89,9,518,1,90
978,195,2,90,2,520,1,20
979,195,2,91,8,528,7,80
980,195,2,92,9,537,1,90
981,195,2,93,2,539,7,20
982,195,2,94,5,544,1,50
983,195,2,95,5,549,1,50
984,195,2,96,2,551,2,20
985,195,2,97,4,555,1,40
986,195,2,98,4,559,6,40
987,195,2,99,7,566,5,70
988,195,2,100,2,568,1,20
989,195,2,101,2,570,1,20
990,195,2,102,9,579,1,90
991,195,2,103,3,582,1,30
992,195,2,104,9,591,1,90
993,195,2,105,7,598,1,70
994,195,2,106,7,605,1,70
995,195,2,107,5,610,4,50
996,195,2,108,2,612,7,20
997,195,2,109,7,619,4,70
998,195,2,110,6,625,3,60
999,195,2,111,4,629,1,40
1000,195,2,112,4,633,1,40
1001,195,2,113,6,639,1,60
1002,195,2,114,5,644,3,50
1003,195,2,115,3,647,4,30
1004,195,2,116,6,653,6,60
1005,195,2,117,7,660,1,70
1006,195,2,118,9,669,2,90
1007,195,2,119,2,671,1,20
1008,195,2,120,2,673,1,20
1009,195,2,121,8,681,2,80
1010,195,2,122,9,690,1,90
1011,195,2,123,4,694,1,40
1012,195,2,124,5,699,4,50
1013,195,2,125,8,707,1,80
1014,195,2,126,7,714,1,70
1015,195,2,127,2,716,1,20
1016,195,2,128,3,719,7,30
1017,195,2,129,3,722,4,30
1018,195,2,130,9,731,1,90
1019,195,2,131,6,737,1,60
1020,195,2,132,6,743,2,60
1021,195,2,133,8,751,5,80
1022,195,2,134,7,758,4,70
1023,195,2,135,8,766,1,80
1024,195,2,136,8,774,1,80
1025,195,2,137,6,780,1,60
1026,195,2,138,3,783,1,30
1027,195,2,139,6,789,1,60
1028,195,2,140,4,793,1,40
1029,195,2,141,9,802,1,90
1030,195,2,142,7,809,1,70
1031,195,2,143,5,814,6,50
1032,195,2,144,5,819,7,50
1033,195,2,145,4,823,1,40
1034,195,2,146,9,832,7,90
1035,195,2,147,2,834,1,20
1036,195,2,148,2,836,1,20
1037,195,2,149,9,845,7,90
1038,195,2,150,6,851,1,60
1039,195,2,151,7,858,7,70
1040,195,2,152,2,860,1,20
1041,195,2,153,3,863,4,30
1042,195,2,154,8,871,1,80
1043,195,2,155,4,875,1,40
1044,195,2,156,4,879,3,40
1045,195,2,157,2,881,1,20
1046,195,2,158,5,886,3,50
1047,195,2,159,7,893,4,70
1048,195,2,160,8,901,4,80
1049,195,2,161,5,906,1,50
1050,195,2,162,5,911,1,50
1051,195,2,163,4,915,1,40
1052,195,2,164,7,922,1,70
1053,195,2,165,9,931,3,90
1054,195,2,166,6,937,1,60
1055,195,2,167,6,943,1,60
1056,195,2,168,7,950,6,70
1057,195,2,169,7,957,1,70
1058,195,2,170,3,960,1,30
1059,195,2,171,7,967,8,70
1060,195,2,172,7,974,1,70
1061,195,2,173,3,977,3,30
1062,195,2,174,4,981,1,40
1063,195,2,175,3,984,6,30
1064,195,2,176,5,989,6,50
1065,195,2,177,3,992,1,30
1066,195,2,178,7,999,1,70
1067,195,2,179,5,1004,3,50
1068,195,2,180,4,1008,1,40
1069,195,2,181,7,1015,1,70
1070,195,2,182,8,1023,8,80
1071,195,2,183,7,1030,4,70
1072,195,2,184,5,1035,1,50
1073,195,2,185,7,1042,1,70
1074,195,2,186,7,1049,1,70
1075,195,2,187,6,1055,1,60
1076,195,2,188,8,1063,1,80
1077,195,2,189,6,1069,1,60
1078,195,2,190,6,1075,11,60
1079,195,2,191,5,1080,8,50
1080,195,2,192,3,1083,1,30
1081,195,2,193,3,1086,7,30
1082,195,2,194,9,1095,1,90
1083,195,2,195,4,1099,1,40
1084,195,2,196,7,1106,1,70
1085,195,2,197,9,1115,1,90
1086,195,2,198,9,1124,7,90
1087,195,2,199,6,1130,1,60
1088,195,2,200,9,1139,1,90
1089,195,2,201,9,1148,1,90
1090,195,2,202,9,1157,1,90
1091,195,2,203,9,1166,1,90
1092,195,2,204,9,1175,17,90
1093,195,2,205,4,1179,1,40
1094,195,2,206,9,1188,1,90
1095,195,2,207,2,1190,7,20
1096,195,2,208,5,1195,8,50
1097,195,2,209,6,1201,4,60
1098,195,2,210,9,1210,1,90
1099,195,2,211,7,1217,1,70
1100,195,2,212,3,1220,4,30
1101,195,2,213,5,1225,1,50
1102,195,2,214,5,1230,1,50
1103,195,2,215,5,1235,6,50
1104,195,2,216,7,1242,1,70
1105,195,2,217,8,1250,5,80
1106,195,2,218,5,1255,3,50
1107,195,2,219,6,1261,4,60
1108,195,2,220,2,1263,1,20
1109,195,2,221,2,1265,1,20
1110,195,2,222,3,1268,1,30
1111,195,2,223,2,1270,4,20
1112,195,2,224,9,1279,6,90
1113,195,2,225,2,1281,3,20
1114,195,2,226,4,1285,3,40
1115,195,2,227,6,1291,1,60
1116,195,2,228,8,1299,3,80
1117,195,2,229,3,1302,1,30
1118,195,2,230,8,1310,2,80
1119,195,2,231,4,1314,4,40
1120,195,2,232,4,1318,1,40
1121,195,2,233,4,1322,1,40
1122,195,2,234,4,1326,1,40
1123,195,2,235,9,1335,1,90
1124,195,2,236,9,1344,4,90
1125,195,2,237,4,1348,1,40
1126,195,2,238,2,1350,1,20
1127,195,2,239,8,1358,3,80
1128,195,2,240,7,1365,7,70
1129,195,2,241,4,1369,1,40
1130,195,2,242,5,1374,2,50
1131,195,2,243,7,1381,6,70
1132,195,2,244,3,1384,1,30
1133,195,2,245,7,1391,1,70
1134,195,2,246,3,1394,1,30
1135,195,2,247,6,1400,1,60
1136,195,2,248,3,1403,6,30
1137,195,2,249,3,1406,1,30
1138,195,2,250,2,1408,1,20
1139,195,2,251,2,1410,4,20
1140,195,2,252,7,1417,1,70
1141,195,2,253,6,1423,1,60
1142,195,2,254,9,1432,1,90
1143,195,2,255,2,1434,4,20
1144,195,2,256,5,1439,2,50
1145,195,2,257,3,1442,1,30
1146,195,2,258,7,1449,2,70
1147,195,2,259,7,1456,5,70
1148,195,2,260,7,1463,1,70
1149,195,2,261,7,1470,1,70
1150,195,2,262,5,1475,5,50
1151,195,2,263,4,1479,4,40
1152,195,2,264,5,1484,1,50
1153,195,2,265,3,1487,3,30
1154,195,2,266,9,1496,1,90
1155,195,2,267,7,1503,1,70
1156,195,2,268,3,1506,2,30
1157,195,2,269,6,1512,1,60
1158,195,2,270,7,1519,6,70
1159,195,2,271,4,1523,1,40
1160,195,2,272,5,1528,1,50
1161,195,2,273,4,1532,2,40
1162,195,2,274,2,1534,1,20
1163,195,2,275,3,1537,1,30
1164,195,2,276,7,1544,4,70
1165,195,2,277,2,1546,1,20
1166,195,2,278,4,1550,1,40
1167,195,2,279,6,1556,4,60
1168,195,2,280,9,1565,4,90
1169,195,2,281,8,1573,7,80
1170,195,2,282,5,1578,1,50
1171,195,2,283,4,1582,3,40
1172,195,2,284,3,1585,1,30
1173,195,2,285,5,1590,1,50
1174,195,2,286,5,1595,1,50
1175,195,2,287,9,1604,2,90
1176,195,2,288,4,1608,1,40
1177,195,2,289,2,1610,2,20
1178,195,2,290,7,1617,3,70
1179,195,2,291,8,1625,1,80
1180,195,2,292,4,1629,1,40
1181,195,2,293,5,1634,1,50
1182,195,2,294,8,1642,1,80
1183,195,2,295,4,1646,1,40
1184,195,2,296,8,1654,1,80
1185,195,2,297,6,1660,12,60
1186,195,2,298,2,1662,8,20
1187,195,2,299,3,1665,6,30
1188,195,2,300,9,1674,1,90
1189,195,2,301,4,1678,1,40
1190,195,2,302,8,1686,1,80
1191,195,2,303,4,1690,1,40
1192,195,2,304,5,1695,1,50
1193,195,2,305,4,1699,7,40
1194,195,2,306,3,1702,9,30
1195,195,2,307,3,1705,5,30
1196,195,2,308,7,1712,3,70
1197,195,2,309,3,1715,6,30
1198,195,2,310,8,1723,1,80
1199,195,2,311,3,1726,9,30
1200,195,2,312,7,1733,3,70
1201,195,2,313,9,1742,1,90
1202,195,2,314,8,1750,1,80
1203,195,2,315,9,1759,1,90
1204,195,2,316,4,1763,6,40
1205,195,2,317,6,1769,9,60
1206,195,2,318,8,1777,1,80
1207,195,2,319,8,1785,2,80
1208,195,2,320,6,1791,5,60
1209,195,2,321,4,1795,1,40
1210,195,2,322,3,1798,5,30
1211,195,2,323,6,1804,1,60
1212,195,2,324,2,1806,2,20
1213,195,2,325,3,1809,3,30
1214,195,2,326,2,1811,1,20
1215,195,2,327,3,1814,1,30
1216,195,2,328,6,1820,1,60
1217,195,2,329,6,1826,5,60
1218,195,2,330,9,1835,1,90
1219,195,2,331,8,1843,1,80
1220,195,2,332,6,1849,1,60
1221,195,2,333,6,1855,1,60
1222,195,2,334,4,1859,6,40
1223,195,2,335,3,1862,5,30
1224,195,2,336,3,1865,6,30
1225,195,2,337,9,1874,1,90
1226,195,2,338,6,1880,5,60
1227,195,2,339,8,1888,1,80
1228,195,2,340,6,1894,1,60
1229,195,2,341,2,1896,1,20
1230,195,2,342,6,1902,6,60
1231,195,2,343,3,1905,5,30
1232,195,2,344,6,1911,2,60
1233,195,2,345,4,1915,1,40
1234,195,2,346,2,1917,1,20
1235,195,2,347,5,1922,5,50
1236,195,2,348,9,1931,1,90
1237,195,2,349,7,1938,1,70
1238,195,2,350,3,1941,0,30
1239,195,2,351,8,1949,1,80
1240,195,2,352,8,1957,1,80
1241,195,2,353,9,1966,1,90
1242,195,2,354,4,1970,3,40
1243,195,2,355,9,1979,1,90
1244,195,2,356,9,1988,1,90
1245,195,2,357,7,1995,1,70
1246,195,2,358,2,1997,9,20
1247,195,2,359,9,2006,1,90
1248,195,2,360,9,2015,8,90
1249,195,2,361,6,2021,8,60
1250,195,2,362,7,2028,5,70
1251,195,2,363,5,2033,4,50
1252,195,2,364,3,2036,1,30
1253,195,2,365,5,2041,1,50
1254,195,2,366,8,2049,1,80
1255,195,2,367,5,2054,1,50
1256,195,2,368,5,2059,6,50
1257,195,2,369,5,2064,1,50
1258,195,2,370,2,2066,1,20
1259,195,2,371,9,2075,1,90
1260,195,2,372,9,2084,1,90
1261,195,2,373,9,2093,4,90
1262,195,2,374,5,2098,1,50
1263,195,2,375,3,2101,1,30
1264,195,2,376,3,2104,5,30
1265,195,2,377,6,2110,2,60
1266,195,2,378,7,2117,1,70
1267,195,2,379,6,2123,3,60
1268,195,2,380,8,2131,1,80
1269,195,2,381,5,2136,1,50
1270,195,2,382,4,2140,1,40
1271,195,2,383,3,2143,6,30
1272,195,2,384,2,2145,3,20
1273,195,2,385,2,2147,1,20
1274,195,2,386,4,2151,1,40
1275,195,2,387,2,2153,9,20
1276,195,2,388,5,2158,1,50
1277,195,2,389,7,2165,5,70
1278,195,2,390,3,2168,1,30
1279,195,2,391,3,2171,5,30
1280,195,2,392,6,2177,2,60
1281,195,2,393,6,2183,2,60
1282,195,2,394,6,2189,1,60
1283,195,2,395,5,2194,5,50
1284,195,2,396,8,2202,1,80
1285,195,2,397,8,2210,4,80
1286,195,2,398,4,2214,1,40
1287,195,2,399,6,2220,1,60
1288,195,2,400,9,2229,1,90
1289,195,2,401,7,2236,1,70
1290,195,2,402,5,2241,1,50
1291,195,2,403,5,2246,9,50
1292,195,2,404,5,2251,5,50
1293,195,2,405,7,2258,5,70
1294,195,2,406,2,2260,4,20
1295,195,2,407,5,2265,5,50
1296,195,2,408,4,2269,1,40
1297,195,2,409,6,2275,1,60
1298,195,2,410,8,2283,1,80
1299,195,2,411,9,2292,1,90
1300,195,2,412,6,2298,1,60
1301,195,2,413,8,2306,8,80
1302,195,2,414,7,2313,1,70
1303,195,2,415,2,2315,1,20
1304,195,2,416,7,2322,3,70
1305,195,2,417,7,2329,3,70
1306,195,2,418,2,2331,1,20
1307,195,2,419,9,2340,1,90
1308,195,2,420,3,2343,10,30
1309,195,2,421,3,2346,1,30
1310,195,2,422,4,2350,3,40
1311,195,2,423,8,2358,1,80
1312,195,2,424,6,2364,1,60
1313,195,2,425,7,2371,1,70
1314,195,2,426,2,2373,11,20
1315,195,2,427,4,2377,1,40
1316,195,2,428,4,2381,1,40
1317,195,2,429,3,2384,3,30
1318,195,2,430,7,2391,1,70
1319,195,2,431,8,2399,1,80
1320,195,2,432,2,2401,5,20
1321,195,2,433,3,2404,4,30
1322,195,2,434,2,2406,5,20
1323,195,2,435,9,2415,1,90
1324,195,2,436,6,2421,5,60
1325,195,2,437,5,2426,1,50
1326,195,2,438,3,2429,1,30
1327,195,2,439,9,2438,1,90
1328,195,2,440,8,2446,6,80
1329,195,2,441,4,2450,1,40
1330,195,2,442,5,2455,1,50
1331,195,2,443,8,2463,3,80
1332,195,2,444,9,2472,4,90
1333,195,2,445,5,2477,4,50
1334,195,2,446,2,2479,1,20
1335,195,2,447,9,2488,7,90
1336,195,2,448,4,2492,2,40
1337,195,2,449,6,2498,1,60
1338,195,2,450,7,2505,4,70
1339,195,2,451,4,2509,1,40
1340,195,2,452,5,2514,1,50
1341,195,2,453,5,2519,1,50
1342,195,2,454,2,2521,2,20
1343,195,2,455,2,2523,3,20
1344,195,2,456,6,2529,4,60
1345,195,2,457,4,2533,1,40
1346,195,2,458,5,2538,1,50
1347,195,2,459,4,2542,6,40
1348,195,2,460,2,2544,1,20
1349,195,2,461,8,2552,3,80
1350,195,2,462,4,2556,3,40
1351,195,2,463,3,2559,1,30
1352,195,2,464,9,2568,1,90
1353,195,2,465,8,2576,3,80
1354,195,2,466,7,2583,6,70
1355,195,2,467,8,2591,1,80
1356,195,2,468,7,2598,1,70
1357,195,2,469,4,2602,1,40
1358,195,2,470,2,2604,0,20
1359,195,2,471,5,2609,1,50
1360,195,2,472,6,2615,1,60
1361,195,2,473,9,2624,6,90
1362,195,2,474,7,2631,1,70
1363,195,2,475,8,2639,5,80
1364,195,2,476,5,2644,6,50
1365,195,2,477,5,2649,2,50
1366,195,2,478,5,2654,6,50
1367,195,2,479,3,2657,1,30
1368,195,2,480,9,2666,3,90
1369,195,2,481,9,2675,3,90
1370,195,2,482,5,2680,6,50
1371,195,2,483,5,2685,3,50
1372,195,2,484,5,2690,1,50
1373,195,2,485,8,2698,1,80
1374,195,2,486,4,2702,7,40
1375,195,2,487,9,2711,1,90
1376,195,2,488,9,2720,1,90
1377,195,2,489,3,2723,3,30
1378,195,2,490,9,2732,1,90
1379,195,2,491,4,2736,7,40
1380,195,2,492,8,2744,1,80
1381,195,2,493,4,2748,1,40
1382,195,2,494,3,2751,5,30
1383,195,2,495,4,2755,1,40
1384,195,2,496,3,2758,5,30
1385,195,2,497,2,2760,5,20
1386,195,2,498,8,2768,1,80
1387,195,2,499,5,2773,1,50
1388,195,2,500,3,2776,1,30
1389,195,2,501,9,2785,1,90
1390,195,2,502,3,2788,1,30
1391,195,2,503,5,2793,1,50
1392,195,2,504,8,2801,8,80
1393,195,2,505,7,2808,1,70
1394,195,2,506,4,2812,1,40
1395,195,2,507,9,2821,5,90
1396,195,2,508,7,2828,9,70
1397,195,2,509,7,2835,1,70
1398,195,2,510,3,2838,1,30
1399,195,2,511,8,2846,1,80
1400,195,2,512,9,2855,1,90
1401,195,2,513,4,2859,5,40
1402,195,2,514,3,2862,1,30
1403,195,2,515,9,2871,8,90
1404,195,2,516,7,2878,5,70
1405,195,2,517,5,2883,1,50
1406,195,2,518,8,2891,4,80
1407,195,2,519,7,2898,5,70
1408,195,2,520,9,2907,1,90
1409,195,2,521,5,2912,1,50
1410,195,2,522,5,2917,9,50
1411,195,2,523,3,2920,1,30
1412,195,2,524,3,2923,2,30
1413,195,2,525,6,2929,1,60
1414,195,2,526,7,2936,1,70
1415,195,2,527,7,2943,8,70
1416,195,2,528,3,2946,5,30
1417,195,2,529,6,2952,6,60
1418,195,2,530,8,2960,1,80
1419,195,2,531,6,2966,1,60
1420,195,2,532,4,2970,1,40
1421,195,2,533,8,2978,1,80
1422,195,2,534,8,2986,4,80
1423,195,2,535,7,2993,1,70
1424,195,2,536,9,3002,1,90
1425,195,2,537,2,3004,1,20
1426,195,2,538,9,3013,8,90
1427,195,2,539,2,3015,6,20
1428,195,2,540,9,3024,1,90
1429,195,2,541,6,3030,1,60
1430,195,2,542,3,3033,8,30
1431,195,2,543,7,3040,6,70
1432,195,2,544,7,3047,1,70
1433,195,2,545,3,3050,4,30
1434,195,2,546,8,3058,1,80
1435,195,2,547,5,3063,1,50
1436,195,2,548,8,3071,1,80
1437,195,2,549,9,3080,4,90
1438,195,2,550,3,3083,1,30
1439,195,2,551,6,3089,1,60
1440,195,2,552,6,3095,1,60
1441,195,2,553,9,3104,6,90
1442,195,2,554,2,3106,1,20
1443,195,2,555,5,3111,4,50
1444,195,2,556,5,3116,1,50
1445,195,2,557,8,3124,1,80
1446,195,2,558,2,3126,1,20
1447,195,2,559,4,3130,1,40
1448,195,2,560,4,3134,1,40
1449,195,2,561,8,3142,7,80
1450,195,2,562,6,3148,8,60
1451,195,2,563,2,3150,4,20
1452,195,2,564,3,3153,4,30
1453,195,2,565,3,3156,1,30
1454,195,2,566,7,3163,1,70
1455,195,2,567,7,3170,1,70
1456,195,2,568,5,3175,1,50
1457,195,2,569,8,3183,1,80
1458,195,2,570,5,3188,1,50
1459,195,2,571,9,3197,6,90
1460,195,2,572,5,3202,5,50
1461,195,2,573,6,3208,3,60
1462,195,2,574,2,3210,2,20
1463,195,2,575,2,3212,3,20
1464,195,2,576,3,3215,1,30
1465,195,2,577,5,3220,2,50
1466,195,2,578,3,3223,1,30
1467,195,2,579,2,3225,5,20
1468,195,2,580,9,3234,1,90
1469,195,2,581,8,3242,1,80
1470,195,2,582,4,3246,1,40
1471,195,2,583,8,3254,3,80
1472,195,2,584,3,3257,4,30
1473,195,2,585,5,3262,2,50
1474,195,2,586,3,3265,1,30
1475,195,2,587,6,3271,9,60
1476,195,2,588,4,3275,4,40
1477,195,2,589,2,3277,1,20
1478,195,2,590,6,3283,1,60
1479,195,2,591,9,3292,1,90
1480,195,2,592,9,3301,1,90
1481,195,2,593,9,3310,1,90
1482,195,2,594,4,3314,2,40
1483,195,2,595,2,3316,1,20
1484,195,2,596,3,3319,1,30
1485,195,2,597,7,3326,7,70
1486,195,2,598,6,3332,1,60
1487,195,2,599,6,3338,6,60
1488,195,2,600,8,3346,7,80
1489,195,2,601,2,3348,3,20
1490,195,2,602,5,3353,5,50
1491,195,2,603,7,3360,5,70
1492,195,2,604,2,3362,1,20
1493,195,2,605,8,3370,7,80
1494,195,2,606,4,3374,1,40
1495,195,2,607,5,3379,1,50
1496,195,2,608,3,3382,1,30
1497,195,2,609,3,3385,8,30
1498,195,2,610,3,3388,2,30
1499,195,2,611,4,3392,1,40
1500,195,2,612,5,3397,1,50
1501,195,2,613,8,3405,5,80
1502,195,2,614,3,3408,1,30
1503,195,2,615,3,3411,1,30
1504,195,2,616,3,3414,4,30
1505,195,2,617,3,3417,3,30
1506,195,2,618,9,3426,1,90
1507,195,2,619,2,3428,1,20
1508,195,2,620,5,3433,1,50
1509,195,2,621,3,3436,2,30
1510,195,2,622,2,3438,2,20
1511,195,2,623,7,3445,1,70
1512,195,2,624,9,3454,7,90
1513,195,2,625,4,3458,1,40
1514,195,2,626,6,3464,1,60
1515,195,2,627,7,3471,4,70
1516,195,2,628,4,3475,1,40
1517,195,2,629,6,3481,1,60
1518,195,2,630,7,3488,1,70
1519,195,2,631,9,3497,1,90
1520,195,2,632,8,3505,1,80
1521,195,2,633,8,3513,1,80
1522,195,2,634,9,3522,6,90
1523,195,2,635,2,3524,10,20
1524,195,2,636,6,3530,9,60
1525,195,2,637,2,3532,3,20
1526,195,2,638,2,3534,1,20
1527,195,2,639,4,3538,1,40
1528,195,2,640,3,3541,4,30
1529,195,2,641,2,3543,2,20
1530,195,2,642,6,3549,1,60
1531,195,2,643,5,3554,1,50
1532,195,2,644,7,3561,2,70
1533,195,2,645,3,3564,1,30
1534,195,2,646,5,3569,3,50
1535,195,2,647,4,3573,1,40
1536,195,2,648,9,3582,1,90
1537,195,2,649,6,3588,1,60
1538,195,2,650,9,3597,1,90
1539,195,2,651,9,3606,1,90
1540,195,2,652,9,3615,1,90
1541,195,2,653,4,3619,10,40
1542,195,2,654,8,3627,7,80
1543,195,2,655,6,3633,6,60
1544,195,2,656,3,3636,1,30
1545,195,2,657,5,3641,6,50
1546,195,2,658,2,3643,1,20
1547,195,2,659,8,3651,5,80
1548,195,2,660,9,3660,7,90
1549,195,2,661,9,3669,1,90
1550,195,2,662,9,3678,8,90
1551,195,2,663,4,3682,1,40
1552,195,2,664,5,3687,3,50
1553,195,2,665,8,3695,4,80
1554,195,2,666,7,3702,1,70
1555,195,2,667,9,3711,1,90
1556,195,2,668,6,3717,8,60
1557,195,2,669,6,3723,1,60
1558,195,2,670,9,3732,1,90
1559,195,2,671,8,3740,1,80
1560,195,2,672,7,3747,1,70
1561,195,2,673,6,3753,7,60
1562,195,2,674,8,3761,1,80
1563,195,2,675,8,3769,1,80
1564,195,2,676,4,3773,1,40
1565,195,2,677,5,3778,11,50
1566,195,2,678,8,3786,8,80
1567,195,2,679,4,3790,1,40
1568,195,2,680,4,3794,1,40
1569,195,2,681,8,3802,9,80
1570,195,2,682,8,3810,8,80
1571,195,2,683,9,3819,1,90
1572,195,2,684,2,3821,1,20
1573,195,2,685,8,3829,1,80
1574,195,2,686,3,3832,5,30
1575,195,2,687,4,3836,6,40
1576,195,2,688,6,3842,7,60
1577,195,2,689,9,3851,1,90
1578,195,2,690,9,3860,2,90
1579,195,2,691,6,3866,1,60
1580,195,2,692,9,3875,1,90
1581,195,2,693,3,3878,4,30
1582,195,2,694,7,3885,1,70
1583,195,2,695,9,3894,1,90
1584,195,2,696,7,3901,7,70
1585,195,2,697,7,3908,1,70
1586,195,2,698,4,3912,1,40
1587,195,2,699,2,3914,6,20
1588,195,2,700,9,3923,7,90
1589,195,2,701,2,3925,1,20
1590,195,2,702,5,3930,1,50
1591,195,2,703,8,3938,1,80
1592,195,2,704,9,3947,7,90
1593,195,2,705,7,3954,1,70
1594,195,2,706,4,3958,3,40
1595,195,2,707,8,3966,5,80
1596,195,2,708,4,3970,1,40
1597,195,2,709,9,3979,4,90
1598,195,2,710,8,3987,4,80
1599,195,2,711,8,3995,1,80
1600,195,2,712,8,4003,1,80
1601,195,2,713,3,4006,2,30
1602,195,2,714,6,4012,0,60
1603,195,2,715,6,4018,3,60
1604,195,2,716,8,4026,1,80
1605,195,2,717,3,4029,1,30
1606,195,2,718,4,4033,1,40
1607,195,2,719,6,4039,1,60
1608,195,2,720,4,4043,1,40
1609,195,2,721,5,4048,1,50
1610,195,2,722,5,4053,1,50
1611,195,2,723,5,4058,1,50
1612,195,2,724,5,4063,4,50
1613,195,2,725,9,4072,8,90
1614,195,2,726,5,4077,1,50
1615,195,2,727,8,4085,11,80
1616,195,2,728,8,4093,3,80
1617,195,2,729,8,4101,1,80
1618,195,2,730,8,4109,6,80
1619,195,2,731,6,4115,4,60
1620,195,2,732,7,4122,1,70
1621,195,2,733,8,4130,4,80
1622,195,2,734,4,4134,1,40
1623,195,2,735,9,4143,1,90
1624,195,2,736,5,4148,1,50
1625,195,2,737,5,4153,1,50
1626,195,2,738,8,4161,8,80
1627,195,2,739,4,4165,3,40
1628,195,2,740,9,4174,3,90
1629,195,2,741,5,4179,1,50
1630,195,2,742,2,4181,1,20
1631,195,2,743,5,4186,5,50
1632,195,2,744,8,4194,1,80
1633,195,2,745,3,4197,7,30
1634,195,2,746,8,4205,3,80
1635,195,2,747,8,4213,1,80
1636,195,2,748,4,4217,1,40
1637,195,2,749,5,4222,6,50
1638,195,2,750,8,4230,1,80
1639,195,2,751,2,4232,1,20
1640,195,2,752,6,4238,1,60
1641,195,2,753,7,4245,6,70
1642,195,2,754,5,4250,8,50
1643,195,2,755,3,4253,1,30
1644,195,2,756,5,4258,1,50
1645,195,2,757,2,4260,1,20
1646,195,2,758,8,4268,1,80
1647,195,2,759,2,4270,7,20
1648,195,2,760,5,4275,1,50
1649,195,2,761,9,4284,1,90
1650,195,2,762,5,4289,1,50
1651,195,2,763,8,4297,6,80
1652,195,2,764,2,4299,1,20
1653,195,2,765,7,4306,1,70
1654,195,2,766,4,4310,1,40
1655,195,2,767,3,4313,9,30
1656,195,2,768,6,4319,4,60
1657,195,2,769,6,4325,4,60
1658,195,2,770,6,4331,1,60
1659,195,2,771,8,4339,1,80
1660,195,2,772,6,4345,7,60
1661,195,2,773,7,4352,1,70
1662,195,2,774,2,4354,8,20
1663,195,2,775,8,4362,2,80
1664,195,2,776,2,4364,5,20
1665,195,2,777,4,4368,1,40
1666,195,2,778,7,4375,1,70
1667,195,2,779,3,4378,1,30
1668,195,2,780,5,4383,4,50
1669,195,2,781,2,4385,1,20
1670,195,2,782,4,4389,1,40
1671,195,2,783,3,4392,5,30
1672,195,2,784,7,4399,2,70
1673,195,2,785,7,4406,3,70
1674,195,2,786,4,4410,2,40
1675,195,2,787,3,4413,1,30
1676,195,2,788,6,4419,4,60
1677,195,2,789,7,4426,1,70
1678,195,2,790,3,4429,2,30
1679,195,2,791,2,4431,5,20
1680,195,2,792,6,4437,1,60
1681,195,2,793,9,4446,2,90
1682,195,2,794,2,4448,2,20
1683,195,2,795,9,4457,1,90
1684,195,2,796,4,4461,1,40
1685,195,2,797,3,4464,3,30
1686,195,2,798,3,4467,1,30
1687,195,2,799,5,4472,5,50
1688,195,2,800,8,4480,2,80
1689,195,2,801,7,4487,4,70
1690,195,2,802,3,4490,1,30
1691,195,2,803,4,4494,1,40
1692,195,2,804,8,4502,1,80
1693,195,2,805,4,4506,1,40
1694,195,2,806,5,4511,1,50
1695,195,2,807,9,4520,12,90
1696,195,2,808,7,4527,2,70
1697,195,2,809,7,4534,3,70
1698,195,2,810,7,4541,1,70
1699,195,2,811,6,4547,1,60
1700,195,2,812,8,4555,1,80
1701,195,2,813,8,4563,1,80
1702,195,2,814,8,4571,9,80
1703,195,2,815,3,4574,1,30
1704,195,2,816,9,4583,4,90
1705,195,2,817,8,4591,2,80
1706,195,2,818,2,4593,1,20
1707,195,2,819,2,4595,1,20
1708,195,2,820,9,4604,1,90
1709,195,2,821,4,4608,1,40
1710,195,2,822,6,4614,1,60
1711,195,2,823,9,4623,6,90
1712,195,2,824,5,4628,6,50
1713,195,2,825,6,4634,1,60
1714,195,2,826,8,4642,8,80
1715,195,2,827,9,4651,1,90
1716,195,2,828,6,4657,1,60
1717,195,2,829,3,4660,6,30
1718,195,2,830,3,4663,7,30
1719,195,2,831,9,4672,7,90
1720,195,2,832,2,4674,4,20
1721,195,2,833,3,4677,1,30
1722,195,2,834,3,4680,2,30
1723,195,2,835,7,4687,1,70
1724,195,2,836,5,4692,1,50
1725,195,2,837,9,4701,1,90
1726,195,2,838,9,4710,5,90
1727,195,2,839,2,4712,1,20
1728,195,2,840,5,4717,8,50
1729,195,2,841,5,4722,1,50
1730,195,2,842,6,4728,1,60
1731,195,2,843,3,4731,5,30
1732,195,2,844,5,4736,1,50
1733,195,2,845,5,4741,8,50
1734,195,2,846,4,4745,3,40
1735,195,2,847,8,4753,1,80
1736,195,2,848,5,4758,1,50
1737,195,2,849,7,4765,1,70
1738,195,2,850,2,4767,1,20
1739,195,2,851,2,4769,11,20
1740,195,2,852,3,4772,1,30
1741,195,2,853,8,4780,7,80
1742,195,2,854,8,4788,1,80
1743,195,2,855,6,4794,5,60
1744,195,2,856,2,4796,1,20
1745,195,2,857,5,4801,1,50
1746,195,2,858,3,4804,1,30
1747,195,2,859,8,4812,4,80
1748,195,2,860,6,4818,5,60
1749,195,2,861,3,4821,1,30
1750,195,2,862,6,4827,4,60
1751,195,2,863,2,4829,1,20
1752,195,2,864,8,4837,1,80
1753,195,2,865,5,4842,7,50
1754,195,2,866,5,4847,1,50
1755,195,2,867,8,4855,1,80
1756,195,2,868,6,4861,7,60
1757,195,2,869,2,4863,1,20
1758,195,2,870,4,4867,3,40
1759,195,2,871,6,4873,1,60
1760,195,2,872,5,4878,3,50
1761,195,2,873,4,4882,4,40
1762,195,2,874,7,4889,1,70
1763,195,2,875,4,4893,1,40
1764,195,2,876,9,4902,4,90
1765,195,2,877,5,4907,1,50
1766,195,2,878,3,4910,1,30
1767,195,2,879,5,4915,1,50
1768,195,2,880,2,4917,1,20
1769,195,2,881,3,4920,5,30
1770,195,2,882,4,4924,4,40
1771,195,2,883,7,4931,1,70
1772,195,2,884,8,4939,1,80
1773,195,2,885,6,4945,1,60
1774,195,2,886,6,4951,1,60
1775,195,2,887,7,4958,8,70
1776,195,2,888,8,4966,7,80
1777,195,2,889,8,4974,3,80
1778,195,2,890,2,4976,1,20
1779,195,2,891,6,4982,1,60
1780,195,2,892,3,4985,1,30
1781,195,2,893,2,4987,6,20
1782,195,2,894,7,4994,1,70
1783,195,3,1,6,6,0,60
1784,195,3,2,6,12,1,60
1785,195,3,3,8,20,1,80
1786,195,3,4,6,26,1,60
1787,195,3,5,5,31,1,50
1788,195,3,6,3,34,1,30
1789,195,3,7,6,40,3,60
1790,195,3,8,3,43,1,30
1791,195,3,9,3,46,2,30
1792,195,3,10,2,48,2,20
1793,195,3,11,5,53,1,50
1794,195,3,12,5,58,1,50
1795,195,3,13,5,63,1,50
1796,195,3,14,8,71,2,80
1797,195,3,15,3,74,6,30
1798,195,3,16,7,81,1,70
1799,195,3,17,9,90,1,90
1800,195,3,18,6,96,9,60
1801,195,3,19,3,99,1,30
1802,195,3,20,6,105,1,60
1803,195,3,21,6,111,2,60
1804,195,3,22,6,117,1,60
1805,195,3,23,5,122,3,50
1806,195,3,24,2,124,3,20
1807,195,3,25,6,130,1,60
1808,195,3,26,2,132,6,20
1809,195,3,27,4,136,4,40
1810,195,3,28,6,142,4,60
1811,195,3,29,8,150,1,80
1812,195,3,30,8,158,1,80
1813,195,3,31,8,166,1,80
1814,195,3,32,9,175,1,90
1815,195,3,33,7,182,1,70
1816,195,3,34,4,186,1,40
1817,195,3,35,6,192,1,60
1818,195,3,36,5,197,4,50
1819,195,3,37,9,206,8,90
1820,195,3,38,5,211,1,50
1821,195,3,39,4,215,6,40
1822,195,3,40,5,220,4,50
1823,195,3,41,6,226,1,60
1824,195,3,42,7,233,3,70
1825,195,3,43,3,236,2,30
1826,195,3,44,4,240,3,40
1827,195,3,45,3,243,1,30
1828,195,3,46,3,246,3,30
1829,195,3,47,6,252,5,60
1830,195,3,48,5,257,1,50
1831,195,3,49,9,266,1,90
1832,195,3,50,6,272,1,60
1833,195,3,51,3,275,1,30
1834,195,3,52,9,284,5,90
1835,195,3,53,8,292,5,80
1836,195,3,54,4,296,4,40
1837,195,3,55,7,303,4,70
1838,195,3,56,3,306,1,30
1839,195,3,57,7,313,1,70
1840,195,3,58,4,317,1,40
1841,195,3,59,9,326,4,90
1842,195,3,60,8,334,1,80
1843,195,3,61,2,336,1,20
1844,195,3,62,3,339,1,30
1845,195,3,63,2,341,1,20
1846,195,3,64,2,343,5,20
1847,195,3,65,6,349,1,60
1848,195,3,66,9,358,1,90
1849,195,3,67,9,367,1,90
1850,195,3,68,8,375,1,80
1851,195,3,69,8,383,9,80
1852,195,3,70,7,390,1,70
1853,195,3,71,4,394,8,40
1854,195,3,72,6,400,5,60
1855,195,3,73,3,403,7,30
1856,195,3,74,8,411,5,80
1857,195,3,75,6,417,5,60
1858,195,3,76,4,421,5,40
1859,195,3,77,3,424,3,30
1860,195,3,78,7,431,1,70
1861,195,3,79,7,438,1,70
1862,195,3,80,8,446,4,80
1863,195,3,81,4,450,6,40
1864,195,3,82,6,456,1,60
1865,195,3,83,6,462,3,60
1866,195,3,84,4,466,1,40
1867,195,3,85,6,472,4,60
1868,195,3,86,3,475,3,30
1869,195,3,87,6,481,3,60
1870,195,3,88,8,489,1,80
1871,195,3,89,9,498,1,90
1872,195,3,90,7,505,1,70
1873,195,3,91,2,507,1,20
1874,195,3,92,2,509,1,20
1875,195,3,93,3,512,1,30
1876,195,3,94,2,514,1,20
1877,195,3,95,6,520,1,60
1878,195,3,96,6,526,9,60
1879,195,3,97,9,535,1,90
1880,195,3,98,7,542,6,70
1881,195,3,99,6,548,10,60
1882,195,3,100,7,555,3,70
1883,195,3,101,9,564,6,90
1884,195,3,102,4,568,1,40
1885,195,3,103,8,576,1,80
1886,195,3,104,6,582,1,60
1887,195,3,105,9,591,1,90
1888,195,3,106,3,594,4,30
1889,195,3,107,4,598,1,40
1890,195,3,108,8,606,3,80
1891,195,3,109,5,611,3,50
1892,195,3,110,3,614,1,30
1893,195,3,111,7,621,7,70
1894,195,3,112,7,628,2,70
1895,195,3,113,5,633,3,50
1896,195,3,114,5,638,2,50
1897,195,3,115,7,645,1,70
1898,195,3,116,5,650,1,50
1899,195,3,117,7,657,1,70
1900,195,3,118,9,666,1,90
1901,195,3,119,2,668,1,20
1902,195,3,120,3,671,6,30
1903,195,3,121,7,678,6,70
1904,195,3,122,9,687,5,90
1905,195,3,123,4,691,1,40
1906,195,3,124,4,695,1,40
1907,195,3,125,3,698,8,30
1908,195,3,126,2,700,1,20
1909,195,3,127,2,702,1,20
1910,195,3,128,7,709,1,70
1911,195,3,129,2,711,1,20
1912,195,3,130,5,716,1,50
1913,195,3,131,3,719,1,30
1914,195,3,132,6,725,1,60
1915,195,3,133,6,731,8,60
1916,195,3,134,6,737,1,60
1917,195,3,135,8,745,1,80
1918,195,3,136,5,750,7,50
1919,195,3,137,8,758,1,80
1920,195,3,138,3,761,1,30
1921,195,3,139,7,768,1,70
1922,195,3,140,9,777,1,90
1923,195,3,141,3,780,1,30
1924,195,3,142,7,787,1,70
1925,195,3,143,9,796,7,90
1926,195,3,144,5,801,7,50
1927,195,3,145,2,803,1,20
1928,195,3,146,6,809,2,60
1929,195,3,147,6,815,8,60
1930,195,3,148,5,820,3,50
1931,195,3,149,7,827,3,70
1932,195,3,150,7,834,1,70
1933,195,3,151,9,843,1,90
1934,195,3,152,4,847,1,40
1935,195,3,153,8,855,1,80
1936,195,3,154,8,863,1,80
1937,195,3,155,5,868,1,50
1938,195,3,156,2,870,1,20
1939,195,3,157,8,878,6,80
1940,195,3,158,7,885,1,70
1941,195,3,159,5,890,1,50
1942,195,3,160,9,899,1,90
1943,195,3,161,7,906,1,70
1944,195,3,162,6,912,1,60
1945,195,3,163,5,917,12,50
1946,195,3,164,9,926,1,90
1947,195,3,165,7,933,1,70
1948,195,3,166,3,936,14,30
1949,195,3,167,2,938,1,20
1950,195,3,168,7,945,9,70
1951,195,3,169,3,948,1,30
1952,195,3,170,6,954,1,60
1953,195,3,171,3,957,1,30
1954,195,3,172,4,961,1,40
1955,195,3,173,8,969,12,80
1956,195,3,174,7,976,1,70
1957,195,3,175,9,985,1,90
1958,195,3,176,5,990,1,50
1959,195,3,177,3,993,1,30
1960,195,3,178,5,998,1,50
1961,195,3,179,7,1005,1,70
1962,195,3,180,5,1010,9,50
1963,195,3,181,4,1014,1,40
1964,195,3,182,4,1018,1,40
1965,195,3,183,8,1026,6,80
1966,195,3,184,6,1032,1,60
1967,195,3,185,2,1034,1,20
1968,195,3,186,2,1036,1,20
1969,195,3,187,7,1043,1,70
1970,195,3,188,9,1052,1,90
1971,195,3,189,4,1056,1,40
1972,195,3,190,6,1062,1,60
1973,195,3,191,7,1069,1,70
1974,195,3,192,7,1076,13,70
1975,195,3,193,5,1081,1,50
1976,195,3,194,8,1089,7,80
1977,195,3,195,4,1093,1,40
1978,195,3,196,8,1101,6,80
1979,195,3,197,3,1104,1,30
1980,195,3,198,7,1111,3,70
1981,195,3,199,5,1116,6,50
1982,195,3,200,5,1121,1,50
1983,195,3,201,5,1126,1,50
1984,195,3,202,4,1130,1,40
1985,195,3,203,7,1137,1,70
1986,195,3,204,5,1142,1,50
1987,195,3,205,4,1146,8,40
1988,195,3,206,4,1150,1,40
1989,195,3,207,8,1158,1,80
1990,195,3,208,3,1161,1,30
1991,195,3,209,3,1164,1,30
1992,195,3,210,7,1171,1,70
1993,195,3,211,2,1173,9,20
1994,195,3,212,9,1182,7,90
1995,195,3,213,4,1186,5,40
1996,195,3,214,5,1191,8,50
1997,195,3,215,6,1197,1,60
1998,195,3,216,6,1203,6,60
1999,195,3,217,2,1205,1,20
2000,195,3,218,8,1213,5,80
2001,195,3,219,9,1222,5,90
2002,195,3,220,6,1228,1,60
2003,195,3,221,2,1230,6,20
2004,195,3,222,3,1233,3,30
2005,195,3,223,3,1236,2,30
2006,195,3,224,4,1240,2,40
2007,195,3,225,2,1242,1,20
2008,195,3,226,4,1246,1,40
2009,195,3,227,2,1248,3,20
2010,195,3,228,5,1253,1,50
2011,195,3,229,9,1262,1,90
2012,195,3,230,5,1267,1,50
2013,195,3,231,4,1271,1,40
2014,195,3,232,5,1276,2,50
2015,195,3,233,7,1283,0,70
2016,195,3,234,7,1290,7,70
2017,195,3,235,4,1294,1,40
2018,195,3,236,2,1296,1,20
2019,195,3,237,5,1301,3,50
2020,195,3,238,4,1305,1,40
2021,195,3,239,3,1308,4,30
2022,195,3,240,7,1315,1,70
2023,195,3,241,5,1320,1,50
2024,195,3,242,7,1327,2,70
2025,195,3,243,2,1329,7,20
2026,195,3,244,2,1331,1,20
2027,195,3,245,2,1333,1,20
2028,195,3,246,7,1340,4,70
2029,195,3,247,2,1342,1,20
2030,195,3,248,7,1349,2,70
2031,195,3,249,8,1357,2,80
2032,195,3,250,2,1359,1,20
2033,195,3,251,7,1366,1,70
2034,195,3,252,3,1369,5,30
2035,195,3,253,8,1377,1,80
2036,195,3,254,8,1385,1,80
2037,195,3,255,5,1390,1,50
2038,195,3,256,3,1393,1,30
2039,195,3,257,9,1402,8,90
2040,195,3,258,3,1405,1,30
2041,195,3,259,6,1411,1,60
2042,195,3,260,6,1417,1,60
2043,195,3,261,9,1426,8,90
2044,195,3,262,5,1431,7,50
2045,195,3,263,5,1436,1,50
2046,195,3,264,2,1438,1,20
2047,195,3,265,9,1447,1,90
2048,195,3,266,9,1456,1,90
2049,195,3,267,8,1464,1,80
2050,195,3,268,9,1473,1,90
2051,195,3,269,8,1481,1,80
2052,195,3,270,8,1489,1,80
2053,195,3,271,3,1492,5,30
2054,195,3,272,4,1496,1,40
2055,195,3,273,3,1499,1,30
2056,195,3,274,3,1502,1,30
2057,195,3,275,7,1509,8,70
2058,195,3,276,3,1512,1,30
2059,195,3,277,5,1517,1,50
2060,195,3,278,6,1523,7,60
2061,195,3,279,3,1526,13,30
2062,195,3,280,4,1530,1,40
2063,195,3,281,3,1533,1,30
2064,195,3,282,5,1538,1,50
2065,195,3,283,8,1546,1,80
2066,195,3,284,4,1550,1,40
2067,195,3,285,4,1554,1,40
2068,195,3,286,6,1560,8,60
2069,195,3,287,3,1563,1,30
2070,195,3,288,4,1567,6,40
2071,195,3,289,7,1574,4,70
2072,195,3,290,2,1576,8,20
2073,195,3,291,3,1579,1,30
2074,195,3,292,3,1582,1,30
2075,195,3,293,7,1589,1,70
2076,195,3,294,2,1591,3,20
2077,195,3,295,7,1598,1,70
2078,195,3,296,5,1603,1,50
2079,195,3,297,4,1607,1,40
2080,195,3,298,3,1610,4,30
2081,195,3,299,9,1619,1,90
2082,195,3,300,9,1628,3,90
2083,195,3,301,2,1630,1,20
2084,195,3,302,8,1638,1,80
2085,195,3,303,7,1645,2,70
2086,195,3,304,7,1652,1,70
2087,195,3,305,5,1657,1,50
2088,195,3,306,2,1659,8,20
2089,195,3,307,4,1663,4,40
2090,195,3,308,4,1667,1,40
2091,195,3,309,6,1673,1,60
2092,195,3,310,9,1682,2,90
2093,195,3,311,5,1687,3,50
2094,195,3,312,2,1689,1,20
2095,195,3,313,9,1698,1,90
2096,195,3,314,3,1701,1,30
2097,195,3,315,4,1705,5,40
2098,195,3,316,9,1714,4,90
2099,195,3,317,3,1717,1,30
2100,195,3,318,4,1721,1,40
2101,195,3,319,8,1729,4,80
2102,195,3,320,8,1737,3,80
2103,195,3,321,7,1744,1,70
2104,195,3,322,3,1747,1,30
2105,195,3,323,4,1751,1,40
2106,195,3,324,3,1754,1,30
2107,195,3,325,8,1762,3,80
2108,195,3,326,2,1764,4,20
2109,195,3,327,8,1772,1,80
2110,195,3,328,3,1775,1,30
2111,195,3,329,9,1784,1,90
2112,195,3,330,8,1792,1,80
2113,195,3,331,4,1796,1,40
2114,195,3,332,3,1799,7,30
2115,195,3,333,5,1804,1,50
2116,195,3,334,2,1806,3,20
2117,195,3,335,8,1814,1,80
2118,195,3,336,5,1819,1,50
2119,195,3,337,2,1821,4,20
2120,195,3,338,8,1829,1,80
2121,195,3,339,5,1834,8,50
2122,195,3,340,8,1842,1,80
2123,195,3,341,8,1850,1,80
2124,195,3,342,5,1855,1,50
2125,195,3,343,5,1860,4,50
2126,195,3,344,5,1865,1,50
2127,195,3,345,8,1873,6,80
2128,195,3,346,6,1879,5,60
2129,195,3,347,5,1884,1,50
2130,195,3,348,2,1886,6,20
2131,195,3,349,7,1893,3,70
2132,195,3,350,2,1895,1,20
2133,195,3,351,5,1900,3,50
2134,195,3,352,3,1903,1,30
2135,195,3,353,7,1910,1,70
2136,195,3,354,4,1914,5,40
2137,195,3,355,3,1917,1,30
2138,195,3,356,2,1919,1,20
2139,195,3,357,5,1924,1,50
2140,195,3,358,8,1932,1,80
2141,195,3,359,9,1941,1,90
2142,195,3,360,5,1946,7,50
2143,195,3,361,3,1949,10,30
2144,195,3,362,6,1955,1,60
2145,195,3,363,9,1964,7,90
2146,195,3,364,4,1968,1,40
2147,195,3,365,5,1973,1,50
2148,195,3,366,3,1976,1,30
2149,195,3,367,3,1979,1,30
2150,195,3,368,6,1985,2,60
2151,195,3,369,9,1994,6,90
2152,195,3,370,9,2003,3,90
2153,195,3,371,9,2012,1,90
2154,195,3,372,9,2021,1,90
2155,195,3,373,4,2025,4,40
2156,195,3,374,7,2032,3,70
2157,195,3,375,8,2040,1,80
2158,195,3,376,3,2043,1,30
2159,195,3,377,2,2045,6,20
2160,195,3,378,5,2050,1,50
2161,195,3,379,3,2053,5,30
2162,195,3,380,5,2058,1,50
2163,195,3,381,3,2061,5,30
2164,195,3,382,2,2063,1,20
2165,195,3,383,5,2068,2,50
2166,195,3,384,9,2077,1,90
2167,195,3,385,4,2081,1,40
2168,195,3,386,3,2084,4,30
2169,195,3,387,4,2088,1,40
2170,195,3,388,9,2097,1,90
2171,195,3,389,9,2106,1,90
2172,195,3,390,4,2110,7,40
2173,195,3,391,9,2119,6,90
2174,195,3,392,5,2124,1,50
2175,195,3,393,4,2128,1,40
2176,195,3,394,3,2131,6,30
2177,195,3,395,3,2134,1,30
2178,195,3,396,8,2142,1,80
2179,195,3,397,4,2146,1,40
2180,195,3,398,3,2149,9,30
2181,195,3,399,5,2154,2,50
2182,195,3,400,8,2162,1,80
2183,195,3,401,3,2165,1,30
2184,195,3,402,5,2170,1,50
2185,195,3,403,6,2176,5,60
2186,195,3,404,4,2180,1,40
2187,195,3,405,3,2183,8,30
2188,195,3,406,3,2186,7,30
2189,195,3,407,8,2194,1,80
2190,195,3,408,7,2201,4,70
2191,195,3,409,7,2208,1,70
2192,195,3,410,8,2216,7,80
2193,195,3,411,8,2224,7,80
2194,195,3,412,5,2229,1,50
2195,195,3,413,7,2236,5,70
2196,195,3,414,5,2241,1,50
2197,195,3,415,3,2244,1,30
2198,195,3,416,4,2248,1,40
2199,195,3,417,5,2253,1,50
2200,195,3,418,3,2256,1,30
2201,195,3,419,8,2264,4,80
2202,195,3,420,9,2273,7,90
2203,195,3,421,5,2278,1,50
2204,195,3,422,6,2284,1,60
2205,195,3,423,7,2291,1,70
2206,195,3,424,5,2296,1,50
2207,195,3,425,5,2301,1,50
2208,195,3,426,7,2308,1,70
2209,195,3,427,5,2313,1,50
2210,195,3,428,6,2319,1,60
2211,195,3,429,2,2321,5,20
2212,195,3,430,4,2325,1,40
2213,195,3,431,3,2328,1,30
2214,195,3,432,3,2331,1,30
2215,195,3,433,8,2339,8,80
2216,195,3,434,4,2343,7,40
2217,195,3,435,9,2352,1,90
2218,195,3,436,2,2354,5,20
2219,195,3,437,9,2363,1,90
2220,195,3,438,7,2370,6,70
2221,195,3,439,7,2377,1,70
2222,195,3,440,3,2380,1,30
2223,195,3,441,5,2385,1,50
2224,195,3,442,5,2390,1,50
2225,195,3,443,9,2399,1,90
2226,195,3,444,6,2405,1,60
2227,195,3,445,6,2411,10,60
2228,195,3,446,8,2419,1,80
2229,195,3,447,6,2425,1,60
2230,195,3,448,6,2431,10,60
2231,195,3,449,8,2439,5,80
2232,195,3,450,4,2443,9,40
2233,195,3,451,8,2451,1,80
2234,195,3,452,7,2458,1,70
2235,195,3,453,8,2466,1,80
2236,195,3,454,2,2468,6,20
2237,195,3,455,5,2473,1,50
2238,195,3,456,6,2479,1,60
2239,195,3,457,2,2481,1,20
2240,195,3,458,7,2488,7,70
2241,195,3,459,3,2491,1,30
2242,195,3,460,6,2497,7,60
2243,195,3,461,6,2503,1,60
2244,195,3,462,7,2510,1,70
2245,195,3,463,4,2514,3,40
2246,195,3,464,7,2521,1,70
2247,195,3,465,2,2523,1,20
2248,195,3,466,4,2527,1,40
2249,195,3,467,6,2533,1,60
2250,195,3,468,8,2541,2,80
2251,195,3,469,8,2549,6,80
2252,195,3,470,8,2557,1,80
2253,195,3,471,9,2566,2,90
2254,195,3,472,8,2574,2,80
2255,195,3,473,4,2578,1,40
2256,195,3,474,6,2584,4,60
2257,195,3,475,4,2588,1,40
2258,195,3,476,4,2592,1,40
2259,195,3,477,9,2601,1,90
2260,195,3,478,8,2609,1,80
2261,195,3,479,5,2614,1,50
2262,195,3,480,3,2617,1,30
2263,195,3,481,9,2626,4,90
2264,195,3,482,5,2631,6,50
2265,195,3,483,3,2634,1,30
2266,195,3,484,7,2641,1,70
2267,195,3,485,9,2650,1,90
2268,195,3,486,2,2652,1,20
2269,195,3,487,7,2659,4,70
2270,195,3,488,6,2665,4,60
2271,195,3,489,7,2672,2,70
2272,195,3,490,2,2674,1,20
2273,195,3,491,8,2682,5,80
2274,195,3,492,9,2691,1,90
2275,195,3,493,7,2698,1,70
2276,195,3,494,9,2707,6,90
2277,195,3,495,4,2711,11,40
2278,195,3,496,7,2718,5,70
2279,195,3,497,7,2725,1,70
2280,195,3,498,7,2732,1,70
2281,195,3,499,9,2741,7,90
2282,195,3,500,6,2747,9,60
2283,195,3,501,7,2754,1,70
2284,195,3,502,7,2761,4,70
2285,195,3,503,2,2763,1,20
2286,195,3,504,4,2767,1,40
2287,195,3,505,8,2775,1,80
2288,195,3,506,6,2781,1,60
2289,195,3,507,9,2790,3,90
2290,195,3,508,9,2799,4,90
2291,195,3,509,8,2807,1,80
2292,195,3,510,6,2813,7,60
2293,195,3,511,7,2820,1,70
2294,195,3,512,4,2824,1,40
2295,195,3,513,9,2833,7,90
2296,195,3,514,6,2839,1,60
2297,195,3,515,6,2845,1,60
2298,195,3,516,4,2849,5,40
2299,195,3,517,3,2852,4,30
2300,195,3,518,4,2856,1,40
2301,195,3,519,7,2863,6,70
2302,195,3,520,7,2870,2,70
2303,195,3,521,6,2876,3,60
2304,195,3,522,4,2880,1,40
2305,195,3,523,3,2883,1,30
2306,195,3,524,4,2887,1,40
2307,195,3,525,7,2894,11,70
2308,195,3,526,9,2903,2,90
2309,195,3,527,4,2907,1,40
2310,195,3,528,5,2912,5,50
2311,195,3,529,7,2919,1,70
2312,195,3,530,5,2924,1,50
2313,195,3,531,7,2931,1,70
2314,195,3,532,2,2933,6,20
2315,195,3,533,7,2940,5,70
2316,195,3,534,7,2947,3,70
2317,195,3,535,7,2954,6,70
2318,195,3,536,4,2958,6,40
2319,195,3,537,2,2960,1,20
2320,195,3,538,2,2962,1,20
2321,195,3,539,4,2966,1,40
2322,195,3,540,5,2971,4,50
2323,195,3,541,2,2973,3,20
2324,195,3,542,3,2976,0,30
2325,195,3,543,2,2978,1,20
2326,195,3,544,3,2981,1,30
2327,195,3,545,2,2983,1,20
2328,195,3,546,4,2987,1,40
2329,195,3,547,4,2991,4,40
2330,195,3,548,7,2998,1,70
2331,195,3,549,9,3007,1,90
2332,195,3,550,6,3013,3,60
2333,195,3,551,4,3017,3,40
2334,195,3,552,9,3026,1,90
2335,195,3,553,6,3032,5,60
2336,195,3,554,2,3034,2,20
2337,195,3,555,3,3037,1,30
2338,195,3,556,3,3040,1,30
2339,195,3,557,2,3042,2,20
2340,195,3,558,3,3045,1,30
2341,195,3,559,6,3051,1,60
2342,195,3,560,7,3058,7,70
2343,195,3,561,7,3065,2,70
2344,195,3,562,6,3071,1,60
2345,195,3,563,5,3076,1,50
2346,195,3,564,6,3082,1,60
2347,195,3,565,2,3084,1,20
2348,195,3,566,7,3091,6,70
2349,195,3,567,3,3094,3,30
2350,195,3,568,9,3103,1,90
2351,195,3,569,9,3112,5,90
2352,195,3,570,9,3121,2,90
2353,195,3,571,4,3125,3,40
2354,195,3,572,6,3131,3,60
2355,195,3,573,3,3134,1,30
2356,195,3,574,4,3138,5,40
2357,195,3,575,6,3144,4,60
2358,195,3,576,8,3152,1,80
2359,195,3,577,3,3155,1,30
2360,195,3,578,2,3157,1,20
2361,195,3,579,8,3165,2,80
2362,195,3,580,9,3174,1,90
2363,195,3,581,5,3179,3,50
2364,195,3,582,6,3185,1,60
2365,195,3,583,9,3194,1,90
2366,195,3,584,4,3198,1,40
2367,195,3,585,5,3203,1,50
2368,195,3,586,5,3208,2,50
2369,195,3,587,6,3214,1,60
2370,195,3,588,7,3221,1,70
2371,195,3,589,5,3226,8,50
2372,195,3,590,5,3231,5,50
2373,195,3,591,2,3233,1,20
2374,195,3,592,6,3239,6,60
2375,195,3,593,5,3244,1,50
2376,195,3,594,5,3249,3,50
2377,195,3,595,3,3252,1,30
2378,195,3,596,6,3258,1,60
2379,195,3,597,3,3261,1,30
2380,195,3,598,7,3268,5,70
2381,195,3,599,2,3270,1,20
2382,195,3,600,9,3279,1,90
2383,195,3,601,8,3287,5,80
2384,195,3,602,7,3294,1,70
2385,195,3,603,3,3297,1,30
2386,195,3,604,7,3304,1,70
2387,195,3,605,7,3311,1,70
2388,195,3,606,8,3319,1,80
2389,195,3,607,5,3324,1,50
2390,195,3,608,4,3328,1,40
2391,195,3,609,2,3330,10,20
2392,195,3,610,5,3335,4,50
2393,195,3,611,6,3341,9,60
2394,195,3,612,7,3348,8,70
2395,195,3,613,5,3353,4,50
2396,195,3,614,6,3359,3,60
2397,195,3,615,2,3361,3,20
2398,195,3,616,5,3366,1,50
2399,195,3,617,3,3369,1,30
2400,195,3,618,4,3373,7,40
2401,195,3,619,5,3378,4,50
2402,195,3,620,6,3384,1,60
2403,195,3,621,4,3388,4,40
2404,195,3,622,4,3392,1,40
2405,195,3,623,9,3401,1,90
2406,195,3,624,7,3408,1,70
2407,195,3,625,3,3411,4,30
2408,195,3,626,6,3417,1,60
2409,195,3,627,9,3426,1,90
2410,195,3,628,9,3435,1,90
2411,195,3,629,8,3443,1,80
2412,195,3,630,5,3448,1,50
2413,195,3,631,5,3453,7,50
2414,195,3,632,8,3461,11,80
2415,195,3,633,3,3464,6,30
2416,195,3,634,6,3470,8,60
2417,195,3,635,6,3476,1,60
2418,195,3,636,3,3479,1,30
2419,195,3,637,7,3486,4,70
2420,195,3,638,8,3494,3,80
2421,195,3,639,3,3497,4,30
2422,195,3,640,3,3500,1,30
2423,195,3,641,3,3503,2,30
2424,195,3,642,2,3505,1,20
2425,195,3,643,2,3507,2,20
2426,195,3,644,3,3510,1,30
2427,195,3,645,7,3517,5,70
2428,195,3,646,2,3519,3,20
2429,195,3,647,5,3524,6,50
2430,195,3,648,3,3527,1,30
2431,195,3,649,9,3536,1,90
2432,195,3,650,6,3542,1,60
2433,195,3,651,9,3551,4,90
2434,195,3,652,9,3560,1,90
2435,195,3,653,4,3564,1,40
2436,195,3,654,5,3569,1,50
2437,195,3,655,8,3577,5,80
2438,195,3,656,7,3584,5,70
2439,195,3,657,3,3587,1,30
2440,195,3,658,8,3595,1,80
2441,195,3,659,2,3597,1,20
2442,195,3,660,5,3602,1,50
2443,195,3,661,7,3609,1,70
2444,195,3,662,4,3613,1,40
2445,195,3,663,6,3619,1,60
2446,195,3,664,3,3622,6,30
2447,195,3,665,5,3627,6,50
2448,195,3,666,4,3631,4,40
2449,195,3,667,3,3634,1,30
2450,195,3,668,3,3637,0,30
2451,195,3,669,2,3639,1,20
2452,195,3,670,8,3647,1,80
2453,195,3,671,5,3652,1,50
2454,195,3,672,9,3661,1,90
2455,195,3,673,7,3668,1,70
2456,195,3,674,5,3673,1,50
2457,195,3,675,7,3680,6,70
2458,195,3,676,4,3684,10,40
2459,195,3,677,5,3689,4,50
2460,195,3,678,7,3696,1,70
2461,195,3,679,8,3704,1,80
2462,195,3,680,6,3710,1,60
2463,195,3,681,4,3714,3,40
2464,195,3,682,6,3720,1,60
2465,195,3,683,7,3727,7,70
2466,195,3,684,7,3734,7,70
2467,195,3,685,7,3741,7,70
2468,195,3,686,8,3749,3,80
2469,195,3,687,5,3754,1,50
2470,195,3,688,5,3759,6,50
2471,195,3,689,2,3761,6,20
2472,195,3,690,7,3768,1,70
2473,195,3,691,4,3772,1,40
2474,195,3,692,5,3777,1,50
2475,195,3,693,8,3785,1,80
2476,195,3,694,9,3794,1,90
2477,195,3,695,6,3800,6,60
2478,195,3,696,3,3803,1,30
2479,195,3,697,4,3807,7,40
2480,195,3,698,2,3809,5,20
2481,195,3,699,2,3811,1,20
2482,195,3,700,3,3814,4,30
2483,195,3,701,7,3821,4,70
2484,195,3,702,6,3827,1,60
2485,195,3,703,5,3832,1,50
2486,195,3,704,8,3840,1,80
2487,195,3,705,4,3844,1,40
2488,195,3,706,3,3847,6,30
2489,195,3,707,4,3851,2,40
2490,195,3,708,8,3859,0,80
2491,195,3,709,4,3863,1,40
2492,195,3,710,3,3866,2,30
2493,195,3,711,7,3873,4,70
2494,195,3,712,6,3879,6,60
2495,195,3,713,9,3888,2,90
2496,195,3,714,4,3892,1,40
2497,195,3,715,6,3898,1,60
2498,195,3,716,2,3900,1,20
2499,195,3,717,2,3902,1,20
2500,195,3,718,8,3910,1,80
2501,195,3,719,3,3913,1,30
2502,195,3,720,3,3916,1,30
2503,195,3,721,7,3923,1,70
2504,195,3,722,4,3927,4,40
2505,195,3,723,7,3934,4,70
2506,195,3,724,3,3937,1,30
2507,195,3,725,6,3943,4,60
2508,195,3,726,2,3945,1,20
2509,195,3,727,2,3947,1,20
2510,195,3,728,9,3956,1,90
2511,195,3,729,5,3961,1,50
2512,195,3,730,3,3964,6,30
2513,195,3,731,3,3967,3,30
2514,195,3,732,2,3969,1,20
2515,195,3,733,7,3976,2,70
2516,195,3,734,4,3980,1,40
2517,195,3,735,4,3984,1,40
2518,195,3,736,4,3988,4,40
2519,195,3,737,5,3993,6,50
2520,195,3,738,3,3996,1,30
2521,195,3,739,9,4005,1,90
2522,195,3,740,8,4013,1,80
2523,195,3,741,2,4015,9,20
2524,195,3,742,8,4023,3,80
2525,195,3,743,8,4031,1,80
2526,195,3,744,8,4039,1,80
2527,195,3,745,2,4041,1,20
2528,195,3,746,3,4044,1,30
2529,195,3,747,4,4048,1,40
2530,195,3,748,7,4055,1,70
2531,195,3,749,2,4057,1,20
2532,195,3,750,8,4065,1,80
2533,195,3,751,4,4069,6,40
2534,195,3,752,6,4075,5,60
2535,195,3,753,6,4081,7,60
2536,195,3,754,4,4085,1,40
2537,195,3,755,5,4090,1,50
2538,195,3,756,7,4097,6,70
2539,195,3,757,9,4106,7,90
2540,195,3,758,3,4109,1,30
2541,195,3,759,8,4117,1,80
2542,195,3,760,6,4123,1,60
2543,195,3,761,7,4130,4,70
2544,195,3,762,5,4135,1,50
2545,195,3,763,4,4139,1,40
2546,195,3,764,9,4148,7,90
2547,195,3,765,8,4156,10,80
2548,195,3,766,7,4163,1,70
2549,195,3,767,5,4168,1,50
2550,195,3,768,9,4177,1,90
2551,195,3,769,2,4179,1,20
2552,195,3,770,7,4186,1,70
2553,195,3,771,9,4195,1,90
2554,195,3,772,2,4197,1,20
2555,195,3,773,3,4200,12,30
2556,195,3,774,8,4208,1,80
2557,195,3,775,2,4210,1,20
2558,195,3,776,7,4217,9,70
2559,195,3,777,4,4221,1,40
2560,195,3,778,6,4227,1,60
2561,195,3,779,3,4230,7,30
2562,195,3,780,8,4238,1,80
2563,195,3,781,9,4247,9,90
2564,195,3,782,6,4253,1,60
2565,195,3,783,2,4255,2,20
2566,195,3,784,9,4264,6,90
2567,195,3,785,4,4268,1,40
2568,195,3,786,6,4274,4,60
2569,195,3,787,8,4282,9,80
2570,195,3,788,4,4286,6,40
2571,195,3,789,2,4288,1,20
2572,195,3,790,7,4295,3,70
2573,195,3,791,3,4298,1,30
2574,195,3,792,3,4301,5,30
2575,195,3,793,8,4309,6,80
2576,195,3,794,6,4315,2,60
2577,195,3,795,5,4320,1,50
2578,195,3,796,5,4325,1,50
2579,195,3,797,6,4331,1,60
2580,195,3,798,5,4336,3,50
2581,195,3,799,7,4343,1,70
2582,195,3,800,8,4351,5,80
2583,195,3,801,6,4357,1,60
2584,195,3,802,5,4362,4,50
2585,195,3,803,5,4367,1,50
2586,195,3,804,7,4374,1,70
2587,195,3,805,2,4376,1,20
2588,195,3,806,4,4380,1,40
2589,195,3,807,3,4383,1,30
2590,195,3,808,4,4387,5,40
2591,195,3,809,6,4393,1,60
2592,195,3,810,4,4397,1,40
2593,195,3,811,7,4404,9,70
2594,195,3,812,4,4408,5,40
2595,195,3,813,4,4412,3,40
2596,195,3,814,8,4420,1,80
2597,195,3,815,8,4428,1,80
2598,195,3,816,2,4430,1,20
2599,195,3,817,7,4437,1,70
2600,195,3,818,2,4439,1,20
2601,195,3,819,4,4443,1,40
2602,195,3,820,8,4451,1,80
2603,195,3,821,6,4457,1,60
2604,195,3,822,3,4460,11,30
2605,195,3,823,3,4463,1,30
2606,195,3,824,2,4465,1,20
2607,195,3,825,8,4473,1,80
2608,195,3,826,2,4475,1,20
2609,195,3,827,6,4481,9,60
2610,195,3,828,3,4484,1,30
2611,195,3,829,5,4489,12,50
2612,195,3,830,8,4497,1,80
2613,195,3,831,5,4502,1,50
2614,195,3,832,6,4508,1,60
2615,195,3,833,3,4511,10,30
2616,195,3,834,5,4516,7,50
2617,195,3,835,8,4524,5,80
2618,195,3,836,6,4530,1,60
2619,195,3,837,2,4532,1,20
2620,195,3,838,4,4536,8,40
2621,195,3,839,6,4542,7,60
2622,195,3,840,2,4544,4,20
2623,195,3,841,4,4548,1,40
2624,195,3,842,4,4552,2,40
2625,195,3,843,3,4555,5,30
2626,195,3,844,5,4560,5,50
2627,195,3,845,8,4568,1,80
2628,195,3,846,2,4570,3,20
2629,195,3,847,8,4578,1,80
2630,195,3,848,7,4585,1,70
2631,195,3,849,4,4589,5,40
2632,195,3,850,6,4595,1,60
2633,195,3,851,9,4604,1,90
2634,195,3,852,2,4606,1,20
2635,195,3,853,9,4615,5,90
2636,195,3,854,3,4618,1,30
2637,195,3,855,3,4621,1,30
2638,195,3,856,8,4629,7,80
2639,195,3,857,8,4637,8,80
2640,195,3,858,4,4641,5,40
2641,195,3,859,9,4650,4,90
2642,195,3,860,6,4656,1,60
2643,195,3,861,9,4665,1,90
2644,195,3,862,4,4669,1,40
2645,195,3,863,6,4675,5,60
2646,195,3,864,7,4682,1,70
2647,195,3,865,2,4684,1,20
2648,195,3,866,4,4688,1,40
2649,195,3,867,6,4694,9,60
2650,195,3,868,5,4699,4,50
2651,195,3,869,7,4706,1,70
2652,195,3,870,4,4710,6,40
2653,195,3,871,3,4713,1,30
2654,195,3,872,8,4721,3,80
2655,195,3,873,7,4728,7,70
2656,195,3,874,2,4730,1,20
2657,195,3,875,4,4734,1,40
2658,195,3,876,7,4741,5,70
2659,195,3,877,3,4744,4,30
2660,195,3,878,3,4747,1,30
2661,195,3,879,3,4750,0,30
2662,195,3,880,4,4754,2,40
2663,195,3,881,8,4762,1,80
2664,195,3,882,6,4768,1,60
2665,195,3,883,6,4774,3,60
2666,195,3,884,2,4776,4,20
2667,195,3,885,3,4779,1,30
2668,195,3,886,7,4786,1,70
2669,195,3,887,7,4793,1,70
2670,195,3,888,7,4800,1,70
2671,195,3,889,9,4809,1,90
2672,195,3,890,8,4817,1,80
2673,195,3,891,2,4819,5,20
2674,195,3,892,3,4822,1,30
2675,195,3,893,6,4828,5,60
2676,195,3,894,3,4831,1,30
2677,195,3,895,3,4834,4,30
2678,195,3,896,8,4842,2,80
2679,195,3,897,4,4846,6,40
2680,195,3,898,9,4855,5,90
2681,195,3,899,4,4859,1,40
2682,195,3,900,5,4864,1,50
2683,195,3,901,7,4871,4,70
2684,195,3,902,8,4879,1,80
2685,195,3,903,4,4883,1,40
2686,195,3,904,3,4886,3,30
2687,195,3,905,3,4889,1,30
2688,195,3,906,4,4893,1,40
2689,195,3,907,3,4896,9,30
2690,195,3,908,4,4900,2,40
2691,195,3,909,8,4908,1,80
2692,195,3,910,8,4916,1,80
2693,195,3,911,3,4919,6,30
2694,195,3,912,3,4922,6,30
2695,195,3,913,2,4924,1,20
2696,195,3,914,9,4933,8,90
2697,195,3,915,6,4939,1,60
2698,195,3,916,3,4942,9,30
2699,195,3,917,7,4949,9,70
2700,195,3,918,9,4958,1,90
2701,195,3,919,5,4963,1,50
2702,195,3,920,4,4967,0,40
2703,195,3,921,6,4973,2,60
2704,195,3,922,6,4979,1,60
2705,195,3,923,6,4985,1,60
2706,195,3,924,2,4987,1,20
2707,195,3,925,8,4995,1,80
