,Scenario,Trial,Inspection,Interval,Time,Defects,Rate
0,297,1,1,4,4,1,40
1,297,1,2,4,8,1,40
2,297,1,3,5,13,1,50
3,297,1,4,9,22,1,90
4,297,1,5,2,24,1,20
5,297,1,6,8,32,1,80
6,297,1,7,6,38,1,60
7,297,1,8,7,45,1,70
8,297,1,9,3,48,6,30
9,297,1,10,9,57,1,90
10,297,1,11,9,66,1,90
11,297,1,12,4,70,1,40
12,297,1,13,3,73,1,30
13,297,1,14,3,76,1,30
14,297,1,15,6,82,8,60
15,297,1,16,9,91,5,90
16,297,1,17,7,98,6,70
17,297,1,18,5,103,1,50
18,297,1,19,9,112,1,90
19,297,1,20,6,118,12,60
20,297,1,21,6,124,6,60
21,297,1,22,5,129,1,50
22,297,1,23,6,135,1,60
23,297,1,24,4,139,1,40
24,297,1,25,9,148,1,90
25,297,1,26,8,156,1,80
26,297,1,27,9,165,1,90
27,297,1,28,7,172,13,70
28,297,1,29,9,181,12,90
29,297,1,30,7,188,5,70
30,297,1,31,6,194,1,60
31,297,1,32,9,203,1,90
32,297,1,33,7,210,1,70
33,297,1,34,3,213,6,30
34,297,1,35,5,218,1,50
35,297,1,36,2,220,1,20
36,297,1,37,4,224,1,40
37,297,1,38,7,231,10,70
38,297,1,39,9,240,1,90
39,297,1,40,4,244,3,40
40,297,1,41,3,247,1,30
41,297,1,42,5,252,1,50
42,297,1,43,5,257,1,50
43,297,1,44,4,261,1,40
44,297,1,45,4,265,1,40
45,297,1,46,6,271,1,60
46,297,1,47,2,273,1,20
47,297,1,48,3,276,8,30
48,297,1,49,7,283,1,70
49,297,1,50,2,285,1,20
50,297,1,51,8,293,8,80
51,297,1,52,5,298,1,50
52,297,1,53,6,304,1,60
53,297,1,54,3,307,1,30
54,297,1,55,8,315,6,80
55,297,1,56,9,324,1,90
56,297,1,57,6,330,1,60
57,297,1,58,4,334,1,40
58,297,1,59,5,339,1,50
59,297,1,60,7,346,1,70
60,297,1,61,3,349,1,30
61,297,1,62,3,352,1,30
62,297,1,63,4,356,1,40
63,297,1,64,9,365,19,90
64,297,1,65,5,370,5,50
65,297,1,66,9,379,1,90
66,297,1,67,8,387,1,80
67,297,1,68,4,391,1,40
68,297,1,69,6,397,1,60
69,297,1,70,5,402,12,50
70,297,1,71,3,405,1,30
71,297,1,72,2,407,1,20
72,297,1,73,5,412,1,50
73,297,1,74,3,415,1,30
74,297,1,75,5,420,1,50
75,297,1,76,6,426,1,60
76,297,1,77,7,433,6,70
77,297,1,78,9,442,1,90
78,297,1,79,7,449,7,70
79,297,1,80,6,455,1,60
80,297,1,81,3,458,1,30
81,297,1,82,8,466,1,80
82,297,1,83,9,475,1,90
83,297,1,84,2,477,6,20
84,297,1,85,5,482,1,50
85,297,1,86,4,486,1,40
86,297,1,87,4,490,1,40
87,297,1,88,5,495,1,50
88,297,1,89,2,497,1,20
89,297,1,90,5,502,1,50
90,297,1,91,4,506,1,40
91,297,1,92,9,515,5,90
92,297,1,93,8,523,1,80
93,297,1,94,9,532,1,90
94,297,1,95,6,538,1,60
95,297,1,96,6,544,1,60
96,297,1,97,2,546,1,20
97,297,1,98,8,554,1,80
98,297,1,99,8,562,1,80
99,297,1,100,3,565,1,30
100,297,1,101,2,567,1,20
101,297,1,102,5,572,1,50
102,297,1,103,3,575,1,30
103,297,1,104,7,582,1,70
104,297,1,105,2,584,1,20
105,297,1,106,9,593,1,90
106,297,1,107,4,597,1,40
107,297,1,108,4,601,13,40
108,297,1,109,4,605,1,40
109,297,1,110,8,613,10,80
110,297,1,111,6,619,1,60
111,297,1,112,3,622,1,30
112,297,1,113,2,624,1,20
113,297,1,114,2,626,1,20
114,297,1,115,2,628,1,20
115,297,1,116,6,634,1,60
116,297,1,117,7,641,1,70
117,297,1,118,7,648,1,70
118,297,1,119,2,650,1,20
119,297,1,120,4,654,1,40
120,297,1,121,3,657,1,30
121,297,1,122,3,660,1,30
122,297,1,123,7,667,1,70
123,297,1,124,6,673,1,60
124,297,1,125,3,676,1,30
125,297,1,126,9,685,1,90
126,297,1,127,8,693,1,80
127,297,1,128,2,695,1,20
128,297,1,129,2,697,1,20
129,297,1,130,9,706,1,90
130,297,1,131,2,708,1,20
131,297,1,132,2,710,1,20
132,297,1,133,2,712,1,20
133,297,1,134,7,719,1,70
134,297,1,135,4,723,18,40
135,297,1,136,5,728,1,50
136,297,1,137,6,734,13,60
137,297,1,138,8,742,1,80
138,297,1,139,5,747,1,50
139,297,1,140,9,756,1,90
140,297,1,141,7,763,1,70
141,297,1,142,7,770,1,70
142,297,1,143,8,778,1,80
143,297,1,144,7,785,1,70
144,297,1,145,5,790,1,50
145,297,1,146,9,799,1,90
146,297,1,147,9,808,1,90
147,297,1,148,9,817,1,90
148,297,1,149,9,826,31,90
149,297,1,150,5,831,1,50
150,297,1,151,6,837,1,60
151,297,1,152,3,840,18,30
152,297,1,153,2,842,1,20
153,297,1,154,7,849,1,70
154,297,1,155,3,852,11,30
155,297,1,156,2,854,1,20
156,297,1,157,9,863,1,90
157,297,1,158,6,869,0,60
158,297,1,159,6,875,1,60
159,297,1,160,8,883,1,80
160,297,1,161,3,886,5,30
161,297,1,162,4,890,1,40
162,297,1,163,9,899,1,90
163,297,1,164,7,906,1,70
164,297,1,165,4,910,1,40
165,297,1,166,4,914,1,40
166,297,1,167,8,922,1,80
167,297,1,168,7,929,11,70
168,297,1,169,9,938,1,90
169,297,1,170,9,947,1,90
170,297,1,171,3,950,1,30
171,297,1,172,6,956,14,60
172,297,1,173,9,965,1,90
173,297,1,174,8,973,1,80
174,297,1,175,3,976,5,30
175,297,1,176,8,984,1,80
176,297,1,177,5,989,1,50
177,297,1,178,2,991,1,20
178,297,1,179,3,994,9,30
179,297,1,180,9,1003,1,90
180,297,1,181,3,1006,1,30
181,297,1,182,5,1011,1,50
182,297,1,183,4,1015,6,40
183,297,1,184,6,1021,5,60
184,297,1,185,7,1028,4,70
185,297,1,186,4,1032,1,40
186,297,1,187,8,1040,1,80
187,297,1,188,3,1043,1,30
188,297,1,189,6,1049,1,60
189,297,1,190,8,1057,1,80
190,297,1,191,8,1065,1,80
191,297,1,192,5,1070,1,50
192,297,1,193,5,1075,1,50
193,297,1,194,9,1084,1,90
194,297,1,195,5,1089,1,50
195,297,1,196,4,1093,1,40
196,297,1,197,4,1097,1,40
197,297,1,198,9,1106,1,90
198,297,1,199,6,1112,1,60
199,297,1,200,8,1120,1,80
200,297,1,201,5,1125,1,50
201,297,1,202,4,1129,28,40
202,297,1,203,4,1133,1,40
203,297,1,204,7,1140,9,70
204,297,1,205,5,1145,1,50
205,297,1,206,9,1154,1,90
206,297,1,207,3,1157,1,30
207,297,1,208,7,1164,6,70
208,297,1,209,2,1166,1,20
209,297,1,210,9,1175,1,90
210,297,1,211,2,1177,1,20
211,297,1,212,4,1181,8,40
212,297,1,213,6,1187,1,60
213,297,1,214,5,1192,1,50
214,297,1,215,7,1199,1,70
215,297,1,216,7,1206,1,70
216,297,1,217,2,1208,5,20
217,297,1,218,8,1216,8,80
218,297,1,219,4,1220,1,40
219,297,1,220,7,1227,1,70
220,297,1,221,3,1230,1,30
221,297,1,222,9,1239,1,90
222,297,1,223,6,1245,1,60
223,297,1,224,8,1253,9,80
224,297,1,225,9,1262,1,90
225,297,1,226,2,1264,1,20
226,297,1,227,7,1271,1,70
227,297,1,228,8,1279,1,80
228,297,1,229,3,1282,1,30
229,297,1,230,5,1287,1,50
230,297,1,231,6,1293,8,60
231,297,1,232,4,1297,1,40
232,297,1,233,4,1301,5,40
233,297,1,234,3,1304,1,30
234,297,1,235,5,1309,1,50
235,297,1,236,6,1315,1,60
236,297,1,237,8,1323,1,80
237,297,1,238,6,1329,7,60
238,297,1,239,8,1337,5,80
239,297,1,240,6,1343,1,60
240,297,1,241,2,1345,4,20
241,297,1,242,7,1352,2,70
242,297,1,243,5,1357,1,50
243,297,1,244,6,1363,5,60
244,297,1,245,9,1372,1,90
245,297,1,246,2,1374,1,20
246,297,1,247,8,1382,1,80
247,297,1,248,7,1389,1,70
248,297,1,249,6,1395,9,60
249,297,1,250,2,1397,1,20
250,297,1,251,3,1400,1,30
251,297,1,252,3,1403,1,30
252,297,1,253,3,1406,3,30
253,297,1,254,7,1413,1,70
254,297,1,255,6,1419,1,60
255,297,1,256,5,1424,10,50
256,297,1,257,3,1427,1,30
257,297,1,258,7,1434,1,70
258,297,1,259,6,1440,1,60
259,297,1,260,7,1447,1,70
260,297,1,261,4,1451,10,40
261,297,1,262,2,1453,8,20
262,297,1,263,7,1460,1,70
263,297,1,264,7,1467,1,70
264,297,1,265,9,1476,1,90
265,297,1,266,2,1478,1,20
266,297,1,267,4,1482,1,40
267,297,1,268,4,1486,1,40
268,297,1,269,8,1494,1,80
269,297,1,270,4,1498,1,40
270,297,1,271,7,1505,1,70
271,297,1,272,6,1511,1,60
272,297,1,273,5,1516,1,50
273,297,1,274,7,1523,1,70
274,297,1,275,4,1527,1,40
275,297,1,276,7,1534,1,70
276,297,1,277,5,1539,1,50
277,297,1,278,8,1547,19,80
278,297,1,279,5,1552,8,50
279,297,1,280,2,1554,1,20
280,297,1,281,9,1563,1,90
281,297,1,282,5,1568,2,50
282,297,1,283,8,1576,1,80
283,297,1,284,9,1585,9,90
284,297,1,285,5,1590,1,50
285,297,1,286,5,1595,1,50
286,297,1,287,7,1602,1,70
287,297,1,288,4,1606,1,40
288,297,1,289,5,1611,1,50
289,297,1,290,8,1619,1,80
290,297,1,291,5,1624,1,50
291,297,1,292,9,1633,1,90
292,297,1,293,4,1637,14,40
293,297,1,294,6,1643,13,60
294,297,1,295,6,1649,1,60
295,297,1,296,2,1651,1,20
296,297,1,297,2,1653,1,20
297,297,1,298,6,1659,6,60
298,297,1,299,9,1668,1,90
299,297,1,300,2,1670,1,20
300,297,1,301,5,1675,1,50
301,297,1,302,5,1680,1,50
302,297,1,303,9,1689,1,90
303,297,1,304,9,1698,1,90
304,297,1,305,3,1701,1,30
305,297,1,306,7,1708,1,70
306,297,1,307,2,1710,1,20
307,297,1,308,6,1716,1,60
308,297,1,309,7,1723,1,70
309,297,1,310,8,1731,13,80
310,297,1,311,5,1736,14,50
311,297,1,312,7,1743,1,70
312,297,1,313,8,1751,1,80
313,297,1,314,3,1754,1,30
314,297,1,315,9,1763,1,90
315,297,1,316,4,1767,12,40
316,297,1,317,3,1770,1,30
317,297,1,318,2,1772,1,20
318,297,1,319,4,1776,5,40
319,297,1,320,8,1784,1,80
320,297,1,321,7,1791,1,70
321,297,1,322,9,1800,1,90
322,297,1,323,9,1809,1,90
323,297,1,324,5,1814,1,50
324,297,1,325,9,1823,1,90
325,297,1,326,4,1827,1,40
326,297,1,327,9,1836,15,90
327,297,1,328,2,1838,9,20
328,297,1,329,9,1847,1,90
329,297,1,330,6,1853,1,60
330,297,1,331,4,1857,1,40
331,297,1,332,3,1860,1,30
332,297,1,333,4,1864,1,40
333,297,1,334,7,1871,10,70
334,297,1,335,4,1875,1,40
335,297,1,336,5,1880,1,50
336,297,1,337,9,1889,9,90
337,297,1,338,4,1893,1,40
338,297,1,339,6,1899,1,60
339,297,1,340,5,1904,1,50
340,297,1,341,7,1911,1,70
341,297,1,342,9,1920,8,90
342,297,1,343,7,1927,1,70
343,297,1,344,2,1929,1,20
344,297,1,345,6,1935,1,60
345,297,1,346,4,1939,5,40
346,297,1,347,5,1944,1,50
347,297,1,348,3,1947,8,30
348,297,1,349,4,1951,1,40
349,297,1,350,2,1953,1,20
350,297,1,351,4,1957,1,40
351,297,1,352,3,1960,1,30
352,297,1,353,6,1966,1,60
353,297,1,354,2,1968,1,20
354,297,1,355,3,1971,1,30
355,297,1,356,5,1976,1,50
356,297,1,357,8,1984,1,80
357,297,1,358,6,1990,1,60
358,297,1,359,9,1999,10,90
359,297,1,360,5,2004,1,50
360,297,1,361,9,2013,9,90
361,297,1,362,9,2022,1,90
362,297,1,363,3,2025,1,30
363,297,1,364,7,2032,1,70
364,297,1,365,7,2039,1,70
365,297,1,366,4,2043,1,40
366,297,1,367,8,2051,1,80
367,297,1,368,8,2059,10,80
368,297,1,369,6,2065,1,60
369,297,1,370,2,2067,1,20
370,297,1,371,6,2073,1,60
371,297,1,372,4,2077,1,40
372,297,1,373,4,2081,1,40
373,297,1,374,6,2087,1,60
374,297,1,375,7,2094,1,70
375,297,1,376,6,2100,1,60
376,297,1,377,5,2105,1,50
377,297,1,378,8,2113,1,80
378,297,1,379,2,2115,1,20
379,297,1,380,4,2119,1,40
380,297,1,381,8,2127,1,80
381,297,1,382,7,2134,1,70
382,297,1,383,2,2136,1,20
383,297,1,384,7,2143,1,70
384,297,1,385,6,2149,21,60
385,297,1,386,6,2155,1,60
386,297,1,387,2,2157,16,20
387,297,1,388,7,2164,1,70
388,297,1,389,5,2169,1,50
389,297,1,390,7,2176,1,70
390,297,1,391,9,2185,1,90
391,297,1,392,4,2189,1,40
392,297,1,393,7,2196,8,70
393,297,1,394,4,2200,1,40
394,297,1,395,6,2206,1,60
395,297,1,396,4,2210,1,40
396,297,1,397,7,2217,12,70
397,297,1,398,7,2224,1,70
398,297,1,399,7,2231,12,70
399,297,1,400,8,2239,1,80
400,297,1,401,6,2245,1,60
401,297,1,402,6,2251,1,60
402,297,1,403,3,2254,1,30
403,297,1,404,4,2258,6,40
404,297,1,405,4,2262,7,40
405,297,1,406,9,2271,1,90
406,297,1,407,4,2275,6,40
407,297,1,408,7,2282,1,70
408,297,1,409,9,2291,3,90
409,297,1,410,3,2294,6,30
410,297,1,411,6,2300,1,60
411,297,1,412,6,2306,1,60
412,297,1,413,5,2311,1,50
413,297,1,414,3,2314,1,30
414,297,1,415,3,2317,1,30
415,297,1,416,7,2324,1,70
416,297,1,417,5,2329,15,50
417,297,1,418,8,2337,1,80
418,297,1,419,7,2344,1,70
419,297,1,420,9,2353,1,90
420,297,1,421,9,2362,6,90
421,297,1,422,4,2366,1,40
422,297,1,423,7,2373,8,70
423,297,1,424,7,2380,1,70
424,297,1,425,9,2389,1,90
425,297,1,426,7,2396,1,70
426,297,1,427,6,2402,7,60
427,297,1,428,9,2411,1,90
428,297,1,429,5,2416,1,50
429,297,1,430,6,2422,1,60
430,297,1,431,6,2428,1,60
431,297,1,432,2,2430,1,20
432,297,1,433,8,2438,12,80
433,297,1,434,9,2447,1,90
434,297,1,435,2,2449,1,20
435,297,1,436,8,2457,1,80
436,297,1,437,8,2465,1,80
437,297,1,438,4,2469,1,40
438,297,1,439,7,2476,1,70
439,297,1,440,7,2483,1,70
440,297,1,441,2,2485,1,20
441,297,1,442,7,2492,15,70
442,297,1,443,5,2497,1,50
443,297,1,444,5,2502,11,50
444,297,1,445,3,2505,1,30
445,297,1,446,7,2512,1,70
446,297,1,447,7,2519,1,70
447,297,1,448,5,2524,1,50
448,297,1,449,3,2527,1,30
449,297,1,450,5,2532,1,50
450,297,1,451,5,2537,1,50
451,297,1,452,4,2541,1,40
452,297,1,453,6,2547,1,60
453,297,1,454,7,2554,1,70
454,297,1,455,6,2560,1,60
455,297,1,456,6,2566,13,60
456,297,1,457,5,2571,1,50
457,297,1,458,9,2580,1,90
458,297,1,459,3,2583,1,30
459,297,1,460,3,2586,1,30
460,297,1,461,6,2592,1,60
461,297,1,462,6,2598,17,60
462,297,1,463,8,2606,9,80
463,297,1,464,6,2612,1,60
464,297,1,465,5,2617,1,50
465,297,1,466,5,2622,1,50
466,297,1,467,5,2627,9,50
467,297,1,468,2,2629,3,20
468,297,1,469,5,2634,1,50
469,297,1,470,4,2638,1,40
470,297,1,471,7,2645,1,70
471,297,1,472,9,2654,1,90
472,297,1,473,2,2656,1,20
473,297,1,474,6,2662,10,60
474,297,1,475,3,2665,1,30
475,297,1,476,8,2673,1,80
476,297,1,477,2,2675,1,20
477,297,1,478,3,2678,1,30
478,297,1,479,2,2680,9,20
479,297,1,480,5,2685,1,50
480,297,1,481,6,2691,1,60
481,297,1,482,2,2693,1,20
482,297,1,483,4,2697,1,40
483,297,1,484,9,2706,1,90
484,297,1,485,9,2715,1,90
485,297,1,486,8,2723,1,80
486,297,1,487,7,2730,1,70
487,297,1,488,3,2733,10,30
488,297,1,489,4,2737,1,40
489,297,1,490,3,2740,1,30
490,297,1,491,4,2744,1,40
491,297,1,492,2,2746,1,20
492,297,1,493,3,2749,1,30
493,297,1,494,9,2758,1,90
494,297,1,495,2,2760,7,20
495,297,1,496,4,2764,1,40
496,297,1,497,2,2766,1,20
497,297,1,498,8,2774,1,80
498,297,1,499,7,2781,1,70
499,297,1,500,5,2786,1,50
500,297,1,501,8,2794,1,80
501,297,1,502,9,2803,1,90
502,297,1,503,2,2805,1,20
503,297,1,504,8,2813,14,80
504,297,1,505,3,2816,1,30
505,297,1,506,8,2824,1,80
506,297,1,507,7,2831,9,70
507,297,1,508,5,2836,1,50
508,297,1,509,6,2842,1,60
509,297,1,510,5,2847,1,50
510,297,1,511,7,2854,1,70
511,297,1,512,2,2856,1,20
512,297,1,513,7,2863,1,70
513,297,1,514,3,2866,7,30
514,297,1,515,8,2874,1,80
515,297,1,516,6,2880,20,60
516,297,1,517,2,2882,5,20
517,297,1,518,5,2887,0,50
518,297,1,519,4,2891,1,40
519,297,1,520,8,2899,1,80
520,297,1,521,8,2907,1,80
521,297,1,522,5,2912,1,50
522,297,1,523,7,2919,13,70
523,297,1,524,7,2926,1,70
524,297,1,525,3,2929,6,30
525,297,1,526,8,2937,1,80
526,297,1,527,7,2944,5,70
527,297,1,528,4,2948,1,40
528,297,1,529,8,2956,1,80
529,297,1,530,4,2960,1,40
530,297,1,531,9,2969,12,90
531,297,1,532,4,2973,4,40
532,297,1,533,6,2979,1,60
533,297,1,534,6,2985,1,60
534,297,1,535,6,2991,5,60
535,297,1,536,3,2994,1,30
536,297,1,537,6,3000,1,60
537,297,1,538,5,3005,1,50
538,297,1,539,2,3007,1,20
539,297,1,540,6,3013,1,60
540,297,1,541,9,3022,9,90
541,297,1,542,5,3027,1,50
542,297,1,543,3,3030,1,30
543,297,1,544,7,3037,1,70
544,297,1,545,4,3041,1,40
545,297,1,546,9,3050,1,90
546,297,1,547,2,3052,1,20
547,297,1,548,9,3061,8,90
548,297,1,549,2,3063,1,20
549,297,1,550,4,3067,1,40
550,297,1,551,3,3070,1,30
551,297,1,552,6,3076,1,60
552,297,1,553,7,3083,1,70
553,297,1,554,8,3091,1,80
554,297,1,555,4,3095,8,40
555,297,1,556,5,3100,1,50
556,297,1,557,3,3103,1,30
557,297,1,558,7,3110,1,70
558,297,1,559,6,3116,1,60
559,297,1,560,3,3119,1,30
560,297,1,561,6,3125,1,60
561,297,1,562,3,3128,1,30
562,297,1,563,6,3134,1,60
563,297,1,564,5,3139,1,50
564,297,1,565,3,3142,1,30
565,297,1,566,9,3151,1,90
566,297,1,567,8,3159,1,80
567,297,1,568,4,3163,1,40
568,297,1,569,4,3167,1,40
569,297,1,570,4,3171,1,40
570,297,1,571,2,3173,1,20
571,297,1,572,2,3175,1,20
572,297,1,573,7,3182,1,70
573,297,1,574,3,3185,1,30
574,297,1,575,5,3190,1,50
575,297,1,576,8,3198,1,80
576,297,1,577,4,3202,1,40
577,297,1,578,6,3208,35,60
578,297,1,579,7,3215,1,70
579,297,1,580,8,3223,1,80
580,297,1,581,2,3225,1,20
581,297,1,582,4,3229,1,40
582,297,1,583,3,3232,1,30
583,297,1,584,3,3235,1,30
584,297,1,585,2,3237,20,20
585,297,1,586,6,3243,8,60
586,297,1,587,7,3250,1,70
587,297,1,588,6,3256,9,60
588,297,1,589,8,3264,1,80
589,297,1,590,6,3270,1,60
590,297,1,591,9,3279,1,90
591,297,1,592,9,3288,1,90
592,297,1,593,6,3294,1,60
593,297,1,594,6,3300,1,60
594,297,1,595,4,3304,1,40
595,297,1,596,2,3306,1,20
596,297,1,597,8,3314,1,80
597,297,1,598,9,3323,1,90
598,297,1,599,5,3328,16,50
599,297,1,600,2,3330,1,20
600,297,1,601,9,3339,1,90
601,297,1,602,5,3344,1,50
602,297,1,603,7,3351,1,70
603,297,1,604,8,3359,1,80
604,297,1,605,9,3368,1,90
605,297,1,606,4,3372,1,40
606,297,1,607,7,3379,1,70
607,297,1,608,9,3388,12,90
608,297,1,609,6,3394,1,60
609,297,1,610,8,3402,1,80
610,297,1,611,2,3404,1,20
611,297,1,612,8,3412,1,80
612,297,1,613,7,3419,1,70
613,297,1,614,8,3427,1,80
614,297,1,615,5,3432,1,50
615,297,1,616,4,3436,1,40
616,297,1,617,2,3438,10,20
617,297,1,618,3,3441,7,30
618,297,1,619,6,3447,1,60
619,297,1,620,3,3450,1,30
620,297,1,621,5,3455,1,50
621,297,1,622,7,3462,1,70
622,297,1,623,9,3471,1,90
623,297,1,624,3,3474,1,30
624,297,1,625,5,3479,1,50
625,297,1,626,5,3484,1,50
626,297,1,627,5,3489,1,50
627,297,1,628,4,3493,1,40
628,297,1,629,5,3498,1,50
629,297,1,630,6,3504,1,60
630,297,1,631,3,3507,16,30
631,297,1,632,2,3509,1,20
632,297,1,633,7,3516,1,70
633,297,1,634,7,3523,1,70
634,297,1,635,7,3530,1,70
635,297,1,636,7,3537,1,70
636,297,1,637,6,3543,1,60
637,297,1,638,6,3549,1,60
638,297,1,639,7,3556,1,70
639,297,1,640,8,3564,18,80
640,297,1,641,9,3573,1,90
641,297,1,642,3,3576,1,30
642,297,1,643,2,3578,1,20
643,297,1,644,8,3586,1,80
644,297,1,645,6,3592,1,60
645,297,1,646,7,3599,10,70
646,297,1,647,2,3601,1,20
647,297,1,648,3,3604,1,30
648,297,1,649,7,3611,4,70
649,297,1,650,6,3617,1,60
650,297,1,651,9,3626,1,90
651,297,1,652,3,3629,1,30
652,297,1,653,6,3635,1,60
653,297,1,654,5,3640,17,50
654,297,1,655,3,3643,1,30
655,297,1,656,9,3652,1,90
656,297,1,657,2,3654,1,20
657,297,1,658,9,3663,1,90
658,297,1,659,9,3672,1,90
659,297,1,660,8,3680,1,80
660,297,1,661,6,3686,1,60
661,297,1,662,7,3693,1,70
662,297,1,663,3,3696,9,30
663,297,1,664,4,3700,1,40
664,297,1,665,8,3708,1,80
665,297,1,666,8,3716,1,80
666,297,1,667,5,3721,13,50
667,297,1,668,4,3725,1,40
668,297,1,669,8,3733,1,80
669,297,1,670,2,3735,1,20
670,297,1,671,8,3743,1,80
671,297,1,672,7,3750,1,70
672,297,1,673,3,3753,1,30
673,297,1,674,4,3757,1,40
674,297,1,675,2,3759,16,20
675,297,1,676,3,3762,1,30
676,297,1,677,2,3764,5,20
677,297,1,678,8,3772,1,80
678,297,1,679,5,3777,1,50
679,297,1,680,2,3779,1,20
680,297,1,681,8,3787,1,80
681,297,1,682,9,3796,1,90
682,297,1,683,2,3798,1,20
683,297,1,684,6,3804,1,60
684,297,1,685,6,3810,1,60
685,297,1,686,9,3819,1,90
686,297,1,687,5,3824,1,50
687,297,1,688,2,3826,1,20
688,297,1,689,5,3831,1,50
689,297,1,690,3,3834,1,30
690,297,1,691,9,3843,1,90
691,297,1,692,5,3848,1,50
692,297,1,693,9,3857,1,90
693,297,1,694,6,3863,1,60
694,297,1,695,6,3869,1,60
695,297,1,696,8,3877,23,80
696,297,1,697,9,3886,12,90
697,297,1,698,4,3890,4,40
698,297,1,699,5,3895,1,50
699,297,1,700,6,3901,1,60
700,297,1,701,5,3906,3,50
701,297,1,702,2,3908,2,20
702,297,1,703,8,3916,1,80
703,297,1,704,5,3921,1,50
704,297,1,705,2,3923,3,20
705,297,1,706,7,3930,1,70
706,297,1,707,3,3933,1,30
707,297,1,708,6,3939,1,60
708,297,1,709,7,3946,1,70
709,297,1,710,5,3951,1,50
710,297,1,711,7,3958,1,70
711,297,1,712,9,3967,7,90
712,297,1,713,4,3971,1,40
713,297,1,714,2,3973,1,20
714,297,1,715,8,3981,10,80
715,297,1,716,3,3984,1,30
716,297,1,717,7,3991,1,70
717,297,1,718,3,3994,1,30
718,297,1,719,3,3997,1,30
719,297,1,720,8,4005,1,80
720,297,1,721,5,4010,1,50
721,297,1,722,6,4016,1,60
722,297,1,723,3,4019,1,30
723,297,1,724,6,4025,1,60
724,297,1,725,5,4030,1,50
725,297,1,726,2,4032,1,20
726,297,1,727,2,4034,1,20
727,297,1,728,9,4043,1,90
728,297,1,729,9,4052,1,90
729,297,1,730,5,4057,1,50
730,297,1,731,9,4066,1,90
731,297,1,732,2,4068,1,20
732,297,1,733,6,4074,27,60
733,297,1,734,8,4082,1,80
734,297,1,735,5,4087,1,50
735,297,1,736,6,4093,1,60
736,297,1,737,3,4096,1,30
737,297,1,738,2,4098,1,20
738,297,1,739,9,4107,1,90
739,297,1,740,9,4116,1,90
740,297,1,741,2,4118,1,20
741,297,1,742,2,4120,1,20
742,297,1,743,8,4128,1,80
743,297,1,744,9,4137,1,90
744,297,1,745,2,4139,1,20
745,297,1,746,6,4145,1,60
746,297,1,747,3,4148,1,30
747,297,1,748,7,4155,27,70
748,297,1,749,7,4162,17,70
749,297,1,750,5,4167,1,50
750,297,1,751,9,4176,1,90
751,297,1,752,6,4182,1,60
752,297,1,753,6,4188,1,60
753,297,1,754,8,4196,21,80
754,297,1,755,4,4200,9,40
755,297,1,756,8,4208,9,80
756,297,1,757,7,4215,1,70
757,297,1,758,9,4224,2,90
758,297,1,759,4,4228,1,40
759,297,1,760,4,4232,5,40
760,297,1,761,2,4234,1,20
761,297,1,762,9,4243,1,90
762,297,1,763,6,4249,1,60
763,297,1,764,5,4254,1,50
764,297,1,765,6,4260,5,60
765,297,1,766,2,4262,2,20
766,297,1,767,4,4266,4,40
767,297,1,768,3,4269,1,30
768,297,1,769,8,4277,1,80
769,297,1,770,7,4284,1,70
770,297,1,771,7,4291,1,70
771,297,1,772,8,4299,1,80
772,297,1,773,9,4308,1,90
773,297,1,774,5,4313,1,50
774,297,1,775,8,4321,1,80
775,297,1,776,3,4324,11,30
776,297,1,777,8,4332,4,80
777,297,1,778,8,4340,1,80
778,297,1,779,7,4347,1,70
779,297,1,780,2,4349,1,20
780,297,1,781,4,4353,1,40
781,297,1,782,7,4360,7,70
782,297,1,783,2,4362,4,20
783,297,1,784,7,4369,1,70
784,297,1,785,4,4373,1,40
785,297,1,786,9,4382,1,90
786,297,1,787,8,4390,1,80
787,297,1,788,8,4398,1,80
788,297,1,789,8,4406,13,80
789,297,1,790,5,4411,1,50
790,297,1,791,5,4416,1,50
791,297,1,792,5,4421,1,50
792,297,1,793,7,4428,1,70
793,297,1,794,3,4431,1,30
794,297,1,795,7,4438,1,70
795,297,1,796,8,4446,1,80
796,297,1,797,3,4449,1,30
797,297,1,798,7,4456,1,70
798,297,1,799,5,4461,1,50
799,297,1,800,2,4463,1,20
800,297,1,801,5,4468,1,50
801,297,1,802,4,4472,1,40
802,297,1,803,7,4479,1,70
803,297,1,804,6,4485,1,60
804,297,1,805,4,4489,1,40
805,297,1,806,8,4497,26,80
806,297,1,807,7,4504,1,70
807,297,1,808,6,4510,1,60
808,297,1,809,5,4515,20,50
809,297,1,810,2,4517,9,20
810,297,1,811,9,4526,9,90
811,297,1,812,7,4533,1,70
812,297,1,813,5,4538,1,50
813,297,1,814,5,4543,1,50
814,297,1,815,3,4546,1,30
815,297,1,816,5,4551,1,50
816,297,1,817,9,4560,16,90
817,297,1,818,5,4565,10,50
818,297,1,819,5,4570,4,50
819,297,1,820,6,4576,1,60
820,297,1,821,3,4579,6,30
821,297,1,822,4,4583,4,40
822,297,1,823,9,4592,1,90
823,297,1,824,2,4594,7,20
824,297,1,825,6,4600,1,60
825,297,1,826,3,4603,1,30
826,297,1,827,4,4607,5,40
827,297,1,828,2,4609,3,20
828,297,1,829,9,4618,1,90
829,297,1,830,7,4625,1,70
830,297,1,831,9,4634,1,90
831,297,1,832,8,4642,1,80
832,297,1,833,9,4651,1,90
833,297,1,834,8,4659,1,80
834,297,1,835,9,4668,11,90
835,297,1,836,8,4676,1,80
836,297,1,837,6,4682,13,60
837,297,1,838,8,4690,1,80
838,297,1,839,2,4692,1,20
839,297,1,840,2,4694,1,20
840,297,1,841,9,4703,6,90
841,297,1,842,9,4712,11,90
842,297,1,843,8,4720,1,80
843,297,1,844,8,4728,1,80
844,297,1,845,7,4735,5,70
845,297,1,846,6,4741,1,60
846,297,1,847,5,4746,1,50
847,297,1,848,8,4754,1,80
848,297,1,849,4,4758,1,40
849,297,1,850,4,4762,1,40
850,297,1,851,3,4765,1,30
851,297,1,852,2,4767,1,20
852,297,1,853,6,4773,10,60
853,297,1,854,6,4779,1,60
854,297,1,855,5,4784,1,50
855,297,1,856,4,4788,1,40
856,297,1,857,6,4794,1,60
857,297,1,858,3,4797,8,30
858,297,1,859,9,4806,6,90
859,297,1,860,2,4808,1,20
860,297,1,861,8,4816,1,80
861,297,1,862,3,4819,1,30
862,297,1,863,4,4823,1,40
863,297,1,864,6,4829,10,60
864,297,1,865,2,4831,1,20
865,297,1,866,5,4836,1,50
866,297,1,867,7,4843,5,70
867,297,1,868,6,4849,1,60
868,297,1,869,7,4856,1,70
869,297,1,870,9,4865,1,90
870,297,1,871,4,4869,1,40
871,297,1,872,4,4873,1,40
872,297,1,873,6,4879,8,60
873,297,1,874,4,4883,1,40
874,297,1,875,8,4891,1,80
875,297,1,876,6,4897,9,60
876,297,1,877,3,4900,1,30
877,297,1,878,2,4902,1,20
878,297,1,879,5,4907,1,50
879,297,1,880,8,4915,9,80
880,297,1,881,2,4917,1,20
881,297,1,882,7,4924,1,70
882,297,1,883,8,4932,1,80
883,297,1,884,6,4938,1,60
884,297,1,885,2,4940,1,20
885,297,1,886,4,4944,1,40
886,297,1,887,4,4948,1,40
887,297,1,888,7,4955,1,70
888,297,1,889,5,4960,1,50
889,297,1,890,6,4966,1,60
890,297,1,891,7,4973,1,70
891,297,1,892,6,4979,13,60
892,297,1,893,5,4984,8,50
893,297,1,894,9,4993,1,90
894,297,2,1,9,9,1,90
895,297,2,2,6,15,3,60
896,297,2,3,9,24,1,90
897,297,2,4,8,32,1,80
898,297,2,5,8,40,8,80
899,297,2,6,7,47,5,70
900,297,2,7,4,51,1,40
901,297,2,8,2,53,1,20
902,297,2,9,7,60,4,70
903,297,2,10,3,63,1,30
904,297,2,11,9,72,1,90
905,297,2,12,6,78,10,60
906,297,2,13,6,84,1,60
907,297,2,14,3,87,1,30
908,297,2,15,2,89,1,20
909,297,2,16,3,92,1,30
910,297,2,17,7,99,1,70
911,297,2,18,9,108,1,90
912,297,2,19,2,110,1,20
913,297,2,20,2,112,1,20
914,297,2,21,5,117,1,50
915,297,2,22,4,121,1,40
916,297,2,23,2,123,10,20
917,297,2,24,9,132,1,90
918,297,2,25,3,135,9,30
919,297,2,26,4,139,1,40
920,297,2,27,3,142,5,30
921,297,2,28,4,146,1,40
922,297,2,29,3,149,1,30
923,297,2,30,9,158,1,90
924,297,2,31,9,167,4,90
925,297,2,32,3,170,1,30
926,297,2,33,3,173,1,30
927,297,2,34,8,181,1,80
928,297,2,35,6,187,1,60
929,297,2,36,9,196,1,90
930,297,2,37,9,205,1,90
931,297,2,38,3,208,1,30
932,297,2,39,5,213,1,50
933,297,2,40,6,219,1,60
934,297,2,41,9,228,1,90
935,297,2,42,9,237,1,90
936,297,2,43,2,239,1,20
937,297,2,44,9,248,1,90
938,297,2,45,9,257,1,90
939,297,2,46,2,259,1,20
940,297,2,47,2,261,1,20
941,297,2,48,7,268,1,70
942,297,2,49,3,271,1,30
943,297,2,50,7,278,1,70
944,297,2,51,6,284,27,60
945,297,2,52,3,287,1,30
946,297,2,53,6,293,1,60
947,297,2,54,8,301,15,80
948,297,2,55,8,309,1,80
949,297,2,56,3,312,7,30
950,297,2,57,5,317,5,50
951,297,2,58,4,321,1,40
952,297,2,59,6,327,9,60
953,297,2,60,2,329,1,20
954,297,2,61,4,333,2,40
955,297,2,62,5,338,1,50
956,297,2,63,4,342,1,40
957,297,2,64,6,348,1,60
958,297,2,65,7,355,1,70
959,297,2,66,2,357,1,20
960,297,2,67,7,364,6,70
961,297,2,68,8,372,1,80
962,297,2,69,3,375,1,30
963,297,2,70,7,382,1,70
964,297,2,71,7,389,1,70
965,297,2,72,2,391,1,20
966,297,2,73,2,393,1,20
967,297,2,74,7,400,1,70
968,297,2,75,5,405,1,50
969,297,2,76,3,408,1,30
970,297,2,77,2,410,1,20
971,297,2,78,2,412,1,20
972,297,2,79,5,417,1,50
973,297,2,80,7,424,12,70
974,297,2,81,3,427,6,30
975,297,2,82,6,433,3,60
976,297,2,83,6,439,1,60
977,297,2,84,9,448,1,90
978,297,2,85,9,457,5,90
979,297,2,86,8,465,13,80
980,297,2,87,6,471,1,60
981,297,2,88,6,477,1,60
982,297,2,89,7,484,1,70
983,297,2,90,4,488,1,40
984,297,2,91,4,492,5,40
985,297,2,92,3,495,1,30
986,297,2,93,3,498,1,30
987,297,2,94,8,506,1,80
988,297,2,95,4,510,1,40
989,297,2,96,6,516,7,60
990,297,2,97,9,525,1,90
991,297,2,98,2,527,1,20
992,297,2,99,7,534,1,70
993,297,2,100,2,536,7,20
994,297,2,101,9,545,1,90
995,297,2,102,3,548,9,30
996,297,2,103,2,550,1,20
997,297,2,104,8,558,1,80
998,297,2,105,9,567,1,90
999,297,2,106,5,572,1,50
1000,297,2,107,4,576,1,40
1001,297,2,108,3,579,1,30
1002,297,2,109,4,583,11,40
1003,297,2,110,8,591,8,80
1004,297,2,111,3,594,1,30
1005,297,2,112,2,596,1,20
1006,297,2,113,8,604,1,80
1007,297,2,114,8,612,1,80
1008,297,2,115,3,615,1,30
1009,297,2,116,4,619,4,40
1010,297,2,117,5,624,1,50
1011,297,2,118,7,631,1,70
1012,297,2,119,6,637,1,60
1013,297,2,120,5,642,1,50
1014,297,2,121,4,646,1,40
1015,297,2,122,5,651,1,50
1016,297,2,123,3,654,1,30
1017,297,2,124,6,660,1,60
1018,297,2,125,2,662,1,20
1019,297,2,126,9,671,1,90
1020,297,2,127,7,678,1,70
1021,297,2,128,8,686,1,80
1022,297,2,129,8,694,1,80
1023,297,2,130,5,699,1,50
1024,297,2,131,2,701,1,20
1025,297,2,132,7,708,1,70
1026,297,2,133,8,716,1,80
1027,297,2,134,8,724,1,80
1028,297,2,135,3,727,1,30
1029,297,2,136,6,733,1,60
1030,297,2,137,6,739,1,60
1031,297,2,138,8,747,1,80
1032,297,2,139,9,756,30,90
1033,297,2,140,4,760,23,40
1034,297,2,141,5,765,7,50
1035,297,2,142,9,774,1,90
1036,297,2,143,8,782,1,80
1037,297,2,144,2,784,1,20
1038,297,2,145,6,790,1,60
1039,297,2,146,2,792,1,20
1040,297,2,147,9,801,1,90
1041,297,2,148,5,806,1,50
1042,297,2,149,9,815,1,90
1043,297,2,150,5,820,1,50
1044,297,2,151,4,824,17,40
1045,297,2,152,2,826,1,20
1046,297,2,153,4,830,1,40
1047,297,2,154,6,836,1,60
1048,297,2,155,3,839,1,30
1049,297,2,156,7,846,1,70
1050,297,2,157,3,849,1,30
1051,297,2,158,7,856,1,70
1052,297,2,159,5,861,1,50
1053,297,2,160,6,867,1,60
1054,297,2,161,4,871,1,40
1055,297,2,162,7,878,1,70
1056,297,2,163,8,886,19,80
1057,297,2,164,7,893,1,70
1058,297,2,165,9,902,1,90
1059,297,2,166,3,905,1,30
1060,297,2,167,9,914,1,90
1061,297,2,168,6,920,1,60
1062,297,2,169,8,928,1,80
1063,297,2,170,4,932,1,40
1064,297,2,171,9,941,15,90
1065,297,2,172,4,945,1,40
1066,297,2,173,2,947,1,20
1067,297,2,174,3,950,1,30
1068,297,2,175,7,957,1,70
1069,297,2,176,4,961,1,40
1070,297,2,177,7,968,1,70
1071,297,2,178,3,971,1,30
1072,297,2,179,4,975,1,40
1073,297,2,180,6,981,23,60
1074,297,2,181,8,989,1,80
1075,297,2,182,6,995,1,60
1076,297,2,183,8,1003,7,80
1077,297,2,184,9,1012,1,90
1078,297,2,185,8,1020,1,80
1079,297,2,186,2,1022,1,20
1080,297,2,187,4,1026,1,40
1081,297,2,188,9,1035,1,90
1082,297,2,189,5,1040,1,50
1083,297,2,190,4,1044,1,40
1084,297,2,191,4,1048,1,40
1085,297,2,192,2,1050,16,20
1086,297,2,193,5,1055,1,50
1087,297,2,194,2,1057,6,20
1088,297,2,195,3,1060,1,30
1089,297,2,196,4,1064,1,40
1090,297,2,197,4,1068,1,40
1091,297,2,198,8,1076,1,80
1092,297,2,199,7,1083,1,70
1093,297,2,200,5,1088,1,50
1094,297,2,201,6,1094,1,60
1095,297,2,202,9,1103,1,90
1096,297,2,203,2,1105,8,20
1097,297,2,204,7,1112,1,70
1098,297,2,205,6,1118,7,60
1099,297,2,206,7,1125,1,70
1100,297,2,207,5,1130,1,50
1101,297,2,208,5,1135,1,50
1102,297,2,209,4,1139,1,40
1103,297,2,210,6,1145,13,60
1104,297,2,211,8,1153,9,80
1105,297,2,212,7,1160,1,70
1106,297,2,213,8,1168,1,80
1107,297,2,214,6,1174,9,60
1108,297,2,215,3,1177,1,30
1109,297,2,216,4,1181,1,40
1110,297,2,217,2,1183,1,20
1111,297,2,218,5,1188,1,50
1112,297,2,219,7,1195,1,70
1113,297,2,220,9,1204,10,90
1114,297,2,221,3,1207,1,30
1115,297,2,222,4,1211,1,40
1116,297,2,223,6,1217,1,60
1117,297,2,224,2,1219,1,20
1118,297,2,225,9,1228,1,90
1119,297,2,226,2,1230,1,20
1120,297,2,227,5,1235,1,50
1121,297,2,228,5,1240,9,50
1122,297,2,229,3,1243,1,30
1123,297,2,230,3,1246,1,30
1124,297,2,231,8,1254,9,80
1125,297,2,232,4,1258,1,40
1126,297,2,233,9,1267,1,90
1127,297,2,234,4,1271,1,40
1128,297,2,235,3,1274,7,30
1129,297,2,236,6,1280,3,60
1130,297,2,237,5,1285,3,50
1131,297,2,238,6,1291,1,60
1132,297,2,239,5,1296,1,50
1133,297,2,240,2,1298,1,20
1134,297,2,241,8,1306,1,80
1135,297,2,242,2,1308,4,20
1136,297,2,243,5,1313,1,50
1137,297,2,244,8,1321,1,80
1138,297,2,245,5,1326,1,50
1139,297,2,246,3,1329,9,30
1140,297,2,247,9,1338,1,90
1141,297,2,248,2,1340,1,20
1142,297,2,249,5,1345,6,50
1143,297,2,250,9,1354,1,90
1144,297,2,251,9,1363,1,90
1145,297,2,252,2,1365,1,20
1146,297,2,253,9,1374,1,90
1147,297,2,254,3,1377,1,30
1148,297,2,255,8,1385,1,80
1149,297,2,256,2,1387,1,20
1150,297,2,257,4,1391,5,40
1151,297,2,258,4,1395,1,40
1152,297,2,259,3,1398,1,30
1153,297,2,260,9,1407,1,90
1154,297,2,261,2,1409,1,20
1155,297,2,262,6,1415,1,60
1156,297,2,263,7,1422,1,70
1157,297,2,264,3,1425,1,30
1158,297,2,265,6,1431,1,60
1159,297,2,266,4,1435,1,40
1160,297,2,267,8,1443,1,80
1161,297,2,268,4,1447,1,40
1162,297,2,269,3,1450,1,30
1163,297,2,270,6,1456,1,60
1164,297,2,271,8,1464,1,80
1165,297,2,272,9,1473,1,90
1166,297,2,273,4,1477,19,40
1167,297,2,274,9,1486,1,90
1168,297,2,275,2,1488,1,20
1169,297,2,276,2,1490,1,20
1170,297,2,277,7,1497,14,70
1171,297,2,278,3,1500,1,30
1172,297,2,279,5,1505,1,50
1173,297,2,280,8,1513,9,80
1174,297,2,281,6,1519,1,60
1175,297,2,282,4,1523,1,40
1176,297,2,283,9,1532,1,90
1177,297,2,284,2,1534,1,20
1178,297,2,285,4,1538,1,40
1179,297,2,286,8,1546,9,80
1180,297,2,287,8,1554,1,80
1181,297,2,288,5,1559,13,50
1182,297,2,289,9,1568,1,90
1183,297,2,290,4,1572,1,40
1184,297,2,291,8,1580,1,80
1185,297,2,292,6,1586,1,60
1186,297,2,293,3,1589,1,30
1187,297,2,294,2,1591,1,20
1188,297,2,295,2,1593,1,20
1189,297,2,296,9,1602,1,90
1190,297,2,297,8,1610,1,80
1191,297,2,298,3,1613,1,30
1192,297,2,299,9,1622,1,90
1193,297,2,300,6,1628,9,60
1194,297,2,301,7,1635,1,70
1195,297,2,302,8,1643,12,80
1196,297,2,303,5,1648,1,50
1197,297,2,304,4,1652,1,40
1198,297,2,305,8,1660,1,80
1199,297,2,306,3,1663,1,30
1200,297,2,307,5,1668,8,50
1201,297,2,308,8,1676,1,80
1202,297,2,309,2,1678,1,20
1203,297,2,310,2,1680,1,20
1204,297,2,311,8,1688,1,80
1205,297,2,312,3,1691,1,30
1206,297,2,313,6,1697,1,60
1207,297,2,314,5,1702,18,50
1208,297,2,315,5,1707,1,50
1209,297,2,316,3,1710,1,30
1210,297,2,317,2,1712,1,20
1211,297,2,318,6,1718,1,60
1212,297,2,319,9,1727,11,90
1213,297,2,320,3,1730,1,30
1214,297,2,321,3,1733,1,30
1215,297,2,322,6,1739,1,60
1216,297,2,323,4,1743,1,40
1217,297,2,324,5,1748,1,50
1218,297,2,325,3,1751,1,30
1219,297,2,326,6,1757,1,60
1220,297,2,327,5,1762,1,50
1221,297,2,328,8,1770,1,80
1222,297,2,329,7,1777,1,70
1223,297,2,330,4,1781,1,40
1224,297,2,331,4,1785,1,40
1225,297,2,332,3,1788,1,30
1226,297,2,333,6,1794,1,60
1227,297,2,334,5,1799,23,50
1228,297,2,335,3,1802,1,30
1229,297,2,336,5,1807,1,50
1230,297,2,337,3,1810,1,30
1231,297,2,338,8,1818,1,80
1232,297,2,339,3,1821,1,30
1233,297,2,340,6,1827,1,60
1234,297,2,341,2,1829,1,20
1235,297,2,342,8,1837,1,80
1236,297,2,343,5,1842,1,50
1237,297,2,344,5,1847,1,50
1238,297,2,345,9,1856,1,90
1239,297,2,346,9,1865,1,90
1240,297,2,347,7,1872,1,70
1241,297,2,348,5,1877,1,50
1242,297,2,349,6,1883,1,60
1243,297,2,350,3,1886,1,30
1244,297,2,351,2,1888,1,20
1245,297,2,352,3,1891,1,30
1246,297,2,353,9,1900,1,90
1247,297,2,354,8,1908,24,80
1248,297,2,355,8,1916,1,80
1249,297,2,356,4,1920,1,40
1250,297,2,357,5,1925,1,50
1251,297,2,358,9,1934,1,90
1252,297,2,359,3,1937,1,30
1253,297,2,360,8,1945,1,80
1254,297,2,361,9,1954,1,90
1255,297,2,362,4,1958,1,40
1256,297,2,363,7,1965,22,70
1257,297,2,364,4,1969,1,40
1258,297,2,365,5,1974,1,50
1259,297,2,366,2,1976,1,20
1260,297,2,367,9,1985,16,90
1261,297,2,368,9,1994,1,90
1262,297,2,369,4,1998,1,40
1263,297,2,370,8,2006,1,80
1264,297,2,371,3,2009,1,30
1265,297,2,372,9,2018,15,90
1266,297,2,373,3,2021,9,30
1267,297,2,374,4,2025,1,40
1268,297,2,375,6,2031,1,60
1269,297,2,376,8,2039,1,80
1270,297,2,377,3,2042,2,30
1271,297,2,378,8,2050,5,80
1272,297,2,379,2,2052,1,20
1273,297,2,380,9,2061,1,90
1274,297,2,381,7,2068,1,70
1275,297,2,382,6,2074,1,60
1276,297,2,383,3,2077,13,30
1277,297,2,384,9,2086,4,90
1278,297,2,385,3,2089,1,30
1279,297,2,386,6,2095,4,60
1280,297,2,387,4,2099,1,40
1281,297,2,388,4,2103,1,40
1282,297,2,389,8,2111,1,80
1283,297,2,390,8,2119,1,80
1284,297,2,391,3,2122,1,30
1285,297,2,392,3,2125,1,30
1286,297,2,393,9,2134,1,90
1287,297,2,394,6,2140,1,60
1288,297,2,395,6,2146,14,60
1289,297,2,396,5,2151,1,50
1290,297,2,397,2,2153,7,20
1291,297,2,398,7,2160,1,70
1292,297,2,399,7,2167,1,70
1293,297,2,400,8,2175,1,80
1294,297,2,401,9,2184,1,90
1295,297,2,402,5,2189,1,50
1296,297,2,403,7,2196,1,70
1297,297,2,404,6,2202,1,60
1298,297,2,405,8,2210,11,80
1299,297,2,406,5,2215,1,50
1300,297,2,407,8,2223,1,80
1301,297,2,408,6,2229,1,60
1302,297,2,409,3,2232,12,30
1303,297,2,410,6,2238,1,60
1304,297,2,411,6,2244,1,60
1305,297,2,412,2,2246,4,20
1306,297,2,413,5,2251,8,50
1307,297,2,414,8,2259,1,80
1308,297,2,415,2,2261,1,20
1309,297,2,416,3,2264,1,30
1310,297,2,417,4,2268,1,40
1311,297,2,418,8,2276,1,80
1312,297,2,419,3,2279,1,30
1313,297,2,420,9,2288,1,90
1314,297,2,421,2,2290,1,20
1315,297,2,422,5,2295,1,50
1316,297,2,423,3,2298,1,30
1317,297,2,424,9,2307,15,90
1318,297,2,425,2,2309,1,20
1319,297,2,426,3,2312,1,30
1320,297,2,427,9,2321,1,90
1321,297,2,428,6,2327,2,60
1322,297,2,429,2,2329,1,20
1323,297,2,430,7,2336,1,70
1324,297,2,431,5,2341,1,50
1325,297,2,432,5,2346,1,50
1326,297,2,433,2,2348,4,20
1327,297,2,434,6,2354,1,60
1328,297,2,435,5,2359,1,50
1329,297,2,436,8,2367,4,80
1330,297,2,437,8,2375,1,80
1331,297,2,438,8,2383,1,80
1332,297,2,439,2,2385,1,20
1333,297,2,440,4,2389,1,40
1334,297,2,441,9,2398,1,90
1335,297,2,442,2,2400,1,20
1336,297,2,443,8,2408,1,80
1337,297,2,444,7,2415,1,70
1338,297,2,445,5,2420,1,50
1339,297,2,446,9,2429,1,90
1340,297,2,447,9,2438,1,90
1341,297,2,448,2,2440,1,20
1342,297,2,449,9,2449,22,90
1343,297,2,450,2,2451,1,20
1344,297,2,451,7,2458,1,70
1345,297,2,452,2,2460,1,20
1346,297,2,453,9,2469,1,90
1347,297,2,454,4,2473,1,40
1348,297,2,455,4,2477,1,40
1349,297,2,456,6,2483,1,60
1350,297,2,457,5,2488,11,50
1351,297,2,458,3,2491,11,30
1352,297,2,459,3,2494,5,30
1353,297,2,460,8,2502,0,80
1354,297,2,461,5,2507,1,50
1355,297,2,462,4,2511,1,40
1356,297,2,463,6,2517,1,60
1357,297,2,464,6,2523,1,60
1358,297,2,465,6,2529,1,60
1359,297,2,466,2,2531,1,20
1360,297,2,467,6,2537,1,60
1361,297,2,468,8,2545,1,80
1362,297,2,469,3,2548,1,30
1363,297,2,470,7,2555,1,70
1364,297,2,471,8,2563,1,80
1365,297,2,472,4,2567,1,40
1366,297,2,473,3,2570,1,30
1367,297,2,474,4,2574,12,40
1368,297,2,475,2,2576,6,20
1369,297,2,476,2,2578,1,20
1370,297,2,477,7,2585,3,70
1371,297,2,478,9,2594,1,90
1372,297,2,479,8,2602,1,80
1373,297,2,480,3,2605,1,30
1374,297,2,481,5,2610,9,50
1375,297,2,482,8,2618,1,80
1376,297,2,483,9,2627,7,90
1377,297,2,484,2,2629,1,20
1378,297,2,485,5,2634,1,50
1379,297,2,486,8,2642,1,80
1380,297,2,487,3,2645,6,30
1381,297,2,488,9,2654,1,90
1382,297,2,489,6,2660,1,60
1383,297,2,490,7,2667,1,70
1384,297,2,491,7,2674,1,70
1385,297,2,492,8,2682,1,80
1386,297,2,493,2,2684,1,20
1387,297,2,494,5,2689,1,50
1388,297,2,495,8,2697,1,80
1389,297,2,496,8,2705,1,80
1390,297,2,497,3,2708,1,30
1391,297,2,498,6,2714,1,60
1392,297,2,499,5,2719,1,50
1393,297,2,500,8,2727,1,80
1394,297,2,501,6,2733,1,60
1395,297,2,502,4,2737,1,40
1396,297,2,503,7,2744,23,70
1397,297,2,504,8,2752,1,80
1398,297,2,505,4,2756,1,40
1399,297,2,506,7,2763,1,70
1400,297,2,507,7,2770,1,70
1401,297,2,508,2,2772,1,20
1402,297,2,509,2,2774,13,20
1403,297,2,510,5,2779,8,50
1404,297,2,511,6,2785,2,60
1405,297,2,512,5,2790,1,50
1406,297,2,513,2,2792,1,20
1407,297,2,514,3,2795,3,30
1408,297,2,515,4,2799,1,40
1409,297,2,516,8,2807,1,80
1410,297,2,517,8,2815,1,80
1411,297,2,518,2,2817,1,20
1412,297,2,519,2,2819,1,20
1413,297,2,520,4,2823,1,40
1414,297,2,521,3,2826,8,30
1415,297,2,522,8,2834,3,80
1416,297,2,523,3,2837,1,30
1417,297,2,524,3,2840,3,30
1418,297,2,525,9,2849,1,90
1419,297,2,526,8,2857,1,80
1420,297,2,527,8,2865,13,80
1421,297,2,528,2,2867,1,20
1422,297,2,529,7,2874,1,70
1423,297,2,530,9,2883,1,90
1424,297,2,531,8,2891,1,80
1425,297,2,532,3,2894,7,30
1426,297,2,533,6,2900,1,60
1427,297,2,534,2,2902,1,20
1428,297,2,535,9,2911,1,90
1429,297,2,536,8,2919,1,80
1430,297,2,537,7,2926,1,70
1431,297,2,538,2,2928,1,20
1432,297,2,539,3,2931,1,30
1433,297,2,540,2,2933,1,20
1434,297,2,541,5,2938,1,50
1435,297,2,542,4,2942,1,40
1436,297,2,543,4,2946,1,40
1437,297,2,544,4,2950,1,40
1438,297,2,545,3,2953,12,30
1439,297,2,546,8,2961,1,80
1440,297,2,547,3,2964,12,30
1441,297,2,548,4,2968,1,40
1442,297,2,549,7,2975,1,70
1443,297,2,550,8,2983,1,80
1444,297,2,551,7,2990,14,70
1445,297,2,552,7,2997,1,70
1446,297,2,553,5,3002,1,50
1447,297,2,554,3,3005,1,30
1448,297,2,555,4,3009,7,40
1449,297,2,556,6,3015,14,60
1450,297,2,557,8,3023,10,80
1451,297,2,558,9,3032,5,90
1452,297,2,559,8,3040,1,80
1453,297,2,560,7,3047,1,70
1454,297,2,561,5,3052,4,50
1455,297,2,562,4,3056,1,40
1456,297,2,563,3,3059,1,30
1457,297,2,564,8,3067,1,80
1458,297,2,565,7,3074,6,70
1459,297,2,566,6,3080,1,60
1460,297,2,567,2,3082,1,20
1461,297,2,568,4,3086,1,40
1462,297,2,569,9,3095,1,90
1463,297,2,570,5,3100,1,50
1464,297,2,571,5,3105,9,50
1465,297,2,572,4,3109,1,40
1466,297,2,573,8,3117,1,80
1467,297,2,574,3,3120,6,30
1468,297,2,575,2,3122,1,20
1469,297,2,576,8,3130,7,80
1470,297,2,577,2,3132,1,20
1471,297,2,578,9,3141,1,90
1472,297,2,579,8,3149,1,80
1473,297,2,580,2,3151,1,20
1474,297,2,581,4,3155,1,40
1475,297,2,582,9,3164,1,90
1476,297,2,583,6,3170,1,60
1477,297,2,584,3,3173,1,30
1478,297,2,585,7,3180,1,70
1479,297,2,586,3,3183,1,30
1480,297,2,587,7,3190,1,70
1481,297,2,588,9,3199,1,90
1482,297,2,589,2,3201,1,20
1483,297,2,590,3,3204,1,30
1484,297,2,591,6,3210,1,60
1485,297,2,592,4,3214,1,40
1486,297,2,593,3,3217,26,30
1487,297,2,594,3,3220,1,30
1488,297,2,595,4,3224,7,40
1489,297,2,596,3,3227,1,30
1490,297,2,597,4,3231,1,40
1491,297,2,598,5,3236,1,50
1492,297,2,599,4,3240,1,40
1493,297,2,600,5,3245,1,50
1494,297,2,601,8,3253,8,80
1495,297,2,602,7,3260,6,70
1496,297,2,603,8,3268,1,80
1497,297,2,604,7,3275,7,70
1498,297,2,605,7,3282,1,70
1499,297,2,606,9,3291,1,90
1500,297,2,607,4,3295,4,40
1501,297,2,608,9,3304,1,90
1502,297,2,609,8,3312,1,80
1503,297,2,610,6,3318,1,60
1504,297,2,611,2,3320,1,20
1505,297,2,612,8,3328,1,80
1506,297,2,613,9,3337,1,90
1507,297,2,614,5,3342,1,50
1508,297,2,615,2,3344,1,20
1509,297,2,616,5,3349,1,50
1510,297,2,617,2,3351,1,20
1511,297,2,618,3,3354,14,30
1512,297,2,619,7,3361,1,70
1513,297,2,620,8,3369,1,80
1514,297,2,621,9,3378,1,90
1515,297,2,622,7,3385,1,70
1516,297,2,623,5,3390,1,50
1517,297,2,624,6,3396,1,60
1518,297,2,625,9,3405,21,90
1519,297,2,626,4,3409,1,40
1520,297,2,627,5,3414,1,50
1521,297,2,628,8,3422,10,80
1522,297,2,629,6,3428,1,60
1523,297,2,630,6,3434,1,60
1524,297,2,631,4,3438,1,40
1525,297,2,632,8,3446,1,80
1526,297,2,633,7,3453,1,70
1527,297,2,634,7,3460,1,70
1528,297,2,635,3,3463,1,30
1529,297,2,636,5,3468,1,50
1530,297,2,637,4,3472,1,40
1531,297,2,638,9,3481,1,90
1532,297,2,639,5,3486,1,50
1533,297,2,640,2,3488,1,20
1534,297,2,641,4,3492,1,40
1535,297,2,642,3,3495,1,30
1536,297,2,643,3,3498,1,30
1537,297,2,644,7,3505,1,70
1538,297,2,645,8,3513,1,80
1539,297,2,646,6,3519,1,60
1540,297,2,647,3,3522,1,30
1541,297,2,648,8,3530,1,80
1542,297,2,649,8,3538,1,80
1543,297,2,650,5,3543,1,50
1544,297,2,651,9,3552,1,90
1545,297,2,652,4,3556,1,40
1546,297,2,653,9,3565,1,90
1547,297,2,654,9,3574,1,90
1548,297,2,655,8,3582,1,80
1549,297,2,656,6,3588,1,60
1550,297,2,657,6,3594,1,60
1551,297,2,658,8,3602,1,80
1552,297,2,659,4,3606,1,40
1553,297,2,660,2,3608,1,20
1554,297,2,661,3,3611,1,30
1555,297,2,662,7,3618,1,70
1556,297,2,663,9,3627,1,90
1557,297,2,664,9,3636,31,90
1558,297,2,665,9,3645,1,90
1559,297,2,666,3,3648,1,30
1560,297,2,667,5,3653,1,50
1561,297,2,668,3,3656,1,30
1562,297,2,669,3,3659,1,30
1563,297,2,670,2,3661,1,20
1564,297,2,671,4,3665,1,40
1565,297,2,672,8,3673,1,80
1566,297,2,673,8,3681,1,80
1567,297,2,674,6,3687,1,60
1568,297,2,675,9,3696,1,90
1569,297,2,676,5,3701,1,50
1570,297,2,677,3,3704,1,30
1571,297,2,678,7,3711,1,70
1572,297,2,679,5,3716,38,50
1573,297,2,680,8,3724,1,80
1574,297,2,681,2,3726,1,20
1575,297,2,682,7,3733,15,70
1576,297,2,683,9,3742,1,90
1577,297,2,684,7,3749,1,70
1578,297,2,685,7,3756,1,70
1579,297,2,686,7,3763,17,70
1580,297,2,687,7,3770,1,70
1581,297,2,688,6,3776,1,60
1582,297,2,689,4,3780,1,40
1583,297,2,690,8,3788,1,80
1584,297,2,691,9,3797,1,90
1585,297,2,692,2,3799,1,20
1586,297,2,693,5,3804,1,50
1587,297,2,694,3,3807,1,30
1588,297,2,695,2,3809,1,20
1589,297,2,696,9,3818,1,90
1590,297,2,697,8,3826,1,80
1591,297,2,698,4,3830,1,40
1592,297,2,699,2,3832,1,20
1593,297,2,700,9,3841,1,90
1594,297,2,701,8,3849,1,80
1595,297,2,702,3,3852,23,30
1596,297,2,703,4,3856,1,40
1597,297,2,704,3,3859,1,30
1598,297,2,705,8,3867,1,80
1599,297,2,706,9,3876,1,90
1600,297,2,707,4,3880,1,40
1601,297,2,708,6,3886,1,60
1602,297,2,709,3,3889,13,30
1603,297,2,710,9,3898,1,90
1604,297,2,711,5,3903,1,50
1605,297,2,712,8,3911,1,80
1606,297,2,713,9,3920,1,90
1607,297,2,714,6,3926,15,60
1608,297,2,715,3,3929,1,30
1609,297,2,716,7,3936,1,70
1610,297,2,717,9,3945,1,90
1611,297,2,718,6,3951,1,60
1612,297,2,719,3,3954,1,30
1613,297,2,720,5,3959,1,50
1614,297,2,721,6,3965,1,60
1615,297,2,722,2,3967,1,20
1616,297,2,723,6,3973,13,60
1617,297,2,724,3,3976,1,30
1618,297,2,725,3,3979,1,30
1619,297,2,726,9,3988,1,90
1620,297,2,727,2,3990,1,20
1621,297,2,728,3,3993,12,30
1622,297,2,729,8,4001,6,80
1623,297,2,730,7,4008,1,70
1624,297,2,731,3,4011,1,30
1625,297,2,732,7,4018,5,70
1626,297,2,733,7,4025,1,70
1627,297,2,734,2,4027,1,20
1628,297,2,735,7,4034,6,70
1629,297,2,736,2,4036,2,20
1630,297,2,737,3,4039,1,30
1631,297,2,738,2,4041,1,20
1632,297,2,739,8,4049,1,80
1633,297,2,740,7,4056,1,70
1634,297,2,741,3,4059,1,30
1635,297,2,742,6,4065,1,60
1636,297,2,743,5,4070,7,50
1637,297,2,744,5,4075,5,50
1638,297,2,745,9,4084,1,90
1639,297,2,746,2,4086,1,20
1640,297,2,747,9,4095,1,90
1641,297,2,748,9,4104,1,90
1642,297,2,749,8,4112,1,80
1643,297,2,750,4,4116,1,40
1644,297,2,751,2,4118,1,20
1645,297,2,752,3,4121,1,30
1646,297,2,753,7,4128,1,70
1647,297,2,754,9,4137,1,90
1648,297,2,755,2,4139,1,20
1649,297,2,756,4,4143,19,40
1650,297,2,757,4,4147,1,40
1651,297,2,758,6,4153,1,60
1652,297,2,759,6,4159,1,60
1653,297,2,760,3,4162,1,30
1654,297,2,761,3,4165,1,30
1655,297,2,762,8,4173,1,80
1656,297,2,763,5,4178,1,50
1657,297,2,764,5,4183,1,50
1658,297,2,765,6,4189,1,60
1659,297,2,766,2,4191,18,20
1660,297,2,767,7,4198,1,70
1661,297,2,768,7,4205,1,70
1662,297,2,769,9,4214,1,90
1663,297,2,770,8,4222,1,80
1664,297,2,771,5,4227,1,50
1665,297,2,772,2,4229,1,20
1666,297,2,773,2,4231,1,20
1667,297,2,774,2,4233,15,20
1668,297,2,775,6,4239,1,60
1669,297,2,776,4,4243,1,40
1670,297,2,777,6,4249,1,60
1671,297,2,778,8,4257,14,80
1672,297,2,779,6,4263,8,60
1673,297,2,780,5,4268,1,50
1674,297,2,781,3,4271,1,30
1675,297,2,782,5,4276,1,50
1676,297,2,783,3,4279,1,30
1677,297,2,784,8,4287,1,80
1678,297,2,785,4,4291,1,40
1679,297,2,786,2,4293,1,20
1680,297,2,787,9,4302,1,90
1681,297,2,788,6,4308,1,60
1682,297,2,789,8,4316,1,80
1683,297,2,790,6,4322,19,60
1684,297,2,791,3,4325,1,30
1685,297,2,792,2,4327,1,20
1686,297,2,793,6,4333,1,60
1687,297,2,794,9,4342,1,90
1688,297,2,795,2,4344,1,20
1689,297,2,796,9,4353,1,90
1690,297,2,797,7,4360,1,70
1691,297,2,798,6,4366,17,60
1692,297,2,799,8,4374,1,80
1693,297,2,800,3,4377,1,30
1694,297,2,801,6,4383,1,60
1695,297,2,802,4,4387,1,40
1696,297,2,803,7,4394,1,70
1697,297,2,804,9,4403,1,90
1698,297,2,805,8,4411,1,80
1699,297,2,806,5,4416,1,50
1700,297,2,807,8,4424,28,80
1701,297,2,808,4,4428,1,40
1702,297,2,809,7,4435,1,70
1703,297,2,810,4,4439,1,40
1704,297,2,811,4,4443,12,40
1705,297,2,812,7,4450,1,70
1706,297,2,813,8,4458,9,80
1707,297,2,814,6,4464,1,60
1708,297,2,815,2,4466,1,20
1709,297,2,816,7,4473,5,70
1710,297,2,817,8,4481,1,80
1711,297,2,818,9,4490,13,90
1712,297,2,819,4,4494,1,40
1713,297,2,820,7,4501,7,70
1714,297,2,821,3,4504,1,30
1715,297,2,822,7,4511,1,70
1716,297,2,823,6,4517,1,60
1717,297,2,824,9,4526,1,90
1718,297,2,825,5,4531,1,50
1719,297,2,826,3,4534,1,30
1720,297,2,827,4,4538,1,40
1721,297,2,828,8,4546,1,80
1722,297,2,829,9,4555,1,90
1723,297,2,830,9,4564,1,90
1724,297,2,831,7,4571,20,70
1725,297,2,832,5,4576,1,50
1726,297,2,833,3,4579,1,30
1727,297,2,834,2,4581,1,20
1728,297,2,835,2,4583,1,20
1729,297,2,836,5,4588,1,50
1730,297,2,837,9,4597,1,90
1731,297,2,838,4,4601,1,40
1732,297,2,839,4,4605,1,40
1733,297,2,840,4,4609,1,40
1734,297,2,841,2,4611,1,20
1735,297,2,842,4,4615,1,40
1736,297,2,843,2,4617,1,20
1737,297,2,844,9,4626,1,90
1738,297,2,845,7,4633,1,70
1739,297,2,846,6,4639,19,60
1740,297,2,847,3,4642,1,30
1741,297,2,848,6,4648,1,60
1742,297,2,849,7,4655,8,70
1743,297,2,850,5,4660,1,50
1744,297,2,851,4,4664,1,40
1745,297,2,852,7,4671,1,70
1746,297,2,853,6,4677,4,60
1747,297,2,854,3,4680,1,30
1748,297,2,855,9,4689,1,90
1749,297,2,856,6,4695,1,60
1750,297,2,857,5,4700,1,50
1751,297,2,858,2,4702,1,20
1752,297,2,859,6,4708,12,60
1753,297,2,860,3,4711,1,30
1754,297,2,861,9,4720,1,90
1755,297,2,862,9,4729,6,90
1756,297,2,863,9,4738,1,90
1757,297,2,864,2,4740,3,20
1758,297,2,865,8,4748,1,80
1759,297,2,866,6,4754,1,60
1760,297,2,867,2,4756,1,20
1761,297,2,868,6,4762,1,60
1762,297,2,869,9,4771,1,90
1763,297,2,870,4,4775,1,40
1764,297,2,871,2,4777,1,20
1765,297,2,872,2,4779,1,20
1766,297,2,873,9,4788,1,90
1767,297,2,874,3,4791,1,30
1768,297,2,875,6,4797,1,60
1769,297,2,876,7,4804,1,70
1770,297,2,877,7,4811,1,70
1771,297,2,878,8,4819,22,80
1772,297,2,879,5,4824,1,50
1773,297,2,880,3,4827,1,30
1774,297,2,881,7,4834,1,70
1775,297,2,882,2,4836,1,20
1776,297,2,883,4,4840,1,40
1777,297,2,884,2,4842,1,20
1778,297,2,885,5,4847,16,50
1779,297,2,886,2,4849,1,20
1780,297,2,887,7,4856,1,70
1781,297,2,888,8,4864,1,80
1782,297,2,889,4,4868,1,40
1783,297,2,890,2,4870,1,20
1784,297,2,891,2,4872,1,20
1785,297,2,892,7,4879,1,70
1786,297,2,893,5,4884,11,50
1787,297,2,894,4,4888,1,40
1788,297,2,895,9,4897,1,90
1789,297,2,896,4,4901,1,40
1790,297,2,897,8,4909,1,80
1791,297,2,898,6,4915,14,60
1792,297,2,899,7,4922,1,70
1793,297,2,900,6,4928,1,60
1794,297,2,901,9,4937,1,90
1795,297,2,902,7,4944,1,70
1796,297,2,903,5,4949,1,50
1797,297,2,904,5,4954,7,50
1798,297,2,905,4,4958,1,40
1799,297,2,906,9,4967,1,90
1800,297,2,907,2,4969,1,20
1801,297,2,908,7,4976,1,70
1802,297,2,909,3,4979,1,30
1803,297,2,910,7,4986,1,70
1804,297,2,911,2,4988,12,20
1805,297,2,912,3,4991,1,30
1806,297,3,1,3,3,1,30
1807,297,3,2,3,6,1,30
1808,297,3,3,8,14,1,80
1809,297,3,4,3,17,1,30
1810,297,3,5,3,20,1,30
1811,297,3,6,4,24,6,40
1812,297,3,7,3,27,1,30
1813,297,3,8,3,30,1,30
1814,297,3,9,9,39,1,90
1815,297,3,10,4,43,1,40
1816,297,3,11,2,45,1,20
1817,297,3,12,9,54,1,90
1818,297,3,13,4,58,1,40
1819,297,3,14,9,67,1,90
1820,297,3,15,6,73,1,60
1821,297,3,16,7,80,1,70
1822,297,3,17,8,88,1,80
1823,297,3,18,8,96,1,80
1824,297,3,19,9,105,1,90
1825,297,3,20,7,112,17,70
1826,297,3,21,9,121,11,90
1827,297,3,22,6,127,1,60
1828,297,3,23,9,136,1,90
1829,297,3,24,2,138,1,20
1830,297,3,25,4,142,1,40
1831,297,3,26,6,148,1,60
1832,297,3,27,3,151,1,30
1833,297,3,28,8,159,1,80
1834,297,3,29,8,167,1,80
1835,297,3,30,9,176,26,90
1836,297,3,31,2,178,1,20
1837,297,3,32,7,185,1,70
1838,297,3,33,3,188,1,30
1839,297,3,34,6,194,1,60
1840,297,3,35,7,201,11,70
1841,297,3,36,9,210,1,90
1842,297,3,37,5,215,1,50
1843,297,3,38,5,220,9,50
1844,297,3,39,7,227,1,70
1845,297,3,40,8,235,6,80
1846,297,3,41,7,242,1,70
1847,297,3,42,6,248,1,60
1848,297,3,43,8,256,1,80
1849,297,3,44,6,262,9,60
1850,297,3,45,5,267,1,50
1851,297,3,46,2,269,1,20
1852,297,3,47,2,271,1,20
1853,297,3,48,2,273,4,20
1854,297,3,49,2,275,2,20
1855,297,3,50,8,283,1,80
1856,297,3,51,3,286,1,30
1857,297,3,52,6,292,1,60
1858,297,3,53,2,294,1,20
1859,297,3,54,4,298,1,40
1860,297,3,55,6,304,1,60
1861,297,3,56,7,311,1,70
1862,297,3,57,9,320,1,90
1863,297,3,58,6,326,1,60
1864,297,3,59,8,334,1,80
1865,297,3,60,4,338,1,40
1866,297,3,61,3,341,1,30
1867,297,3,62,5,346,1,50
1868,297,3,63,3,349,21,30
1869,297,3,64,6,355,1,60
1870,297,3,65,4,359,1,40
1871,297,3,66,6,365,1,60
1872,297,3,67,6,371,1,60
1873,297,3,68,2,373,1,20
1874,297,3,69,5,378,1,50
1875,297,3,70,3,381,12,30
1876,297,3,71,7,388,1,70
1877,297,3,72,5,393,1,50
1878,297,3,73,6,399,1,60
1879,297,3,74,7,406,1,70
1880,297,3,75,7,413,7,70
1881,297,3,76,6,419,6,60
1882,297,3,77,6,425,1,60
1883,297,3,78,4,429,5,40
1884,297,3,79,9,438,1,90
1885,297,3,80,4,442,1,40
1886,297,3,81,2,444,1,20
1887,297,3,82,3,447,1,30
1888,297,3,83,3,450,1,30
1889,297,3,84,5,455,8,50
1890,297,3,85,9,464,1,90
1891,297,3,86,6,470,3,60
1892,297,3,87,7,477,1,70
1893,297,3,88,5,482,5,50
1894,297,3,89,7,489,3,70
1895,297,3,90,4,493,1,40
1896,297,3,91,5,498,1,50
1897,297,3,92,8,506,8,80
1898,297,3,93,5,511,1,50
1899,297,3,94,9,520,7,90
1900,297,3,95,2,522,1,20
1901,297,3,96,3,525,1,30
1902,297,3,97,2,527,1,20
1903,297,3,98,5,532,3,50
1904,297,3,99,6,538,1,60
1905,297,3,100,7,545,1,70
1906,297,3,101,7,552,1,70
1907,297,3,102,5,557,1,50
1908,297,3,103,2,559,1,20
1909,297,3,104,3,562,7,30
1910,297,3,105,3,565,1,30
1911,297,3,106,5,570,1,50
1912,297,3,107,7,577,5,70
1913,297,3,108,4,581,1,40
1914,297,3,109,2,583,3,20
1915,297,3,110,6,589,1,60
1916,297,3,111,5,594,5,50
1917,297,3,112,2,596,1,20
1918,297,3,113,5,601,1,50
1919,297,3,114,4,605,1,40
1920,297,3,115,3,608,1,30
1921,297,3,116,7,615,1,70
1922,297,3,117,3,618,1,30
1923,297,3,118,2,620,9,20
1924,297,3,119,5,625,1,50
1925,297,3,120,7,632,1,70
1926,297,3,121,9,641,1,90
1927,297,3,122,2,643,1,20
1928,297,3,123,8,651,1,80
1929,297,3,124,8,659,13,80
1930,297,3,125,2,661,1,20
1931,297,3,126,4,665,1,40
1932,297,3,127,2,667,2,20
1933,297,3,128,9,676,1,90
1934,297,3,129,6,682,1,60
1935,297,3,130,6,688,9,60
1936,297,3,131,9,697,1,90
1937,297,3,132,4,701,1,40
1938,297,3,133,2,703,1,20
1939,297,3,134,2,705,1,20
1940,297,3,135,2,707,7,20
1941,297,3,136,6,713,1,60
1942,297,3,137,2,715,1,20
1943,297,3,138,4,719,5,40
1944,297,3,139,4,723,1,40
1945,297,3,140,4,727,1,40
1946,297,3,141,4,731,10,40
1947,297,3,142,3,734,1,30
1948,297,3,143,2,736,1,20
1949,297,3,144,6,742,1,60
1950,297,3,145,5,747,5,50
1951,297,3,146,6,753,1,60
1952,297,3,147,5,758,1,50
1953,297,3,148,6,764,5,60
1954,297,3,149,7,771,1,70
1955,297,3,150,8,779,1,80
1956,297,3,151,6,785,1,60
1957,297,3,152,3,788,1,30
1958,297,3,153,4,792,1,40
1959,297,3,154,4,796,1,40
1960,297,3,155,3,799,1,30
1961,297,3,156,2,801,1,20
1962,297,3,157,2,803,10,20
1963,297,3,158,3,806,1,30
1964,297,3,159,9,815,1,90
1965,297,3,160,4,819,4,40
1966,297,3,161,6,825,1,60
1967,297,3,162,4,829,1,40
1968,297,3,163,6,835,2,60
1969,297,3,164,8,843,1,80
1970,297,3,165,7,850,1,70
1971,297,3,166,7,857,1,70
1972,297,3,167,4,861,1,40
1973,297,3,168,2,863,1,20
1974,297,3,169,7,870,1,70
1975,297,3,170,8,878,1,80
1976,297,3,171,4,882,1,40
1977,297,3,172,5,887,1,50
1978,297,3,173,3,890,1,30
1979,297,3,174,9,899,1,90
1980,297,3,175,6,905,1,60
1981,297,3,176,7,912,1,70
1982,297,3,177,7,919,1,70
1983,297,3,178,7,926,24,70
1984,297,3,179,9,935,1,90
1985,297,3,180,8,943,1,80
1986,297,3,181,6,949,14,60
1987,297,3,182,9,958,1,90
1988,297,3,183,8,966,1,80
1989,297,3,184,7,973,1,70
1990,297,3,185,7,980,1,70
1991,297,3,186,8,988,1,80
1992,297,3,187,8,996,1,80
1993,297,3,188,5,1001,1,50
1994,297,3,189,4,1005,18,40
1995,297,3,190,3,1008,1,30
1996,297,3,191,6,1014,1,60
1997,297,3,192,5,1019,1,50
1998,297,3,193,4,1023,1,40
1999,297,3,194,6,1029,19,60
2000,297,3,195,7,1036,10,70
2001,297,3,196,9,1045,1,90
2002,297,3,197,6,1051,1,60
2003,297,3,198,9,1060,1,90
2004,297,3,199,7,1067,5,70
2005,297,3,200,3,1070,1,30
2006,297,3,201,7,1077,6,70
2007,297,3,202,4,1081,1,40
2008,297,3,203,4,1085,1,40
2009,297,3,204,9,1094,1,90
2010,297,3,205,4,1098,1,40
2011,297,3,206,3,1101,1,30
2012,297,3,207,6,1107,1,60
2013,297,3,208,5,1112,1,50
2014,297,3,209,6,1118,1,60
2015,297,3,210,2,1120,6,20
2016,297,3,211,7,1127,1,70
2017,297,3,212,2,1129,1,20
2018,297,3,213,9,1138,1,90
2019,297,3,214,5,1143,1,50
2020,297,3,215,7,1150,1,70
2021,297,3,216,3,1153,1,30
2022,297,3,217,3,1156,1,30
2023,297,3,218,9,1165,1,90
2024,297,3,219,7,1172,1,70
2025,297,3,220,8,1180,1,80
2026,297,3,221,3,1183,1,30
2027,297,3,222,4,1187,1,40
2028,297,3,223,9,1196,15,90
2029,297,3,224,7,1203,1,70
2030,297,3,225,8,1211,1,80
2031,297,3,226,4,1215,10,40
2032,297,3,227,9,1224,1,90
2033,297,3,228,6,1230,6,60
2034,297,3,229,7,1237,1,70
2035,297,3,230,3,1240,6,30
2036,297,3,231,4,1244,4,40
2037,297,3,232,7,1251,1,70
2038,297,3,233,5,1256,1,50
2039,297,3,234,6,1262,4,60
2040,297,3,235,5,1267,1,50
2041,297,3,236,6,1273,1,60
2042,297,3,237,5,1278,5,50
2043,297,3,238,9,1287,1,90
2044,297,3,239,7,1294,1,70
2045,297,3,240,2,1296,1,20
2046,297,3,241,4,1300,1,40
2047,297,3,242,3,1303,1,30
2048,297,3,243,3,1306,1,30
2049,297,3,244,4,1310,1,40
2050,297,3,245,9,1319,1,90
2051,297,3,246,9,1328,1,90
2052,297,3,247,5,1333,1,50
2053,297,3,248,2,1335,1,20
2054,297,3,249,2,1337,1,20
2055,297,3,250,3,1340,8,30
2056,297,3,251,6,1346,1,60
2057,297,3,252,8,1354,1,80
2058,297,3,253,2,1356,1,20
2059,297,3,254,8,1364,1,80
2060,297,3,255,6,1370,11,60
2061,297,3,256,9,1379,1,90
2062,297,3,257,4,1383,1,40
2063,297,3,258,5,1388,1,50
2064,297,3,259,9,1397,1,90
2065,297,3,260,4,1401,1,40
2066,297,3,261,5,1406,1,50
2067,297,3,262,7,1413,1,70
2068,297,3,263,9,1422,1,90
2069,297,3,264,2,1424,1,20
2070,297,3,265,4,1428,1,40
2071,297,3,266,8,1436,23,80
2072,297,3,267,8,1444,1,80
2073,297,3,268,5,1449,13,50
2074,297,3,269,7,1456,9,70
2075,297,3,270,6,1462,1,60
2076,297,3,271,2,1464,7,20
2077,297,3,272,5,1469,1,50
2078,297,3,273,7,1476,1,70
2079,297,3,274,2,1478,1,20
2080,297,3,275,6,1484,1,60
2081,297,3,276,5,1489,1,50
2082,297,3,277,3,1492,1,30
2083,297,3,278,3,1495,1,30
2084,297,3,279,6,1501,1,60
2085,297,3,280,8,1509,1,80
2086,297,3,281,7,1516,1,70
2087,297,3,282,8,1524,1,80
2088,297,3,283,2,1526,15,20
2089,297,3,284,9,1535,1,90
2090,297,3,285,7,1542,1,70
2091,297,3,286,5,1547,1,50
2092,297,3,287,7,1554,1,70
2093,297,3,288,3,1557,15,30
2094,297,3,289,8,1565,1,80
2095,297,3,290,9,1574,1,90
2096,297,3,291,9,1583,1,90
2097,297,3,292,8,1591,1,80
2098,297,3,293,5,1596,1,50
2099,297,3,294,5,1601,1,50
2100,297,3,295,3,1604,1,30
2101,297,3,296,7,1611,1,70
2102,297,3,297,8,1619,12,80
2103,297,3,298,9,1628,1,90
2104,297,3,299,6,1634,1,60
2105,297,3,300,9,1643,1,90
2106,297,3,301,5,1648,1,50
2107,297,3,302,7,1655,1,70
2108,297,3,303,5,1660,1,50
2109,297,3,304,5,1665,1,50
2110,297,3,305,3,1668,1,30
2111,297,3,306,9,1677,1,90
2112,297,3,307,6,1683,1,60
2113,297,3,308,3,1686,1,30
2114,297,3,309,4,1690,1,40
2115,297,3,310,2,1692,1,20
2116,297,3,311,8,1700,23,80
2117,297,3,312,2,1702,11,20
2118,297,3,313,7,1709,1,70
2119,297,3,314,5,1714,1,50
2120,297,3,315,5,1719,1,50
2121,297,3,316,6,1725,1,60
2122,297,3,317,2,1727,1,20
2123,297,3,318,3,1730,1,30
2124,297,3,319,4,1734,1,40
2125,297,3,320,3,1737,1,30
2126,297,3,321,5,1742,1,50
2127,297,3,322,9,1751,1,90
2128,297,3,323,6,1757,1,60
2129,297,3,324,9,1766,1,90
2130,297,3,325,9,1775,1,90
2131,297,3,326,5,1780,1,50
2132,297,3,327,4,1784,1,40
2133,297,3,328,3,1787,1,30
2134,297,3,329,2,1789,18,20
2135,297,3,330,4,1793,12,40
2136,297,3,331,8,1801,1,80
2137,297,3,332,3,1804,11,30
2138,297,3,333,7,1811,3,70
2139,297,3,334,9,1820,4,90
2140,297,3,335,3,1823,1,30
2141,297,3,336,7,1830,1,70
2142,297,3,337,5,1835,1,50
2143,297,3,338,3,1838,1,30
2144,297,3,339,8,1846,1,80
2145,297,3,340,7,1853,1,70
2146,297,3,341,9,1862,1,90
2147,297,3,342,8,1870,1,80
2148,297,3,343,5,1875,11,50
2149,297,3,344,8,1883,1,80
2150,297,3,345,3,1886,1,30
2151,297,3,346,3,1889,1,30
2152,297,3,347,5,1894,1,50
2153,297,3,348,8,1902,5,80
2154,297,3,349,7,1909,1,70
2155,297,3,350,9,1918,1,90
2156,297,3,351,2,1920,1,20
2157,297,3,352,4,1924,1,40
2158,297,3,353,3,1927,1,30
2159,297,3,354,7,1934,1,70
2160,297,3,355,4,1938,1,40
2161,297,3,356,6,1944,1,60
2162,297,3,357,9,1953,1,90
2163,297,3,358,4,1957,15,40
2164,297,3,359,3,1960,1,30
2165,297,3,360,7,1967,1,70
2166,297,3,361,6,1973,16,60
2167,297,3,362,3,1976,1,30
2168,297,3,363,6,1982,1,60
2169,297,3,364,7,1989,1,70
2170,297,3,365,7,1996,1,70
2171,297,3,366,3,1999,1,30
2172,297,3,367,3,2002,1,30
2173,297,3,368,3,2005,1,30
2174,297,3,369,9,2014,1,90
2175,297,3,370,2,2016,1,20
2176,297,3,371,6,2022,1,60
2177,297,3,372,4,2026,1,40
2178,297,3,373,4,2030,1,40
2179,297,3,374,2,2032,1,20
2180,297,3,375,7,2039,1,70
2181,297,3,376,4,2043,1,40
2182,297,3,377,8,2051,1,80
2183,297,3,378,5,2056,10,50
2184,297,3,379,6,2062,1,60
2185,297,3,380,9,2071,9,90
2186,297,3,381,4,2075,1,40
2187,297,3,382,3,2078,10,30
2188,297,3,383,4,2082,1,40
2189,297,3,384,9,2091,1,90
2190,297,3,385,9,2100,1,90
2191,297,3,386,3,2103,1,30
2192,297,3,387,5,2108,1,50
2193,297,3,388,9,2117,1,90
2194,297,3,389,2,2119,1,20
2195,297,3,390,8,2127,1,80
2196,297,3,391,8,2135,1,80
2197,297,3,392,3,2138,1,30
2198,297,3,393,7,2145,1,70
2199,297,3,394,8,2153,1,80
2200,297,3,395,2,2155,25,20
2201,297,3,396,4,2159,1,40
2202,297,3,397,4,2163,1,40
2203,297,3,398,3,2166,1,30
2204,297,3,399,2,2168,9,20
2205,297,3,400,5,2173,6,50
2206,297,3,401,2,2175,4,20
2207,297,3,402,7,2182,1,70
2208,297,3,403,8,2190,1,80
2209,297,3,404,2,2192,1,20
2210,297,3,405,4,2196,1,40
2211,297,3,406,7,2203,1,70
2212,297,3,407,8,2211,1,80
2213,297,3,408,8,2219,1,80
2214,297,3,409,8,2227,1,80
2215,297,3,410,7,2234,1,70
2216,297,3,411,6,2240,1,60
2217,297,3,412,7,2247,19,70
2218,297,3,413,2,2249,1,20
2219,297,3,414,8,2257,1,80
2220,297,3,415,2,2259,1,20
2221,297,3,416,4,2263,1,40
2222,297,3,417,3,2266,1,30
2223,297,3,418,6,2272,1,60
2224,297,3,419,2,2274,16,20
2225,297,3,420,2,2276,1,20
2226,297,3,421,6,2282,1,60
2227,297,3,422,2,2284,1,20
2228,297,3,423,7,2291,1,70
2229,297,3,424,5,2296,1,50
2230,297,3,425,7,2303,1,70
2231,297,3,426,3,2306,1,30
2232,297,3,427,3,2309,6,30
2233,297,3,428,2,2311,1,20
2234,297,3,429,5,2316,3,50
2235,297,3,430,5,2321,1,50
2236,297,3,431,9,2330,1,90
2237,297,3,432,9,2339,1,90
2238,297,3,433,9,2348,2,90
2239,297,3,434,6,2354,1,60
2240,297,3,435,9,2363,1,90
2241,297,3,436,7,2370,1,70
2242,297,3,437,8,2378,1,80
2243,297,3,438,5,2383,11,50
2244,297,3,439,7,2390,1,70
2245,297,3,440,4,2394,1,40
2246,297,3,441,4,2398,1,40
2247,297,3,442,8,2406,1,80
2248,297,3,443,5,2411,1,50
2249,297,3,444,9,2420,9,90
2250,297,3,445,6,2426,1,60
2251,297,3,446,4,2430,1,40
2252,297,3,447,4,2434,1,40
2253,297,3,448,6,2440,1,60
2254,297,3,449,8,2448,1,80
2255,297,3,450,4,2452,1,40
2256,297,3,451,4,2456,1,40
2257,297,3,452,9,2465,11,90
2258,297,3,453,2,2467,1,20
2259,297,3,454,3,2470,1,30
2260,297,3,455,7,2477,11,70
2261,297,3,456,3,2480,1,30
2262,297,3,457,5,2485,1,50
2263,297,3,458,9,2494,1,90
2264,297,3,459,3,2497,12,30
2265,297,3,460,7,2504,1,70
2266,297,3,461,5,2509,1,50
2267,297,3,462,2,2511,10,20
2268,297,3,463,8,2519,1,80
2269,297,3,464,3,2522,1,30
2270,297,3,465,7,2529,1,70
2271,297,3,466,6,2535,1,60
2272,297,3,467,9,2544,15,90
2273,297,3,468,4,2548,1,40
2274,297,3,469,5,2553,1,50
2275,297,3,470,8,2561,1,80
2276,297,3,471,8,2569,1,80
2277,297,3,472,7,2576,1,70
2278,297,3,473,9,2585,1,90
2279,297,3,474,7,2592,10,70
2280,297,3,475,6,2598,1,60
2281,297,3,476,9,2607,1,90
2282,297,3,477,8,2615,1,80
2283,297,3,478,5,2620,1,50
2284,297,3,479,7,2627,9,70
2285,297,3,480,6,2633,1,60
2286,297,3,481,5,2638,1,50
2287,297,3,482,4,2642,1,40
2288,297,3,483,7,2649,1,70
2289,297,3,484,9,2658,19,90
2290,297,3,485,2,2660,1,20
2291,297,3,486,2,2662,6,20
2292,297,3,487,6,2668,1,60
2293,297,3,488,9,2677,1,90
2294,297,3,489,9,2686,1,90
2295,297,3,490,4,2690,1,40
2296,297,3,491,6,2696,1,60
2297,297,3,492,5,2701,1,50
2298,297,3,493,6,2707,1,60
2299,297,3,494,9,2716,1,90
2300,297,3,495,9,2725,1,90
2301,297,3,496,7,2732,1,70
2302,297,3,497,9,2741,1,90
2303,297,3,498,5,2746,1,50
2304,297,3,499,8,2754,19,80
2305,297,3,500,9,2763,1,90
2306,297,3,501,6,2769,11,60
2307,297,3,502,6,2775,1,60
2308,297,3,503,5,2780,1,50
2309,297,3,504,8,2788,1,80
2310,297,3,505,5,2793,1,50
2311,297,3,506,4,2797,1,40
2312,297,3,507,9,2806,9,90
2313,297,3,508,4,2810,5,40
2314,297,3,509,3,2813,1,30
2315,297,3,510,4,2817,1,40
2316,297,3,511,8,2825,1,80
2317,297,3,512,5,2830,3,50
2318,297,3,513,7,2837,1,70
2319,297,3,514,7,2844,1,70
2320,297,3,515,4,2848,1,40
2321,297,3,516,3,2851,1,30
2322,297,3,517,2,2853,1,20
2323,297,3,518,2,2855,1,20
2324,297,3,519,3,2858,1,30
2325,297,3,520,5,2863,1,50
2326,297,3,521,2,2865,1,20
2327,297,3,522,2,2867,5,20
2328,297,3,523,6,2873,7,60
2329,297,3,524,4,2877,1,40
2330,297,3,525,6,2883,1,60
2331,297,3,526,8,2891,1,80
2332,297,3,527,8,2899,1,80
2333,297,3,528,4,2903,1,40
2334,297,3,529,2,2905,1,20
2335,297,3,530,4,2909,1,40
2336,297,3,531,3,2912,1,30
2337,297,3,532,9,2921,1,90
2338,297,3,533,3,2924,1,30
2339,297,3,534,2,2926,1,20
2340,297,3,535,9,2935,13,90
2341,297,3,536,6,2941,1,60
2342,297,3,537,5,2946,1,50
2343,297,3,538,9,2955,1,90
2344,297,3,539,8,2963,1,80
2345,297,3,540,6,2969,12,60
2346,297,3,541,4,2973,8,40
2347,297,3,542,8,2981,1,80
2348,297,3,543,5,2986,6,50
2349,297,3,544,7,2993,1,70
2350,297,3,545,7,3000,1,70
2351,297,3,546,7,3007,1,70
2352,297,3,547,2,3009,1,20
2353,297,3,548,6,3015,1,60
2354,297,3,549,7,3022,1,70
2355,297,3,550,4,3026,1,40
2356,297,3,551,3,3029,16,30
2357,297,3,552,6,3035,1,60
2358,297,3,553,4,3039,8,40
2359,297,3,554,5,3044,1,50
2360,297,3,555,5,3049,1,50
2361,297,3,556,8,3057,9,80
2362,297,3,557,2,3059,1,20
2363,297,3,558,9,3068,1,90
2364,297,3,559,6,3074,1,60
2365,297,3,560,4,3078,1,40
2366,297,3,561,5,3083,1,50
2367,297,3,562,4,3087,1,40
2368,297,3,563,4,3091,7,40
2369,297,3,564,4,3095,1,40
2370,297,3,565,3,3098,1,30
2371,297,3,566,4,3102,1,40
2372,297,3,567,4,3106,1,40
2373,297,3,568,8,3114,1,80
2374,297,3,569,4,3118,1,40
2375,297,3,570,4,3122,1,40
2376,297,3,571,6,3128,1,60
2377,297,3,572,7,3135,1,70
2378,297,3,573,4,3139,7,40
2379,297,3,574,2,3141,1,20
2380,297,3,575,3,3144,1,30
2381,297,3,576,6,3150,1,60
2382,297,3,577,2,3152,1,20
2383,297,3,578,2,3154,1,20
2384,297,3,579,3,3157,1,30
2385,297,3,580,6,3163,1,60
2386,297,3,581,5,3168,1,50
2387,297,3,582,5,3173,1,50
2388,297,3,583,4,3177,12,40
2389,297,3,584,9,3186,5,90
2390,297,3,585,4,3190,1,40
2391,297,3,586,4,3194,1,40
2392,297,3,587,5,3199,1,50
2393,297,3,588,4,3203,1,40
2394,297,3,589,9,3212,1,90
2395,297,3,590,3,3215,1,30
2396,297,3,591,6,3221,1,60
2397,297,3,592,8,3229,1,80
2398,297,3,593,7,3236,1,70
2399,297,3,594,5,3241,1,50
2400,297,3,595,5,3246,1,50
2401,297,3,596,9,3255,1,90
2402,297,3,597,4,3259,1,40
2403,297,3,598,9,3268,1,90
2404,297,3,599,5,3273,15,50
2405,297,3,600,6,3279,1,60
2406,297,3,601,8,3287,1,80
2407,297,3,602,6,3293,1,60
2408,297,3,603,8,3301,1,80
2409,297,3,604,5,3306,1,50
2410,297,3,605,9,3315,19,90
2411,297,3,606,3,3318,1,30
2412,297,3,607,5,3323,1,50
2413,297,3,608,7,3330,1,70
2414,297,3,609,4,3334,1,40
2415,297,3,610,9,3343,1,90
2416,297,3,611,9,3352,1,90
2417,297,3,612,8,3360,17,80
2418,297,3,613,7,3367,5,70
2419,297,3,614,8,3375,1,80
2420,297,3,615,3,3378,8,30
2421,297,3,616,6,3384,1,60
2422,297,3,617,8,3392,4,80
2423,297,3,618,7,3399,1,70
2424,297,3,619,9,3408,1,90
2425,297,3,620,9,3417,6,90
2426,297,3,621,7,3424,1,70
2427,297,3,622,8,3432,1,80
2428,297,3,623,2,3434,7,20
2429,297,3,624,5,3439,1,50
2430,297,3,625,9,3448,1,90
2431,297,3,626,6,3454,1,60
2432,297,3,627,8,3462,7,80
2433,297,3,628,5,3467,7,50
2434,297,3,629,3,3470,1,30
2435,297,3,630,7,3477,4,70
2436,297,3,631,5,3482,1,50
2437,297,3,632,2,3484,1,20
2438,297,3,633,5,3489,1,50
2439,297,3,634,8,3497,6,80
2440,297,3,635,3,3500,5,30
2441,297,3,636,8,3508,3,80
2442,297,3,637,9,3517,6,90
2443,297,3,638,3,3520,1,30
2444,297,3,639,4,3524,3,40
2445,297,3,640,3,3527,1,30
2446,297,3,641,4,3531,2,40
2447,297,3,642,5,3536,0,50
2448,297,3,643,5,3541,2,50
2449,297,3,644,9,3550,1,90
2450,297,3,645,7,3557,1,70
2451,297,3,646,8,3565,1,80
2452,297,3,647,6,3571,1,60
2453,297,3,648,7,3578,1,70
2454,297,3,649,8,3586,1,80
2455,297,3,650,9,3595,1,90
2456,297,3,651,6,3601,1,60
2457,297,3,652,6,3607,1,60
2458,297,3,653,2,3609,21,20
2459,297,3,654,2,3611,1,20
2460,297,3,655,2,3613,1,20
2461,297,3,656,5,3618,1,50
2462,297,3,657,4,3622,1,40
2463,297,3,658,9,3631,1,90
2464,297,3,659,7,3638,21,70
2465,297,3,660,6,3644,1,60
2466,297,3,661,7,3651,1,70
2467,297,3,662,6,3657,1,60
2468,297,3,663,2,3659,1,20
2469,297,3,664,9,3668,14,90
2470,297,3,665,4,3672,1,40
2471,297,3,666,6,3678,1,60
2472,297,3,667,5,3683,1,50
2473,297,3,668,3,3686,1,30
2474,297,3,669,8,3694,13,80
2475,297,3,670,2,3696,1,20
2476,297,3,671,5,3701,1,50
2477,297,3,672,3,3704,1,30
2478,297,3,673,6,3710,3,60
2479,297,3,674,8,3718,1,80
2480,297,3,675,7,3725,1,70
2481,297,3,676,5,3730,1,50
2482,297,3,677,2,3732,1,20
2483,297,3,678,5,3737,1,50
2484,297,3,679,8,3745,1,80
2485,297,3,680,4,3749,1,40
2486,297,3,681,2,3751,1,20
2487,297,3,682,6,3757,1,60
2488,297,3,683,5,3762,1,50
2489,297,3,684,8,3770,1,80
2490,297,3,685,9,3779,17,90
2491,297,3,686,7,3786,8,70
2492,297,3,687,6,3792,1,60
2493,297,3,688,6,3798,1,60
2494,297,3,689,3,3801,1,30
2495,297,3,690,7,3808,1,70
2496,297,3,691,6,3814,1,60
2497,297,3,692,8,3822,1,80
2498,297,3,693,3,3825,1,30
2499,297,3,694,3,3828,1,30
2500,297,3,695,8,3836,1,80
2501,297,3,696,4,3840,1,40
2502,297,3,697,9,3849,14,90
2503,297,3,698,4,3853,1,40
2504,297,3,699,6,3859,7,60
2505,297,3,700,8,3867,8,80
2506,297,3,701,2,3869,1,20
2507,297,3,702,7,3876,1,70
2508,297,3,703,3,3879,3,30
2509,297,3,704,5,3884,2,50
2510,297,3,705,8,3892,1,80
2511,297,3,706,7,3899,1,70
2512,297,3,707,7,3906,1,70
2513,297,3,708,4,3910,1,40
2514,297,3,709,3,3913,1,30
2515,297,3,710,8,3921,1,80
2516,297,3,711,7,3928,1,70
2517,297,3,712,8,3936,1,80
2518,297,3,713,7,3943,15,70
2519,297,3,714,5,3948,1,50
2520,297,3,715,8,3956,1,80
2521,297,3,716,3,3959,1,30
2522,297,3,717,3,3962,7,30
2523,297,3,718,4,3966,1,40
2524,297,3,719,2,3968,1,20
2525,297,3,720,4,3972,1,40
2526,297,3,721,5,3977,1,50
2527,297,3,722,7,3984,11,70
2528,297,3,723,4,3988,2,40
2529,297,3,724,3,3991,1,30
2530,297,3,725,6,3997,1,60
2531,297,3,726,5,4002,1,50
2532,297,3,727,5,4007,1,50
2533,297,3,728,4,4011,1,40
2534,297,3,729,3,4014,1,30
2535,297,3,730,8,4022,7,80
2536,297,3,731,6,4028,1,60
2537,297,3,732,4,4032,1,40
2538,297,3,733,5,4037,1,50
2539,297,3,734,2,4039,1,20
2540,297,3,735,2,4041,1,20
2541,297,3,736,4,4045,9,40
2542,297,3,737,8,4053,1,80
2543,297,3,738,3,4056,6,30
2544,297,3,739,7,4063,3,70
2545,297,3,740,3,4066,1,30
2546,297,3,741,2,4068,1,20
2547,297,3,742,8,4076,1,80
2548,297,3,743,2,4078,1,20
2549,297,3,744,9,4087,1,90
2550,297,3,745,7,4094,9,70
2551,297,3,746,4,4098,1,40
2552,297,3,747,6,4104,1,60
2553,297,3,748,9,4113,1,90
2554,297,3,749,4,4117,1,40
2555,297,3,750,6,4123,1,60
2556,297,3,751,5,4128,9,50
2557,297,3,752,5,4133,1,50
2558,297,3,753,4,4137,1,40
2559,297,3,754,7,4144,9,70
2560,297,3,755,5,4149,4,50
2561,297,3,756,3,4152,1,30
2562,297,3,757,7,4159,1,70
2563,297,3,758,7,4166,1,70
2564,297,3,759,5,4171,1,50
2565,297,3,760,9,4180,1,90
2566,297,3,761,5,4185,1,50
2567,297,3,762,7,4192,1,70
2568,297,3,763,6,4198,1,60
2569,297,3,764,3,4201,11,30
2570,297,3,765,3,4204,1,30
2571,297,3,766,3,4207,5,30
2572,297,3,767,2,4209,5,20
2573,297,3,768,5,4214,1,50
2574,297,3,769,2,4216,1,20
2575,297,3,770,7,4223,1,70
2576,297,3,771,5,4228,1,50
2577,297,3,772,7,4235,1,70
2578,297,3,773,8,4243,1,80
2579,297,3,774,5,4248,1,50
2580,297,3,775,7,4255,1,70
2581,297,3,776,2,4257,1,20
2582,297,3,777,3,4260,1,30
2583,297,3,778,9,4269,1,90
2584,297,3,779,3,4272,1,30
2585,297,3,780,8,4280,1,80
2586,297,3,781,8,4288,1,80
2587,297,3,782,8,4296,20,80
2588,297,3,783,9,4305,10,90
2589,297,3,784,3,4308,6,30
2590,297,3,785,6,4314,3,60
2591,297,3,786,8,4322,1,80
2592,297,3,787,7,4329,1,70
2593,297,3,788,7,4336,1,70
2594,297,3,789,8,4344,1,80
2595,297,3,790,8,4352,1,80
2596,297,3,791,5,4357,1,50
2597,297,3,792,9,4366,1,90
2598,297,3,793,4,4370,15,40
2599,297,3,794,6,4376,1,60
2600,297,3,795,8,4384,1,80
2601,297,3,796,2,4386,8,20
2602,297,3,797,3,4389,1,30
2603,297,3,798,7,4396,1,70
2604,297,3,799,8,4404,1,80
2605,297,3,800,4,4408,1,40
2606,297,3,801,6,4414,1,60
2607,297,3,802,3,4417,1,30
2608,297,3,803,8,4425,13,80
2609,297,3,804,9,4434,1,90
2610,297,3,805,7,4441,1,70
2611,297,3,806,3,4444,1,30
2612,297,3,807,5,4449,1,50
2613,297,3,808,6,4455,16,60
2614,297,3,809,3,4458,2,30
2615,297,3,810,7,4465,1,70
2616,297,3,811,3,4468,1,30
2617,297,3,812,8,4476,4,80
2618,297,3,813,7,4483,1,70
2619,297,3,814,3,4486,1,30
2620,297,3,815,6,4492,5,60
2621,297,3,816,3,4495,1,30
2622,297,3,817,6,4501,1,60
2623,297,3,818,5,4506,1,50
2624,297,3,819,2,4508,1,20
2625,297,3,820,6,4514,4,60
2626,297,3,821,7,4521,2,70
2627,297,3,822,7,4528,1,70
2628,297,3,823,2,4530,1,20
2629,297,3,824,4,4534,1,40
2630,297,3,825,9,4543,1,90
2631,297,3,826,9,4552,12,90
2632,297,3,827,2,4554,1,20
2633,297,3,828,6,4560,1,60
2634,297,3,829,3,4563,1,30
2635,297,3,830,8,4571,1,80
2636,297,3,831,9,4580,1,90
2637,297,3,832,6,4586,1,60
2638,297,3,833,5,4591,16,50
2639,297,3,834,4,4595,1,40
2640,297,3,835,5,4600,1,50
2641,297,3,836,9,4609,1,90
2642,297,3,837,6,4615,1,60
2643,297,3,838,2,4617,1,20
2644,297,3,839,6,4623,1,60
2645,297,3,840,2,4625,20,20
2646,297,3,841,8,4633,13,80
2647,297,3,842,9,4642,1,90
2648,297,3,843,6,4648,1,60
2649,297,3,844,3,4651,1,30
2650,297,3,845,2,4653,3,20
2651,297,3,846,2,4655,1,20
2652,297,3,847,3,4658,1,30
2653,297,3,848,7,4665,1,70
2654,297,3,849,3,4668,1,30
2655,297,3,850,7,4675,10,70
2656,297,3,851,9,4684,6,90
2657,297,3,852,8,4692,1,80
2658,297,3,853,5,4697,1,50
2659,297,3,854,5,4702,1,50
2660,297,3,855,5,4707,1,50
2661,297,3,856,3,4710,1,30
2662,297,3,857,9,4719,1,90
2663,297,3,858,8,4727,1,80
2664,297,3,859,2,4729,8,20
2665,297,3,860,9,4738,1,90
2666,297,3,861,5,4743,1,50
2667,297,3,862,9,4752,9,90
2668,297,3,863,8,4760,1,80
2669,297,3,864,8,4768,1,80
2670,297,3,865,2,4770,1,20
2671,297,3,866,4,4774,1,40
2672,297,3,867,9,4783,1,90
2673,297,3,868,4,4787,1,40
2674,297,3,869,3,4790,1,30
2675,297,3,870,9,4799,1,90
2676,297,3,871,6,4805,1,60
2677,297,3,872,7,4812,1,70
2678,297,3,873,4,4816,22,40
2679,297,3,874,4,4820,1,40
2680,297,3,875,6,4826,1,60
2681,297,3,876,3,4829,1,30
2682,297,3,877,5,4834,1,50
2683,297,3,878,6,4840,1,60
2684,297,3,879,7,4847,1,70
2685,297,3,880,6,4853,1,60
2686,297,3,881,6,4859,1,60
2687,297,3,882,5,4864,1,50
2688,297,3,883,6,4870,1,60
2689,297,3,884,2,4872,1,20
2690,297,3,885,8,4880,1,80
2691,297,3,886,9,4889,1,90
2692,297,3,887,6,4895,1,60
2693,297,3,888,7,4902,22,70
2694,297,3,889,2,4904,1,20
2695,297,3,890,2,4906,1,20
2696,297,3,891,5,4911,6,50
2697,297,3,892,2,4913,1,20
2698,297,3,893,8,4921,1,80
2699,297,3,894,6,4927,1,60
2700,297,3,895,8,4935,1,80
2701,297,3,896,9,4944,1,90
2702,297,3,897,4,4948,1,40
2703,297,3,898,7,4955,1,70
2704,297,3,899,5,4960,1,50
2705,297,3,900,7,4967,1,70
2706,297,3,901,3,4970,1,30
2707,297,3,902,6,4976,9,60
2708,297,3,903,2,4978,1,20
2709,297,3,904,5,4983,1,50
2710,297,3,905,3,4986,1,30
2711,297,3,906,9,4995,1,90
2712,297,3,907,3,4998,1,30
