,Scenario,Trial,Inspection,Interval,Time,Defects,Rate
0,155,1,1,8,8,0,80
1,155,1,2,8,16,1,80
2,155,1,3,7,23,1,70
3,155,1,4,2,25,3,20
4,155,1,5,4,29,0,40
5,155,1,6,4,33,2,40
6,155,1,7,8,41,3,80
7,155,1,8,6,47,1,60
8,155,1,9,4,51,3,40
9,155,1,10,6,57,1,60
10,155,1,11,8,65,1,80
11,155,1,12,8,73,2,80
12,155,1,13,3,76,6,30
13,155,1,14,9,85,4,90
14,155,1,15,3,88,1,30
15,155,1,16,6,94,1,60
16,155,1,17,2,96,3,20
17,155,1,18,6,102,2,60
18,155,1,19,7,109,4,70
19,155,1,20,9,118,0,90
20,155,1,21,7,125,2,70
21,155,1,22,5,130,1,50
22,155,1,23,6,136,4,60
23,155,1,24,3,139,1,30
24,155,1,25,9,148,1,90
25,155,1,26,8,156,1,80
26,155,1,27,4,160,1,40
27,155,1,28,6,166,3,60
28,155,1,29,5,171,2,50
29,155,1,30,7,178,1,70
30,155,1,31,9,187,1,90
31,155,1,32,4,191,1,40
32,155,1,33,9,200,1,90
33,155,1,34,3,203,1,30
34,155,1,35,3,206,5,30
35,155,1,36,9,215,1,90
36,155,1,37,7,222,1,70
37,155,1,38,8,230,7,80
38,155,1,39,6,236,1,60
39,155,1,40,4,240,1,40
40,155,1,41,3,243,2,30
41,155,1,42,8,251,6,80
42,155,1,43,8,259,5,80
43,155,1,44,9,268,5,90
44,155,1,45,8,276,1,80
45,155,1,46,9,285,3,90
46,155,1,47,6,291,6,60
47,155,1,48,4,295,1,40
48,155,1,49,7,302,5,70
49,155,1,50,4,306,1,40
50,155,1,51,9,315,5,90
51,155,1,52,8,323,1,80
52,155,1,53,5,328,1,50
53,155,1,54,9,337,6,90
54,155,1,55,5,342,1,50
55,155,1,56,2,344,1,20
56,155,1,57,3,347,7,30
57,155,1,58,7,354,5,70
58,155,1,59,3,357,5,30
59,155,1,60,5,362,2,50
60,155,1,61,7,369,1,70
61,155,1,62,3,372,1,30
62,155,1,63,6,378,6,60
63,155,1,64,2,380,5,20
64,155,1,65,7,387,1,70
65,155,1,66,5,392,1,50
66,155,1,67,4,396,1,40
67,155,1,68,9,405,3,90
68,155,1,69,6,411,1,60
69,155,1,70,5,416,1,50
70,155,1,71,9,425,6,90
71,155,1,72,2,427,4,20
72,155,1,73,9,436,4,90
73,155,1,74,4,440,3,40
74,155,1,75,9,449,1,90
75,155,1,76,2,451,3,20
76,155,1,77,2,453,2,20
77,155,1,78,5,458,2,50
78,155,1,79,8,466,7,80
79,155,1,80,6,472,2,60
80,155,1,81,7,479,2,70
81,155,1,82,6,485,3,60
82,155,1,83,7,492,1,70
83,155,1,84,8,500,1,80
84,155,1,85,4,504,1,40
85,155,1,86,2,506,1,20
86,155,1,87,6,512,1,60
87,155,1,88,2,514,1,20
88,155,1,89,5,519,4,50
89,155,1,90,2,521,2,20
90,155,1,91,9,530,4,90
91,155,1,92,9,539,1,90
92,155,1,93,6,545,4,60
93,155,1,94,9,554,4,90
94,155,1,95,7,561,5,70
95,155,1,96,2,563,3,20
96,155,1,97,5,568,1,50
97,155,1,98,9,577,1,90
98,155,1,99,4,581,3,40
99,155,1,100,8,589,1,80
100,155,1,101,8,597,1,80
101,155,1,102,3,600,2,30
102,155,1,103,8,608,1,80
103,155,1,104,9,617,3,90
104,155,1,105,6,623,1,60
105,155,1,106,5,628,2,50
106,155,1,107,8,636,5,80
107,155,1,108,8,644,1,80
108,155,1,109,4,648,5,40
109,155,1,110,9,657,3,90
110,155,1,111,7,664,3,70
111,155,1,112,7,671,3,70
112,155,1,113,7,678,1,70
113,155,1,114,7,685,4,70
114,155,1,115,7,692,3,70
115,155,1,116,3,695,1,30
116,155,1,117,8,703,1,80
117,155,1,118,8,711,4,80
118,155,1,119,3,714,4,30
119,155,1,120,3,717,2,30
120,155,1,121,6,723,1,60
121,155,1,122,8,731,1,80
122,155,1,123,7,738,5,70
123,155,1,124,6,744,1,60
124,155,1,125,9,753,4,90
125,155,1,126,8,761,1,80
126,155,1,127,5,766,7,50
127,155,1,128,2,768,7,20
128,155,1,129,2,770,1,20
129,155,1,130,8,778,2,80
130,155,1,131,4,782,1,40
131,155,1,132,5,787,2,50
132,155,1,133,6,793,6,60
133,155,1,134,2,795,2,20
134,155,1,135,8,803,3,80
135,155,1,136,5,808,1,50
136,155,1,137,7,815,1,70
137,155,1,138,8,823,1,80
138,155,1,139,5,828,1,50
139,155,1,140,9,837,1,90
140,155,1,141,4,841,1,40
141,155,1,142,5,846,6,50
142,155,1,143,9,855,4,90
143,155,1,144,2,857,6,20
144,155,1,145,3,860,1,30
145,155,1,146,2,862,1,20
146,155,1,147,9,871,3,90
147,155,1,148,5,876,7,50
148,155,1,149,8,884,1,80
149,155,1,150,7,891,1,70
150,155,1,151,9,900,5,90
151,155,1,152,5,905,2,50
152,155,1,153,3,908,1,30
153,155,1,154,3,911,3,30
154,155,1,155,8,919,3,80
155,155,1,156,8,927,1,80
156,155,1,157,8,935,5,80
157,155,1,158,6,941,2,60
158,155,1,159,9,950,1,90
159,155,1,160,6,956,1,60
160,155,1,161,9,965,1,90
161,155,1,162,3,968,4,30
162,155,1,163,5,973,1,50
163,155,1,164,5,978,1,50
164,155,1,165,6,984,3,60
165,155,1,166,9,993,3,90
166,155,1,167,2,995,4,20
167,155,1,168,9,1004,1,90
168,155,1,169,9,1013,5,90
169,155,1,170,3,1016,1,30
170,155,1,171,9,1025,4,90
171,155,1,172,6,1031,9,60
172,155,1,173,4,1035,5,40
173,155,1,174,6,1041,1,60
174,155,1,175,4,1045,6,40
175,155,1,176,7,1052,3,70
176,155,1,177,2,1054,3,20
177,155,1,178,9,1063,1,90
178,155,1,179,5,1068,1,50
179,155,1,180,4,1072,1,40
180,155,1,181,3,1075,5,30
181,155,1,182,7,1082,1,70
182,155,1,183,9,1091,1,90
183,155,1,184,6,1097,1,60
184,155,1,185,5,1102,1,50
185,155,1,186,3,1105,1,30
186,155,1,187,5,1110,3,50
187,155,1,188,6,1116,1,60
188,155,1,189,4,1120,2,40
189,155,1,190,3,1123,1,30
190,155,1,191,8,1131,5,80
191,155,1,192,7,1138,1,70
192,155,1,193,9,1147,6,90
193,155,1,194,6,1153,1,60
194,155,1,195,5,1158,4,50
195,155,1,196,7,1165,1,70
196,155,1,197,4,1169,1,40
197,155,1,198,6,1175,1,60
198,155,1,199,9,1184,5,90
199,155,1,200,7,1191,9,70
200,155,1,201,3,1194,5,30
201,155,1,202,5,1199,1,50
202,155,1,203,7,1206,6,70
203,155,1,204,3,1209,3,30
204,155,1,205,4,1213,0,40
205,155,1,206,6,1219,1,60
206,155,1,207,2,1221,3,20
207,155,1,208,3,1224,6,30
208,155,1,209,2,1226,1,20
209,155,1,210,6,1232,2,60
210,155,1,211,9,1241,0,90
211,155,1,212,5,1246,9,50
212,155,1,213,7,1253,1,70
213,155,1,214,6,1259,2,60
214,155,1,215,7,1266,7,70
215,155,1,216,7,1273,5,70
216,155,1,217,9,1282,5,90
217,155,1,218,4,1286,2,40
218,155,1,219,5,1291,1,50
219,155,1,220,7,1298,3,70
220,155,1,221,6,1304,1,60
221,155,1,222,7,1311,4,70
222,155,1,223,2,1313,6,20
223,155,1,224,9,1322,2,90
224,155,1,225,4,1326,1,40
225,155,1,226,8,1334,6,80
226,155,1,227,4,1338,5,40
227,155,1,228,9,1347,5,90
228,155,1,229,3,1350,6,30
229,155,1,230,2,1352,1,20
230,155,1,231,2,1354,2,20
231,155,1,232,8,1362,1,80
232,155,1,233,9,1371,5,90
233,155,1,234,8,1379,1,80
234,155,1,235,3,1382,2,30
235,155,1,236,6,1388,1,60
236,155,1,237,6,1394,3,60
237,155,1,238,3,1397,1,30
238,155,1,239,5,1402,1,50
239,155,1,240,3,1405,4,30
240,155,1,241,8,1413,1,80
241,155,1,242,2,1415,5,20
242,155,1,243,2,1417,1,20
243,155,1,244,4,1421,1,40
244,155,1,245,8,1429,1,80
245,155,1,246,6,1435,1,60
246,155,1,247,3,1438,1,30
247,155,1,248,7,1445,3,70
248,155,1,249,9,1454,7,90
249,155,1,250,4,1458,1,40
250,155,1,251,8,1466,1,80
251,155,1,252,4,1470,1,40
252,155,1,253,6,1476,8,60
253,155,1,254,6,1482,1,60
254,155,1,255,4,1486,3,40
255,155,1,256,3,1489,6,30
256,155,1,257,3,1492,2,30
257,155,1,258,7,1499,3,70
258,155,1,259,8,1507,1,80
259,155,1,260,5,1512,1,50
260,155,1,261,7,1519,1,70
261,155,1,262,6,1525,2,60
262,155,1,263,5,1530,9,50
263,155,1,264,4,1534,1,40
264,155,1,265,7,1541,1,70
265,155,1,266,4,1545,1,40
266,155,1,267,8,1553,1,80
267,155,1,268,3,1556,2,30
268,155,1,269,8,1564,1,80
269,155,1,270,4,1568,4,40
270,155,1,271,4,1572,1,40
271,155,1,272,3,1575,3,30
272,155,1,273,3,1578,2,30
273,155,1,274,5,1583,1,50
274,155,1,275,5,1588,3,50
275,155,1,276,6,1594,1,60
276,155,1,277,7,1601,2,70
277,155,1,278,9,1610,1,90
278,155,1,279,5,1615,1,50
279,155,1,280,2,1617,5,20
280,155,1,281,8,1625,1,80
281,155,1,282,9,1634,7,90
282,155,1,283,5,1639,2,50
283,155,1,284,3,1642,1,30
284,155,1,285,9,1651,1,90
285,155,1,286,2,1653,2,20
286,155,1,287,9,1662,6,90
287,155,1,288,6,1668,1,60
288,155,1,289,9,1677,1,90
289,155,1,290,8,1685,1,80
290,155,1,291,2,1687,1,20
291,155,1,292,3,1690,1,30
292,155,1,293,4,1694,8,40
293,155,1,294,9,1703,1,90
294,155,1,295,6,1709,1,60
295,155,1,296,7,1716,2,70
296,155,1,297,9,1725,2,90
297,155,1,298,5,1730,1,50
298,155,1,299,7,1737,2,70
299,155,1,300,2,1739,1,20
300,155,1,301,6,1745,6,60
301,155,1,302,7,1752,1,70
302,155,1,303,9,1761,5,90
303,155,1,304,8,1769,1,80
304,155,1,305,7,1776,1,70
305,155,1,306,5,1781,1,50
306,155,1,307,2,1783,1,20
307,155,1,308,9,1792,1,90
308,155,1,309,6,1798,1,60
309,155,1,310,3,1801,1,30
310,155,1,311,7,1808,11,70
311,155,1,312,5,1813,4,50
312,155,1,313,7,1820,1,70
313,155,1,314,7,1827,3,70
314,155,1,315,3,1830,2,30
315,155,1,316,9,1839,7,90
316,155,1,317,8,1847,3,80
317,155,1,318,5,1852,1,50
318,155,1,319,2,1854,1,20
319,155,1,320,3,1857,2,30
320,155,1,321,7,1864,1,70
321,155,1,322,8,1872,1,80
322,155,1,323,9,1881,2,90
323,155,1,324,7,1888,1,70
324,155,1,325,4,1892,1,40
325,155,1,326,7,1899,2,70
326,155,1,327,6,1905,4,60
327,155,1,328,2,1907,9,20
328,155,1,329,7,1914,1,70
329,155,1,330,2,1916,8,20
330,155,1,331,8,1924,1,80
331,155,1,332,5,1929,8,50
332,155,1,333,6,1935,1,60
333,155,1,334,8,1943,1,80
334,155,1,335,6,1949,8,60
335,155,1,336,8,1957,1,80
336,155,1,337,9,1966,4,90
337,155,1,338,4,1970,1,40
338,155,1,339,5,1975,1,50
339,155,1,340,5,1980,1,50
340,155,1,341,4,1984,7,40
341,155,1,342,3,1987,1,30
342,155,1,343,3,1990,1,30
343,155,1,344,7,1997,6,70
344,155,1,345,8,2005,7,80
345,155,1,346,3,2008,1,30
346,155,1,347,9,2017,6,90
347,155,1,348,8,2025,5,80
348,155,1,349,2,2027,1,20
349,155,1,350,6,2033,4,60
350,155,1,351,4,2037,6,40
351,155,1,352,7,2044,1,70
352,155,1,353,7,2051,6,70
353,155,1,354,4,2055,9,40
354,155,1,355,9,2064,1,90
355,155,1,356,4,2068,2,40
356,155,1,357,8,2076,1,80
357,155,1,358,2,2078,1,20
358,155,1,359,3,2081,2,30
359,155,1,360,7,2088,1,70
360,155,1,361,5,2093,1,50
361,155,1,362,7,2100,2,70
362,155,1,363,3,2103,6,30
363,155,1,364,5,2108,4,50
364,155,1,365,4,2112,1,40
365,155,1,366,8,2120,1,80
366,155,1,367,5,2125,1,50
367,155,1,368,5,2130,5,50
368,155,1,369,7,2137,1,70
369,155,1,370,7,2144,6,70
370,155,1,371,6,2150,1,60
371,155,1,372,9,2159,1,90
372,155,1,373,3,2162,1,30
373,155,1,374,2,2164,1,20
374,155,1,375,2,2166,1,20
375,155,1,376,7,2173,5,70
376,155,1,377,5,2178,1,50
377,155,1,378,8,2186,4,80
378,155,1,379,3,2189,12,30
379,155,1,380,8,2197,4,80
380,155,1,381,9,2206,1,90
381,155,1,382,3,2209,4,30
382,155,1,383,4,2213,1,40
383,155,1,384,3,2216,5,30
384,155,1,385,9,2225,1,90
385,155,1,386,5,2230,4,50
386,155,1,387,5,2235,1,50
387,155,1,388,6,2241,4,60
388,155,1,389,4,2245,1,40
389,155,1,390,5,2250,3,50
390,155,1,391,9,2259,1,90
391,155,1,392,9,2268,11,90
392,155,1,393,7,2275,1,70
393,155,1,394,3,2278,4,30
394,155,1,395,2,2280,1,20
395,155,1,396,4,2284,1,40
396,155,1,397,5,2289,7,50
397,155,1,398,3,2292,1,30
398,155,1,399,6,2298,8,60
399,155,1,400,6,2304,4,60
400,155,1,401,4,2308,3,40
401,155,1,402,3,2311,4,30
402,155,1,403,3,2314,1,30
403,155,1,404,7,2321,1,70
404,155,1,405,3,2324,0,30
405,155,1,406,9,2333,1,90
406,155,1,407,2,2335,1,20
407,155,1,408,4,2339,1,40
408,155,1,409,6,2345,1,60
409,155,1,410,6,2351,4,60
410,155,1,411,5,2356,1,50
411,155,1,412,5,2361,1,50
412,155,1,413,9,2370,1,90
413,155,1,414,3,2373,1,30
414,155,1,415,6,2379,9,60
415,155,1,416,3,2382,1,30
416,155,1,417,6,2388,8,60
417,155,1,418,4,2392,1,40
418,155,1,419,6,2398,3,60
419,155,1,420,8,2406,1,80
420,155,1,421,6,2412,1,60
421,155,1,422,7,2419,1,70
422,155,1,423,9,2428,1,90
423,155,1,424,2,2430,1,20
424,155,1,425,7,2437,3,70
425,155,1,426,5,2442,0,50
426,155,1,427,6,2448,8,60
427,155,1,428,2,2450,1,20
428,155,1,429,2,2452,4,20
429,155,1,430,8,2460,5,80
430,155,1,431,8,2468,3,80
431,155,1,432,6,2474,6,60
432,155,1,433,2,2476,1,20
433,155,1,434,2,2478,4,20
434,155,1,435,4,2482,3,40
435,155,1,436,7,2489,1,70
436,155,1,437,3,2492,1,30
437,155,1,438,7,2499,5,70
438,155,1,439,5,2504,4,50
439,155,1,440,7,2511,1,70
440,155,1,441,8,2519,4,80
441,155,1,442,3,2522,2,30
442,155,1,443,2,2524,4,20
443,155,1,444,9,2533,1,90
444,155,1,445,5,2538,1,50
445,155,1,446,9,2547,4,90
446,155,1,447,2,2549,4,20
447,155,1,448,8,2557,3,80
448,155,1,449,5,2562,4,50
449,155,1,450,9,2571,1,90
450,155,1,451,7,2578,7,70
451,155,1,452,6,2584,1,60
452,155,1,453,3,2587,4,30
453,155,1,454,8,2595,3,80
454,155,1,455,2,2597,3,20
455,155,1,456,8,2605,7,80
456,155,1,457,7,2612,1,70
457,155,1,458,9,2621,1,90
458,155,1,459,5,2626,1,50
459,155,1,460,6,2632,2,60
460,155,1,461,6,2638,5,60
461,155,1,462,7,2645,1,70
462,155,1,463,6,2651,2,60
463,155,1,464,5,2656,1,50
464,155,1,465,3,2659,1,30
465,155,1,466,4,2663,1,40
466,155,1,467,8,2671,9,80
467,155,1,468,7,2678,5,70
468,155,1,469,3,2681,7,30
469,155,1,470,3,2684,1,30
470,155,1,471,7,2691,5,70
471,155,1,472,2,2693,4,20
472,155,1,473,2,2695,1,20
473,155,1,474,6,2701,1,60
474,155,1,475,9,2710,1,90
475,155,1,476,8,2718,5,80
476,155,1,477,8,2726,4,80
477,155,1,478,7,2733,1,70
478,155,1,479,6,2739,1,60
479,155,1,480,5,2744,1,50
480,155,1,481,2,2746,4,20
481,155,1,482,5,2751,3,50
482,155,1,483,6,2757,0,60
483,155,1,484,6,2763,1,60
484,155,1,485,7,2770,6,70
485,155,1,486,5,2775,1,50
486,155,1,487,6,2781,1,60
487,155,1,488,6,2787,1,60
488,155,1,489,6,2793,5,60
489,155,1,490,4,2797,1,40
490,155,1,491,4,2801,2,40
491,155,1,492,9,2810,5,90
492,155,1,493,6,2816,5,60
493,155,1,494,9,2825,4,90
494,155,1,495,9,2834,1,90
495,155,1,496,9,2843,4,90
496,155,1,497,7,2850,1,70
497,155,1,498,9,2859,5,90
498,155,1,499,4,2863,3,40
499,155,1,500,2,2865,6,20
500,155,1,501,8,2873,4,80
501,155,1,502,4,2877,1,40
502,155,1,503,2,2879,6,20
503,155,1,504,2,2881,4,20
504,155,1,505,5,2886,1,50
505,155,1,506,5,2891,5,50
506,155,1,507,5,2896,3,50
507,155,1,508,7,2903,7,70
508,155,1,509,8,2911,1,80
509,155,1,510,6,2917,1,60
510,155,1,511,9,2926,1,90
511,155,1,512,2,2928,3,20
512,155,1,513,6,2934,8,60
513,155,1,514,7,2941,4,70
514,155,1,515,2,2943,4,20
515,155,1,516,4,2947,1,40
516,155,1,517,8,2955,1,80
517,155,1,518,3,2958,1,30
518,155,1,519,4,2962,1,40
519,155,1,520,3,2965,7,30
520,155,1,521,6,2971,4,60
521,155,1,522,7,2978,2,70
522,155,1,523,5,2983,3,50
523,155,1,524,2,2985,1,20
524,155,1,525,9,2994,2,90
525,155,1,526,9,3003,1,90
526,155,1,527,7,3010,3,70
527,155,1,528,8,3018,2,80
528,155,1,529,5,3023,2,50
529,155,1,530,8,3031,1,80
530,155,1,531,7,3038,1,70
531,155,1,532,2,3040,1,20
532,155,1,533,9,3049,1,90
533,155,1,534,3,3052,4,30
534,155,1,535,6,3058,1,60
535,155,1,536,3,3061,1,30
536,155,1,537,3,3064,6,30
537,155,1,538,4,3068,1,40
538,155,1,539,9,3077,4,90
539,155,1,540,9,3086,1,90
540,155,1,541,9,3095,1,90
541,155,1,542,7,3102,1,70
542,155,1,543,8,3110,6,80
543,155,1,544,4,3114,4,40
544,155,1,545,8,3122,1,80
545,155,1,546,6,3128,1,60
546,155,1,547,6,3134,1,60
547,155,1,548,8,3142,9,80
548,155,1,549,8,3150,6,80
549,155,1,550,3,3153,1,30
550,155,1,551,9,3162,1,90
551,155,1,552,8,3170,13,80
552,155,1,553,8,3178,1,80
553,155,1,554,7,3185,1,70
554,155,1,555,3,3188,1,30
555,155,1,556,2,3190,1,20
556,155,1,557,7,3197,1,70
557,155,1,558,6,3203,1,60
558,155,1,559,2,3205,1,20
559,155,1,560,3,3208,6,30
560,155,1,561,2,3210,4,20
561,155,1,562,5,3215,1,50
562,155,1,563,4,3219,5,40
563,155,1,564,8,3227,7,80
564,155,1,565,3,3230,1,30
565,155,1,566,5,3235,1,50
566,155,1,567,7,3242,1,70
567,155,1,568,5,3247,1,50
568,155,1,569,9,3256,1,90
569,155,1,570,4,3260,1,40
570,155,1,571,9,3269,5,90
571,155,1,572,9,3278,11,90
572,155,1,573,2,3280,1,20
573,155,1,574,6,3286,1,60
574,155,1,575,4,3290,4,40
575,155,1,576,3,3293,7,30
576,155,1,577,7,3300,4,70
577,155,1,578,9,3309,3,90
578,155,1,579,6,3315,5,60
579,155,1,580,9,3324,6,90
580,155,1,581,9,3333,7,90
581,155,1,582,8,3341,1,80
582,155,1,583,4,3345,1,40
583,155,1,584,9,3354,7,90
584,155,1,585,3,3357,1,30
585,155,1,586,9,3366,5,90
586,155,1,587,8,3374,4,80
587,155,1,588,8,3382,7,80
588,155,1,589,3,3385,8,30
589,155,1,590,3,3388,1,30
590,155,1,591,2,3390,1,20
591,155,1,592,8,3398,3,80
592,155,1,593,2,3400,1,20
593,155,1,594,5,3405,6,50
594,155,1,595,2,3407,1,20
595,155,1,596,7,3414,4,70
596,155,1,597,3,3417,1,30
597,155,1,598,2,3419,1,20
598,155,1,599,3,3422,7,30
599,155,1,600,6,3428,1,60
600,155,1,601,8,3436,1,80
601,155,1,602,9,3445,1,90
602,155,1,603,8,3453,4,80
603,155,1,604,6,3459,1,60
604,155,1,605,3,3462,1,30
605,155,1,606,6,3468,5,60
606,155,1,607,3,3471,1,30
607,155,1,608,5,3476,8,50
608,155,1,609,5,3481,6,50
609,155,1,610,2,3483,1,20
610,155,1,611,7,3490,2,70
611,155,1,612,2,3492,4,20
612,155,1,613,2,3494,2,20
613,155,1,614,4,3498,1,40
614,155,1,615,5,3503,1,50
615,155,1,616,7,3510,5,70
616,155,1,617,5,3515,1,50
617,155,1,618,4,3519,1,40
618,155,1,619,3,3522,3,30
619,155,1,620,7,3529,3,70
620,155,1,621,5,3534,1,50
621,155,1,622,4,3538,1,40
622,155,1,623,7,3545,1,70
623,155,1,624,5,3550,7,50
624,155,1,625,8,3558,3,80
625,155,1,626,8,3566,5,80
626,155,1,627,8,3574,2,80
627,155,1,628,3,3577,8,30
628,155,1,629,5,3582,2,50
629,155,1,630,7,3589,5,70
630,155,1,631,5,3594,2,50
631,155,1,632,8,3602,1,80
632,155,1,633,3,3605,7,30
633,155,1,634,8,3613,1,80
634,155,1,635,4,3617,2,40
635,155,1,636,7,3624,5,70
636,155,1,637,7,3631,4,70
637,155,1,638,6,3637,1,60
638,155,1,639,3,3640,1,30
639,155,1,640,6,3646,1,60
640,155,1,641,2,3648,1,20
641,155,1,642,5,3653,1,50
642,155,1,643,8,3661,1,80
643,155,1,644,3,3664,1,30
644,155,1,645,5,3669,1,50
645,155,1,646,8,3677,1,80
646,155,1,647,2,3679,4,20
647,155,1,648,6,3685,1,60
648,155,1,649,4,3689,1,40
649,155,1,650,6,3695,5,60
650,155,1,651,3,3698,1,30
651,155,1,652,8,3706,7,80
652,155,1,653,2,3708,1,20
653,155,1,654,4,3712,5,40
654,155,1,655,4,3716,2,40
655,155,1,656,2,3718,1,20
656,155,1,657,8,3726,3,80
657,155,1,658,7,3733,7,70
658,155,1,659,7,3740,1,70
659,155,1,660,2,3742,1,20
660,155,1,661,9,3751,3,90
661,155,1,662,9,3760,6,90
662,155,1,663,6,3766,1,60
663,155,1,664,8,3774,1,80
664,155,1,665,3,3777,1,30
665,155,1,666,9,3786,5,90
666,155,1,667,5,3791,6,50
667,155,1,668,3,3794,3,30
668,155,1,669,5,3799,1,50
669,155,1,670,7,3806,4,70
670,155,1,671,3,3809,4,30
671,155,1,672,9,3818,4,90
672,155,1,673,2,3820,1,20
673,155,1,674,4,3824,7,40
674,155,1,675,7,3831,1,70
675,155,1,676,7,3838,4,70
676,155,1,677,4,3842,8,40
677,155,1,678,8,3850,1,80
678,155,1,679,2,3852,1,20
679,155,1,680,3,3855,1,30
680,155,1,681,9,3864,3,90
681,155,1,682,2,3866,3,20
682,155,1,683,6,3872,6,60
683,155,1,684,2,3874,1,20
684,155,1,685,4,3878,7,40
685,155,1,686,9,3887,1,90
686,155,1,687,3,3890,3,30
687,155,1,688,7,3897,1,70
688,155,1,689,9,3906,7,90
689,155,1,690,3,3909,1,30
690,155,1,691,7,3916,1,70
691,155,1,692,8,3924,1,80
692,155,1,693,4,3928,4,40
693,155,1,694,6,3934,4,60
694,155,1,695,5,3939,3,50
695,155,1,696,7,3946,1,70
696,155,1,697,5,3951,6,50
697,155,1,698,5,3956,1,50
698,155,1,699,9,3965,1,90
699,155,1,700,7,3972,1,70
700,155,1,701,9,3981,1,90
701,155,1,702,6,3987,1,60
702,155,1,703,4,3991,5,40
703,155,1,704,8,3999,1,80
704,155,1,705,7,4006,1,70
705,155,1,706,6,4012,1,60
706,155,1,707,3,4015,4,30
707,155,1,708,4,4019,1,40
708,155,1,709,4,4023,5,40
709,155,1,710,6,4029,4,60
710,155,1,711,4,4033,5,40
711,155,1,712,8,4041,1,80
712,155,1,713,9,4050,6,90
713,155,1,714,3,4053,1,30
714,155,1,715,3,4056,1,30
715,155,1,716,5,4061,5,50
716,155,1,717,4,4065,1,40
717,155,1,718,2,4067,3,20
718,155,1,719,8,4075,3,80
719,155,1,720,9,4084,2,90
720,155,1,721,3,4087,1,30
721,155,1,722,6,4093,0,60
722,155,1,723,3,4096,2,30
723,155,1,724,6,4102,1,60
724,155,1,725,8,4110,5,80
725,155,1,726,8,4118,2,80
726,155,1,727,3,4121,1,30
727,155,1,728,9,4130,5,90
728,155,1,729,4,4134,4,40
729,155,1,730,5,4139,1,50
730,155,1,731,2,4141,6,20
731,155,1,732,9,4150,2,90
732,155,1,733,2,4152,1,20
733,155,1,734,7,4159,1,70
734,155,1,735,9,4168,1,90
735,155,1,736,6,4174,1,60
736,155,1,737,6,4180,1,60
737,155,1,738,4,4184,5,40
738,155,1,739,3,4187,9,30
739,155,1,740,5,4192,1,50
740,155,1,741,3,4195,1,30
741,155,1,742,2,4197,4,20
742,155,1,743,3,4200,1,30
743,155,1,744,5,4205,3,50
744,155,1,745,2,4207,1,20
745,155,1,746,3,4210,1,30
746,155,1,747,7,4217,1,70
747,155,1,748,7,4224,1,70
748,155,1,749,2,4226,6,20
749,155,1,750,7,4233,6,70
750,155,1,751,9,4242,2,90
751,155,1,752,6,4248,1,60
752,155,1,753,2,4250,3,20
753,155,1,754,2,4252,1,20
754,155,1,755,8,4260,3,80
755,155,1,756,7,4267,1,70
756,155,1,757,3,4270,4,30
757,155,1,758,4,4274,3,40
758,155,1,759,7,4281,1,70
759,155,1,760,9,4290,1,90
760,155,1,761,6,4296,1,60
761,155,1,762,8,4304,4,80
762,155,1,763,3,4307,8,30
763,155,1,764,4,4311,3,40
764,155,1,765,4,4315,1,40
765,155,1,766,9,4324,6,90
766,155,1,767,9,4333,1,90
767,155,1,768,9,4342,4,90
768,155,1,769,7,4349,1,70
769,155,1,770,3,4352,2,30
770,155,1,771,7,4359,1,70
771,155,1,772,8,4367,1,80
772,155,1,773,9,4376,5,90
773,155,1,774,6,4382,1,60
774,155,1,775,9,4391,1,90
775,155,1,776,7,4398,1,70
776,155,1,777,3,4401,5,30
777,155,1,778,3,4404,4,30
778,155,1,779,3,4407,9,30
779,155,1,780,7,4414,6,70
780,155,1,781,5,4419,1,50
781,155,1,782,6,4425,1,60
782,155,1,783,2,4427,5,20
783,155,1,784,2,4429,5,20
784,155,1,785,8,4437,6,80
785,155,1,786,5,4442,3,50
786,155,1,787,7,4449,1,70
787,155,1,788,8,4457,5,80
788,155,1,789,6,4463,5,60
789,155,1,790,8,4471,1,80
790,155,1,791,6,4477,1,60
791,155,1,792,7,4484,1,70
792,155,1,793,8,4492,1,80
793,155,1,794,7,4499,1,70
794,155,1,795,3,4502,5,30
795,155,1,796,4,4506,1,40
796,155,1,797,7,4513,1,70
797,155,1,798,4,4517,1,40
798,155,1,799,2,4519,1,20
799,155,1,800,9,4528,4,90
800,155,1,801,9,4537,7,90
801,155,1,802,2,4539,8,20
802,155,1,803,7,4546,1,70
803,155,1,804,2,4548,3,20
804,155,1,805,3,4551,1,30
805,155,1,806,5,4556,4,50
806,155,1,807,6,4562,3,60
807,155,1,808,5,4567,4,50
808,155,1,809,3,4570,4,30
809,155,1,810,6,4576,2,60
810,155,1,811,3,4579,3,30
811,155,1,812,2,4581,1,20
812,155,1,813,2,4583,1,20
813,155,1,814,9,4592,1,90
814,155,1,815,3,4595,1,30
815,155,1,816,2,4597,4,20
816,155,1,817,6,4603,1,60
817,155,1,818,6,4609,1,60
818,155,1,819,7,4616,1,70
819,155,1,820,3,4619,1,30
820,155,1,821,9,4628,5,90
821,155,1,822,7,4635,8,70
822,155,1,823,3,4638,1,30
823,155,1,824,9,4647,1,90
824,155,1,825,7,4654,6,70
825,155,1,826,7,4661,1,70
826,155,1,827,4,4665,1,40
827,155,1,828,7,4672,1,70
828,155,1,829,5,4677,5,50
829,155,1,830,6,4683,6,60
830,155,1,831,9,4692,1,90
831,155,1,832,7,4699,6,70
832,155,1,833,4,4703,1,40
833,155,1,834,5,4708,10,50
834,155,1,835,6,4714,1,60
835,155,1,836,4,4718,1,40
836,155,1,837,7,4725,1,70
837,155,1,838,2,4727,1,20
838,155,1,839,4,4731,1,40
839,155,1,840,3,4734,9,30
840,155,1,841,7,4741,9,70
841,155,1,842,2,4743,1,20
842,155,1,843,4,4747,12,40
843,155,1,844,9,4756,1,90
844,155,1,845,6,4762,4,60
845,155,1,846,4,4766,1,40
846,155,1,847,8,4774,1,80
847,155,1,848,8,4782,1,80
848,155,1,849,6,4788,7,60
849,155,1,850,2,4790,6,20
850,155,1,851,6,4796,1,60
851,155,1,852,7,4803,3,70
852,155,1,853,6,4809,1,60
853,155,1,854,6,4815,1,60
854,155,1,855,6,4821,2,60
855,155,1,856,4,4825,6,40
856,155,1,857,7,4832,1,70
857,155,1,858,6,4838,1,60
858,155,1,859,2,4840,1,20
859,155,1,860,7,4847,3,70
860,155,1,861,7,4854,1,70
861,155,1,862,2,4856,6,20
862,155,1,863,7,4863,4,70
863,155,1,864,6,4869,1,60
864,155,1,865,3,4872,7,30
865,155,1,866,9,4881,5,90
866,155,1,867,7,4888,1,70
867,155,1,868,8,4896,1,80
868,155,1,869,5,4901,1,50
869,155,1,870,8,4909,1,80
870,155,1,871,7,4916,5,70
871,155,1,872,9,4925,1,90
872,155,1,873,3,4928,4,30
873,155,1,874,7,4935,1,70
874,155,1,875,9,4944,1,90
875,155,1,876,3,4947,6,30
876,155,1,877,5,4952,1,50
877,155,1,878,2,4954,9,20
878,155,1,879,7,4961,5,70
879,155,1,880,3,4964,1,30
880,155,1,881,5,4969,1,50
881,155,1,882,2,4971,8,20
882,155,1,883,2,4973,4,20
883,155,1,884,2,4975,1,20
884,155,1,885,5,4980,1,50
885,155,1,886,8,4988,1,80
886,155,1,887,6,4994,7,60
887,155,2,1,3,3,0,30
888,155,2,2,5,8,1,50
889,155,2,3,3,11,0,30
890,155,2,4,3,14,0,30
891,155,2,5,2,16,0,20
892,155,2,6,9,25,1,90
893,155,2,7,8,33,1,80
894,155,2,8,6,39,2,60
895,155,2,9,8,47,2,80
896,155,2,10,9,56,1,90
897,155,2,11,5,61,2,50
898,155,2,12,9,70,3,90
899,155,2,13,8,78,3,80
900,155,2,14,7,85,1,70
901,155,2,15,8,93,1,80
902,155,2,16,9,102,2,90
903,155,2,17,3,105,3,30
904,155,2,18,8,113,4,80
905,155,2,19,9,122,9,90
906,155,2,20,6,128,3,60
907,155,2,21,8,136,1,80
908,155,2,22,3,139,5,30
909,155,2,23,4,143,3,40
910,155,2,24,8,151,7,80
911,155,2,25,5,156,1,50
912,155,2,26,2,158,1,20
913,155,2,27,4,162,1,40
914,155,2,28,7,169,1,70
915,155,2,29,4,173,1,40
916,155,2,30,4,177,7,40
917,155,2,31,5,182,1,50
918,155,2,32,8,190,1,80
919,155,2,33,9,199,4,90
920,155,2,34,6,205,1,60
921,155,2,35,6,211,11,60
922,155,2,36,9,220,1,90
923,155,2,37,6,226,4,60
924,155,2,38,9,235,1,90
925,155,2,39,5,240,3,50
926,155,2,40,7,247,2,70
927,155,2,41,4,251,1,40
928,155,2,42,2,253,1,20
929,155,2,43,3,256,1,30
930,155,2,44,7,263,3,70
931,155,2,45,3,266,9,30
932,155,2,46,3,269,1,30
933,155,2,47,9,278,2,90
934,155,2,48,2,280,1,20
935,155,2,49,7,287,6,70
936,155,2,50,7,294,6,70
937,155,2,51,8,302,1,80
938,155,2,52,2,304,4,20
939,155,2,53,9,313,1,90
940,155,2,54,5,318,3,50
941,155,2,55,7,325,1,70
942,155,2,56,4,329,3,40
943,155,2,57,3,332,1,30
944,155,2,58,8,340,4,80
945,155,2,59,9,349,1,90
946,155,2,60,5,354,4,50
947,155,2,61,5,359,7,50
948,155,2,62,5,364,1,50
949,155,2,63,2,366,4,20
950,155,2,64,6,372,1,60
951,155,2,65,6,378,3,60
952,155,2,66,9,387,1,90
953,155,2,67,3,390,1,30
954,155,2,68,9,399,1,90
955,155,2,69,6,405,5,60
956,155,2,70,7,412,1,70
957,155,2,71,8,420,5,80
958,155,2,72,7,427,1,70
959,155,2,73,4,431,1,40
960,155,2,74,6,437,8,60
961,155,2,75,3,440,1,30
962,155,2,76,8,448,1,80
963,155,2,77,5,453,1,50
964,155,2,78,2,455,4,20
965,155,2,79,4,459,1,40
966,155,2,80,8,467,1,80
967,155,2,81,5,472,6,50
968,155,2,82,6,478,7,60
969,155,2,83,5,483,3,50
970,155,2,84,3,486,1,30
971,155,2,85,3,489,1,30
972,155,2,86,7,496,1,70
973,155,2,87,2,498,4,20
974,155,2,88,6,504,1,60
975,155,2,89,5,509,7,50
976,155,2,90,3,512,1,30
977,155,2,91,6,518,1,60
978,155,2,92,5,523,4,50
979,155,2,93,3,526,3,30
980,155,2,94,4,530,1,40
981,155,2,95,9,539,1,90
982,155,2,96,6,545,1,60
983,155,2,97,5,550,2,50
984,155,2,98,3,553,1,30
985,155,2,99,6,559,3,60
986,155,2,100,3,562,1,30
987,155,2,101,2,564,2,20
988,155,2,102,9,573,1,90
989,155,2,103,2,575,5,20
990,155,2,104,7,582,2,70
991,155,2,105,5,587,3,50
992,155,2,106,2,589,1,20
993,155,2,107,8,597,1,80
994,155,2,108,2,599,5,20
995,155,2,109,9,608,2,90
996,155,2,110,9,617,6,90
997,155,2,111,7,624,3,70
998,155,2,112,2,626,0,20
999,155,2,113,8,634,1,80
1000,155,2,114,7,641,1,70
1001,155,2,115,4,645,1,40
1002,155,2,116,8,653,1,80
1003,155,2,117,5,658,1,50
1004,155,2,118,5,663,1,50
1005,155,2,119,7,670,3,70
1006,155,2,120,7,677,5,70
1007,155,2,121,6,683,3,60
1008,155,2,122,9,692,3,90
1009,155,2,123,3,695,7,30
1010,155,2,124,8,703,1,80
1011,155,2,125,7,710,2,70
1012,155,2,126,9,719,1,90
1013,155,2,127,5,724,1,50
1014,155,2,128,3,727,1,30
1015,155,2,129,7,734,1,70
1016,155,2,130,2,736,1,20
1017,155,2,131,5,741,4,50
1018,155,2,132,7,748,1,70
1019,155,2,133,7,755,1,70
1020,155,2,134,6,761,5,60
1021,155,2,135,3,764,1,30
1022,155,2,136,7,771,4,70
1023,155,2,137,4,775,1,40
1024,155,2,138,8,783,7,80
1025,155,2,139,8,791,1,80
1026,155,2,140,4,795,4,40
1027,155,2,141,6,801,3,60
1028,155,2,142,8,809,6,80
1029,155,2,143,4,813,4,40
1030,155,2,144,5,818,6,50
1031,155,2,145,5,823,1,50
1032,155,2,146,4,827,7,40
1033,155,2,147,6,833,1,60
1034,155,2,148,2,835,4,20
1035,155,2,149,4,839,1,40
1036,155,2,150,9,848,5,90
1037,155,2,151,8,856,5,80
1038,155,2,152,4,860,1,40
1039,155,2,153,3,863,2,30
1040,155,2,154,6,869,1,60
1041,155,2,155,4,873,1,40
1042,155,2,156,2,875,1,20
1043,155,2,157,2,877,3,20
1044,155,2,158,3,880,4,30
1045,155,2,159,5,885,5,50
1046,155,2,160,7,892,1,70
1047,155,2,161,7,899,4,70
1048,155,2,162,7,906,4,70
1049,155,2,163,3,909,1,30
1050,155,2,164,9,918,1,90
1051,155,2,165,8,926,1,80
1052,155,2,166,5,931,7,50
1053,155,2,167,7,938,1,70
1054,155,2,168,7,945,3,70
1055,155,2,169,4,949,1,40
1056,155,2,170,4,953,1,40
1057,155,2,171,5,958,1,50
1058,155,2,172,9,967,1,90
1059,155,2,173,4,971,1,40
1060,155,2,174,2,973,1,20
1061,155,2,175,7,980,1,70
1062,155,2,176,6,986,1,60
1063,155,2,177,9,995,2,90
1064,155,2,178,4,999,1,40
1065,155,2,179,2,1001,1,20
1066,155,2,180,6,1007,1,60
1067,155,2,181,7,1014,1,70
1068,155,2,182,4,1018,1,40
1069,155,2,183,3,1021,1,30
1070,155,2,184,6,1027,4,60
1071,155,2,185,3,1030,1,30
1072,155,2,186,4,1034,6,40
1073,155,2,187,4,1038,1,40
1074,155,2,188,6,1044,1,60
1075,155,2,189,3,1047,1,30
1076,155,2,190,6,1053,7,60
1077,155,2,191,3,1056,4,30
1078,155,2,192,4,1060,1,40
1079,155,2,193,3,1063,5,30
1080,155,2,194,8,1071,10,80
1081,155,2,195,9,1080,2,90
1082,155,2,196,6,1086,5,60
1083,155,2,197,2,1088,1,20
1084,155,2,198,8,1096,3,80
1085,155,2,199,8,1104,1,80
1086,155,2,200,6,1110,1,60
1087,155,2,201,2,1112,1,20
1088,155,2,202,9,1121,5,90
1089,155,2,203,7,1128,5,70
1090,155,2,204,3,1131,1,30
1091,155,2,205,7,1138,1,70
1092,155,2,206,5,1143,3,50
1093,155,2,207,4,1147,2,40
1094,155,2,208,7,1154,4,70
1095,155,2,209,8,1162,4,80
1096,155,2,210,3,1165,2,30
1097,155,2,211,7,1172,3,70
1098,155,2,212,2,1174,1,20
1099,155,2,213,9,1183,1,90
1100,155,2,214,8,1191,4,80
1101,155,2,215,8,1199,1,80
1102,155,2,216,6,1205,6,60
1103,155,2,217,6,1211,2,60
1104,155,2,218,4,1215,1,40
1105,155,2,219,8,1223,1,80
1106,155,2,220,9,1232,2,90
1107,155,2,221,2,1234,1,20
1108,155,2,222,5,1239,6,50
1109,155,2,223,7,1246,1,70
1110,155,2,224,3,1249,5,30
1111,155,2,225,9,1258,5,90
1112,155,2,226,9,1267,1,90
1113,155,2,227,4,1271,1,40
1114,155,2,228,7,1278,1,70
1115,155,2,229,3,1281,1,30
1116,155,2,230,4,1285,1,40
1117,155,2,231,6,1291,11,60
1118,155,2,232,5,1296,1,50
1119,155,2,233,2,1298,8,20
1120,155,2,234,2,1300,1,20
1121,155,2,235,3,1303,1,30
1122,155,2,236,5,1308,1,50
1123,155,2,237,8,1316,1,80
1124,155,2,238,9,1325,6,90
1125,155,2,239,5,1330,4,50
1126,155,2,240,8,1338,4,80
1127,155,2,241,3,1341,1,30
1128,155,2,242,7,1348,4,70
1129,155,2,243,9,1357,1,90
1130,155,2,244,6,1363,2,60
1131,155,2,245,3,1366,8,30
1132,155,2,246,2,1368,1,20
1133,155,2,247,7,1375,2,70
1134,155,2,248,3,1378,4,30
1135,155,2,249,7,1385,6,70
1136,155,2,250,8,1393,7,80
1137,155,2,251,5,1398,2,50
1138,155,2,252,6,1404,4,60
1139,155,2,253,6,1410,1,60
1140,155,2,254,6,1416,1,60
1141,155,2,255,8,1424,3,80
1142,155,2,256,6,1430,1,60
1143,155,2,257,8,1438,6,80
1144,155,2,258,6,1444,5,60
1145,155,2,259,5,1449,3,50
1146,155,2,260,4,1453,1,40
1147,155,2,261,6,1459,3,60
1148,155,2,262,8,1467,1,80
1149,155,2,263,5,1472,9,50
1150,155,2,264,2,1474,1,20
1151,155,2,265,9,1483,1,90
1152,155,2,266,6,1489,1,60
1153,155,2,267,4,1493,6,40
1154,155,2,268,5,1498,1,50
1155,155,2,269,3,1501,3,30
1156,155,2,270,4,1505,1,40
1157,155,2,271,9,1514,1,90
1158,155,2,272,6,1520,1,60
1159,155,2,273,4,1524,4,40
1160,155,2,274,8,1532,1,80
1161,155,2,275,5,1537,1,50
1162,155,2,276,8,1545,11,80
1163,155,2,277,3,1548,2,30
1164,155,2,278,7,1555,1,70
1165,155,2,279,6,1561,1,60
1166,155,2,280,9,1570,6,90
1167,155,2,281,4,1574,6,40
1168,155,2,282,9,1583,3,90
1169,155,2,283,7,1590,3,70
1170,155,2,284,9,1599,7,90
1171,155,2,285,5,1604,3,50
1172,155,2,286,8,1612,2,80
1173,155,2,287,8,1620,1,80
1174,155,2,288,8,1628,1,80
1175,155,2,289,6,1634,5,60
1176,155,2,290,3,1637,5,30
1177,155,2,291,3,1640,3,30
1178,155,2,292,5,1645,2,50
1179,155,2,293,6,1651,4,60
1180,155,2,294,3,1654,5,30
1181,155,2,295,5,1659,2,50
1182,155,2,296,6,1665,2,60
1183,155,2,297,5,1670,1,50
1184,155,2,298,4,1674,5,40
1185,155,2,299,9,1683,4,90
1186,155,2,300,8,1691,1,80
1187,155,2,301,4,1695,1,40
1188,155,2,302,6,1701,1,60
1189,155,2,303,5,1706,4,50
1190,155,2,304,7,1713,3,70
1191,155,2,305,5,1718,1,50
1192,155,2,306,9,1727,4,90
1193,155,2,307,4,1731,1,40
1194,155,2,308,5,1736,2,50
1195,155,2,309,3,1739,4,30
1196,155,2,310,9,1748,1,90
1197,155,2,311,4,1752,2,40
1198,155,2,312,3,1755,3,30
1199,155,2,313,2,1757,1,20
1200,155,2,314,9,1766,1,90
1201,155,2,315,3,1769,2,30
1202,155,2,316,2,1771,5,20
1203,155,2,317,2,1773,1,20
1204,155,2,318,5,1778,1,50
1205,155,2,319,2,1780,5,20
1206,155,2,320,5,1785,1,50
1207,155,2,321,7,1792,1,70
1208,155,2,322,6,1798,4,60
1209,155,2,323,7,1805,2,70
1210,155,2,324,8,1813,1,80
1211,155,2,325,8,1821,1,80
1212,155,2,326,8,1829,3,80
1213,155,2,327,4,1833,9,40
1214,155,2,328,9,1842,3,90
1215,155,2,329,9,1851,1,90
1216,155,2,330,8,1859,2,80
1217,155,2,331,3,1862,1,30
1218,155,2,332,8,1870,3,80
1219,155,2,333,4,1874,7,40
1220,155,2,334,8,1882,1,80
1221,155,2,335,9,1891,1,90
1222,155,2,336,6,1897,1,60
1223,155,2,337,9,1906,1,90
1224,155,2,338,2,1908,8,20
1225,155,2,339,7,1915,1,70
1226,155,2,340,3,1918,8,30
1227,155,2,341,9,1927,1,90
1228,155,2,342,7,1934,6,70
1229,155,2,343,2,1936,4,20
1230,155,2,344,7,1943,4,70
1231,155,2,345,7,1950,5,70
1232,155,2,346,7,1957,1,70
1233,155,2,347,8,1965,1,80
1234,155,2,348,4,1969,1,40
1235,155,2,349,7,1976,2,70
1236,155,2,350,9,1985,1,90
1237,155,2,351,2,1987,5,20
1238,155,2,352,4,1991,10,40
1239,155,2,353,9,2000,1,90
1240,155,2,354,4,2004,1,40
1241,155,2,355,9,2013,1,90
1242,155,2,356,4,2017,2,40
1243,155,2,357,7,2024,1,70
1244,155,2,358,6,2030,1,60
1245,155,2,359,3,2033,1,30
1246,155,2,360,7,2040,4,70
1247,155,2,361,9,2049,1,90
1248,155,2,362,7,2056,6,70
1249,155,2,363,3,2059,1,30
1250,155,2,364,3,2062,5,30
1251,155,2,365,6,2068,4,60
1252,155,2,366,7,2075,4,70
1253,155,2,367,5,2080,4,50
1254,155,2,368,2,2082,4,20
1255,155,2,369,6,2088,1,60
1256,155,2,370,9,2097,1,90
1257,155,2,371,4,2101,3,40
1258,155,2,372,4,2105,5,40
1259,155,2,373,6,2111,1,60
1260,155,2,374,6,2117,1,60
1261,155,2,375,2,2119,1,20
1262,155,2,376,3,2122,1,30
1263,155,2,377,8,2130,5,80
1264,155,2,378,5,2135,5,50
1265,155,2,379,4,2139,2,40
1266,155,2,380,9,2148,1,90
1267,155,2,381,6,2154,5,60
1268,155,2,382,7,2161,2,70
1269,155,2,383,2,2163,3,20
1270,155,2,384,6,2169,2,60
1271,155,2,385,2,2171,1,20
1272,155,2,386,8,2179,1,80
1273,155,2,387,5,2184,1,50
1274,155,2,388,3,2187,4,30
1275,155,2,389,9,2196,2,90
1276,155,2,390,7,2203,1,70
1277,155,2,391,8,2211,1,80
1278,155,2,392,3,2214,4,30
1279,155,2,393,8,2222,0,80
1280,155,2,394,3,2225,1,30
1281,155,2,395,7,2232,1,70
1282,155,2,396,5,2237,4,50
1283,155,2,397,8,2245,1,80
1284,155,2,398,6,2251,1,60
1285,155,2,399,3,2254,1,30
1286,155,2,400,9,2263,2,90
1287,155,2,401,6,2269,5,60
1288,155,2,402,8,2277,1,80
1289,155,2,403,7,2284,3,70
1290,155,2,404,8,2292,1,80
1291,155,2,405,5,2297,2,50
1292,155,2,406,5,2302,4,50
1293,155,2,407,7,2309,6,70
1294,155,2,408,7,2316,1,70
1295,155,2,409,3,2319,1,30
1296,155,2,410,9,2328,8,90
1297,155,2,411,3,2331,5,30
1298,155,2,412,2,2333,1,20
1299,155,2,413,3,2336,1,30
1300,155,2,414,4,2340,5,40
1301,155,2,415,2,2342,5,20
1302,155,2,416,2,2344,1,20
1303,155,2,417,9,2353,0,90
1304,155,2,418,9,2362,1,90
1305,155,2,419,6,2368,1,60
1306,155,2,420,9,2377,4,90
1307,155,2,421,3,2380,3,30
1308,155,2,422,2,2382,3,20
1309,155,2,423,8,2390,5,80
1310,155,2,424,8,2398,1,80
1311,155,2,425,9,2407,1,90
1312,155,2,426,3,2410,5,30
1313,155,2,427,4,2414,3,40
1314,155,2,428,4,2418,2,40
1315,155,2,429,6,2424,1,60
1316,155,2,430,3,2427,6,30
1317,155,2,431,4,2431,3,40
1318,155,2,432,7,2438,5,70
1319,155,2,433,5,2443,1,50
1320,155,2,434,4,2447,1,40
1321,155,2,435,3,2450,3,30
1322,155,2,436,7,2457,1,70
1323,155,2,437,4,2461,1,40
1324,155,2,438,5,2466,1,50
1325,155,2,439,9,2475,5,90
1326,155,2,440,4,2479,8,40
1327,155,2,441,3,2482,1,30
1328,155,2,442,3,2485,1,30
1329,155,2,443,8,2493,6,80
1330,155,2,444,9,2502,7,90
1331,155,2,445,2,2504,5,20
1332,155,2,446,7,2511,4,70
1333,155,2,447,8,2519,1,80
1334,155,2,448,5,2524,1,50
1335,155,2,449,2,2526,4,20
1336,155,2,450,3,2529,6,30
1337,155,2,451,6,2535,2,60
1338,155,2,452,6,2541,1,60
1339,155,2,453,4,2545,1,40
1340,155,2,454,9,2554,6,90
1341,155,2,455,6,2560,3,60
1342,155,2,456,3,2563,1,30
1343,155,2,457,6,2569,4,60
1344,155,2,458,2,2571,4,20
1345,155,2,459,8,2579,1,80
1346,155,2,460,9,2588,1,90
1347,155,2,461,5,2593,4,50
1348,155,2,462,4,2597,1,40
1349,155,2,463,7,2604,2,70
1350,155,2,464,5,2609,2,50
1351,155,2,465,4,2613,1,40
1352,155,2,466,8,2621,1,80
1353,155,2,467,6,2627,5,60
1354,155,2,468,2,2629,1,20
1355,155,2,469,2,2631,1,20
1356,155,2,470,3,2634,2,30
1357,155,2,471,9,2643,1,90
1358,155,2,472,3,2646,3,30
1359,155,2,473,5,2651,2,50
1360,155,2,474,9,2660,1,90
1361,155,2,475,4,2664,1,40
1362,155,2,476,6,2670,1,60
1363,155,2,477,2,2672,1,20
1364,155,2,478,7,2679,6,70
1365,155,2,479,2,2681,1,20
1366,155,2,480,3,2684,1,30
1367,155,2,481,2,2686,3,20
1368,155,2,482,4,2690,5,40
1369,155,2,483,9,2699,4,90
1370,155,2,484,4,2703,1,40
1371,155,2,485,8,2711,1,80
1372,155,2,486,4,2715,3,40
1373,155,2,487,9,2724,6,90
1374,155,2,488,9,2733,1,90
1375,155,2,489,4,2737,5,40
1376,155,2,490,9,2746,1,90
1377,155,2,491,7,2753,4,70
1378,155,2,492,2,2755,1,20
1379,155,2,493,7,2762,2,70
1380,155,2,494,8,2770,1,80
1381,155,2,495,3,2773,6,30
1382,155,2,496,6,2779,5,60
1383,155,2,497,8,2787,1,80
1384,155,2,498,9,2796,8,90
1385,155,2,499,7,2803,1,70
1386,155,2,500,7,2810,1,70
1387,155,2,501,2,2812,1,20
1388,155,2,502,5,2817,1,50
1389,155,2,503,3,2820,1,30
1390,155,2,504,4,2824,1,40
1391,155,2,505,9,2833,14,90
1392,155,2,506,7,2840,3,70
1393,155,2,507,4,2844,1,40
1394,155,2,508,8,2852,1,80
1395,155,2,509,7,2859,5,70
1396,155,2,510,3,2862,5,30
1397,155,2,511,2,2864,1,20
1398,155,2,512,3,2867,6,30
1399,155,2,513,6,2873,4,60
1400,155,2,514,5,2878,1,50
1401,155,2,515,9,2887,1,90
1402,155,2,516,3,2890,5,30
1403,155,2,517,5,2895,1,50
1404,155,2,518,5,2900,1,50
1405,155,2,519,7,2907,10,70
1406,155,2,520,7,2914,4,70
1407,155,2,521,8,2922,6,80
1408,155,2,522,7,2929,1,70
1409,155,2,523,7,2936,1,70
1410,155,2,524,4,2940,6,40
1411,155,2,525,3,2943,1,30
1412,155,2,526,5,2948,3,50
1413,155,2,527,5,2953,1,50
1414,155,2,528,5,2958,1,50
1415,155,2,529,7,2965,1,70
1416,155,2,530,3,2968,1,30
1417,155,2,531,2,2970,1,20
1418,155,2,532,7,2977,1,70
1419,155,2,533,3,2980,6,30
1420,155,2,534,8,2988,7,80
1421,155,2,535,9,2997,1,90
1422,155,2,536,6,3003,1,60
1423,155,2,537,3,3006,3,30
1424,155,2,538,6,3012,4,60
1425,155,2,539,2,3014,5,20
1426,155,2,540,3,3017,1,30
1427,155,2,541,3,3020,1,30
1428,155,2,542,5,3025,4,50
1429,155,2,543,9,3034,1,90
1430,155,2,544,6,3040,3,60
1431,155,2,545,5,3045,1,50
1432,155,2,546,2,3047,1,20
1433,155,2,547,9,3056,4,90
1434,155,2,548,2,3058,6,20
1435,155,2,549,7,3065,1,70
1436,155,2,550,5,3070,4,50
1437,155,2,551,3,3073,4,30
1438,155,2,552,8,3081,1,80
1439,155,2,553,2,3083,3,20
1440,155,2,554,5,3088,4,50
1441,155,2,555,8,3096,1,80
1442,155,2,556,5,3101,3,50
1443,155,2,557,4,3105,3,40
1444,155,2,558,8,3113,3,80
1445,155,2,559,6,3119,5,60
1446,155,2,560,8,3127,1,80
1447,155,2,561,9,3136,1,90
1448,155,2,562,4,3140,1,40
1449,155,2,563,6,3146,3,60
1450,155,2,564,3,3149,1,30
1451,155,2,565,5,3154,1,50
1452,155,2,566,4,3158,4,40
1453,155,2,567,2,3160,5,20
1454,155,2,568,9,3169,1,90
1455,155,2,569,9,3178,3,90
1456,155,2,570,9,3187,9,90
1457,155,2,571,8,3195,1,80
1458,155,2,572,4,3199,1,40
1459,155,2,573,5,3204,1,50
1460,155,2,574,5,3209,5,50
1461,155,2,575,8,3217,2,80
1462,155,2,576,3,3220,5,30
1463,155,2,577,9,3229,1,90
1464,155,2,578,8,3237,4,80
1465,155,2,579,4,3241,1,40
1466,155,2,580,6,3247,6,60
1467,155,2,581,7,3254,6,70
1468,155,2,582,7,3261,1,70
1469,155,2,583,8,3269,6,80
1470,155,2,584,5,3274,1,50
1471,155,2,585,2,3276,7,20
1472,155,2,586,4,3280,7,40
1473,155,2,587,2,3282,3,20
1474,155,2,588,4,3286,1,40
1475,155,2,589,4,3290,4,40
1476,155,2,590,8,3298,4,80
1477,155,2,591,7,3305,4,70
1478,155,2,592,7,3312,1,70
1479,155,2,593,4,3316,1,40
1480,155,2,594,6,3322,5,60
1481,155,2,595,4,3326,1,40
1482,155,2,596,3,3329,1,30
1483,155,2,597,2,3331,5,20
1484,155,2,598,7,3338,4,70
1485,155,2,599,8,3346,3,80
1486,155,2,600,5,3351,4,50
1487,155,2,601,8,3359,6,80
1488,155,2,602,3,3362,1,30
1489,155,2,603,9,3371,1,90
1490,155,2,604,3,3374,1,30
1491,155,2,605,7,3381,7,70
1492,155,2,606,2,3383,1,20
1493,155,2,607,7,3390,1,70
1494,155,2,608,5,3395,1,50
1495,155,2,609,8,3403,1,80
1496,155,2,610,7,3410,3,70
1497,155,2,611,4,3414,1,40
1498,155,2,612,4,3418,0,40
1499,155,2,613,5,3423,1,50
1500,155,2,614,8,3431,1,80
1501,155,2,615,7,3438,1,70
1502,155,2,616,9,3447,4,90
1503,155,2,617,4,3451,0,40
1504,155,2,618,9,3460,1,90
1505,155,2,619,6,3466,1,60
1506,155,2,620,2,3468,1,20
1507,155,2,621,3,3471,3,30
1508,155,2,622,5,3476,1,50
1509,155,2,623,6,3482,4,60
1510,155,2,624,9,3491,1,90
1511,155,2,625,7,3498,3,70
1512,155,2,626,8,3506,1,80
1513,155,2,627,5,3511,2,50
1514,155,2,628,5,3516,7,50
1515,155,2,629,2,3518,1,20
1516,155,2,630,9,3527,1,90
1517,155,2,631,8,3535,1,80
1518,155,2,632,7,3542,1,70
1519,155,2,633,7,3549,1,70
1520,155,2,634,7,3556,5,70
1521,155,2,635,3,3559,4,30
1522,155,2,636,2,3561,2,20
1523,155,2,637,2,3563,1,20
1524,155,2,638,3,3566,4,30
1525,155,2,639,6,3572,4,60
1526,155,2,640,4,3576,5,40
1527,155,2,641,8,3584,1,80
1528,155,2,642,8,3592,2,80
1529,155,2,643,5,3597,5,50
1530,155,2,644,2,3599,2,20
1531,155,2,645,5,3604,5,50
1532,155,2,646,4,3608,1,40
1533,155,2,647,2,3610,3,20
1534,155,2,648,9,3619,7,90
1535,155,2,649,7,3626,3,70
1536,155,2,650,4,3630,1,40
1537,155,2,651,2,3632,5,20
1538,155,2,652,7,3639,1,70
1539,155,2,653,7,3646,4,70
1540,155,2,654,9,3655,3,90
1541,155,2,655,8,3663,1,80
1542,155,2,656,3,3666,3,30
1543,155,2,657,4,3670,2,40
1544,155,2,658,7,3677,5,70
1545,155,2,659,6,3683,5,60
1546,155,2,660,5,3688,1,50
1547,155,2,661,8,3696,1,80
1548,155,2,662,9,3705,1,90
1549,155,2,663,3,3708,1,30
1550,155,2,664,3,3711,6,30
1551,155,2,665,3,3714,1,30
1552,155,2,666,6,3720,1,60
1553,155,2,667,2,3722,1,20
1554,155,2,668,8,3730,4,80
1555,155,2,669,3,3733,7,30
1556,155,2,670,6,3739,1,60
1557,155,2,671,3,3742,1,30
1558,155,2,672,8,3750,3,80
1559,155,2,673,4,3754,1,40
1560,155,2,674,7,3761,4,70
1561,155,2,675,6,3767,1,60
1562,155,2,676,3,3770,1,30
1563,155,2,677,2,3772,4,20
1564,155,2,678,8,3780,1,80
1565,155,2,679,3,3783,1,30
1566,155,2,680,4,3787,6,40
1567,155,2,681,5,3792,1,50
1568,155,2,682,4,3796,1,40
1569,155,2,683,8,3804,1,80
1570,155,2,684,8,3812,10,80
1571,155,2,685,5,3817,5,50
1572,155,2,686,4,3821,7,40
1573,155,2,687,5,3826,1,50
1574,155,2,688,8,3834,3,80
1575,155,2,689,9,3843,1,90
1576,155,2,690,7,3850,1,70
1577,155,2,691,2,3852,1,20
1578,155,2,692,6,3858,1,60
1579,155,2,693,4,3862,9,40
1580,155,2,694,2,3864,1,20
1581,155,2,695,4,3868,5,40
1582,155,2,696,9,3877,4,90
1583,155,2,697,8,3885,4,80
1584,155,2,698,4,3889,1,40
1585,155,2,699,6,3895,1,60
1586,155,2,700,7,3902,1,70
1587,155,2,701,3,3905,3,30
1588,155,2,702,3,3908,8,30
1589,155,2,703,8,3916,1,80
1590,155,2,704,3,3919,4,30
1591,155,2,705,4,3923,1,40
1592,155,2,706,7,3930,1,70
1593,155,2,707,3,3933,6,30
1594,155,2,708,4,3937,1,40
1595,155,2,709,3,3940,3,30
1596,155,2,710,8,3948,10,80
1597,155,2,711,6,3954,1,60
1598,155,2,712,9,3963,2,90
1599,155,2,713,7,3970,4,70
1600,155,2,714,7,3977,1,70
1601,155,2,715,7,3984,1,70
1602,155,2,716,4,3988,5,40
1603,155,2,717,2,3990,1,20
1604,155,2,718,2,3992,1,20
1605,155,2,719,6,3998,1,60
1606,155,2,720,7,4005,3,70
1607,155,2,721,8,4013,1,80
1608,155,2,722,2,4015,1,20
1609,155,2,723,5,4020,1,50
1610,155,2,724,2,4022,1,20
1611,155,2,725,7,4029,8,70
1612,155,2,726,9,4038,1,90
1613,155,2,727,9,4047,9,90
1614,155,2,728,5,4052,1,50
1615,155,2,729,9,4061,2,90
1616,155,2,730,8,4069,1,80
1617,155,2,731,7,4076,4,70
1618,155,2,732,6,4082,9,60
1619,155,2,733,7,4089,1,70
1620,155,2,734,7,4096,1,70
1621,155,2,735,4,4100,1,40
1622,155,2,736,2,4102,1,20
1623,155,2,737,2,4104,1,20
1624,155,2,738,3,4107,9,30
1625,155,2,739,6,4113,1,60
1626,155,2,740,3,4116,1,30
1627,155,2,741,6,4122,1,60
1628,155,2,742,5,4127,1,50
1629,155,2,743,5,4132,10,50
1630,155,2,744,2,4134,7,20
1631,155,2,745,7,4141,2,70
1632,155,2,746,9,4150,3,90
1633,155,2,747,3,4153,1,30
1634,155,2,748,6,4159,1,60
1635,155,2,749,6,4165,1,60
1636,155,2,750,4,4169,1,40
1637,155,2,751,3,4172,5,30
1638,155,2,752,3,4175,5,30
1639,155,2,753,2,4177,1,20
1640,155,2,754,5,4182,4,50
1641,155,2,755,8,4190,6,80
1642,155,2,756,3,4193,3,30
1643,155,2,757,8,4201,1,80
1644,155,2,758,8,4209,1,80
1645,155,2,759,9,4218,8,90
1646,155,2,760,2,4220,3,20
1647,155,2,761,9,4229,1,90
1648,155,2,762,7,4236,6,70
1649,155,2,763,9,4245,4,90
1650,155,2,764,2,4247,1,20
1651,155,2,765,7,4254,2,70
1652,155,2,766,9,4263,1,90
1653,155,2,767,4,4267,6,40
1654,155,2,768,5,4272,1,50
1655,155,2,769,9,4281,1,90
1656,155,2,770,3,4284,2,30
1657,155,2,771,4,4288,6,40
1658,155,2,772,3,4291,4,30
1659,155,2,773,8,4299,4,80
1660,155,2,774,7,4306,3,70
1661,155,2,775,2,4308,1,20
1662,155,2,776,6,4314,1,60
1663,155,2,777,6,4320,6,60
1664,155,2,778,9,4329,1,90
1665,155,2,779,4,4333,2,40
1666,155,2,780,9,4342,8,90
1667,155,2,781,5,4347,3,50
1668,155,2,782,4,4351,1,40
1669,155,2,783,2,4353,4,20
1670,155,2,784,3,4356,1,30
1671,155,2,785,4,4360,1,40
1672,155,2,786,8,4368,1,80
1673,155,2,787,2,4370,1,20
1674,155,2,788,9,4379,3,90
1675,155,2,789,5,4384,1,50
1676,155,2,790,3,4387,1,30
1677,155,2,791,4,4391,6,40
1678,155,2,792,9,4400,3,90
1679,155,2,793,8,4408,1,80
1680,155,2,794,9,4417,7,90
1681,155,2,795,9,4426,3,90
1682,155,2,796,6,4432,1,60
1683,155,2,797,5,4437,5,50
1684,155,2,798,7,4444,1,70
1685,155,2,799,5,4449,9,50
1686,155,2,800,9,4458,4,90
1687,155,2,801,3,4461,3,30
1688,155,2,802,5,4466,1,50
1689,155,2,803,9,4475,1,90
1690,155,2,804,4,4479,8,40
1691,155,2,805,6,4485,2,60
1692,155,2,806,5,4490,4,50
1693,155,2,807,3,4493,1,30
1694,155,2,808,2,4495,1,20
1695,155,2,809,8,4503,1,80
1696,155,2,810,3,4506,5,30
1697,155,2,811,2,4508,1,20
1698,155,2,812,7,4515,1,70
1699,155,2,813,5,4520,1,50
1700,155,2,814,2,4522,2,20
1701,155,2,815,2,4524,5,20
1702,155,2,816,8,4532,3,80
1703,155,2,817,3,4535,4,30
1704,155,2,818,9,4544,3,90
1705,155,2,819,2,4546,1,20
1706,155,2,820,6,4552,1,60
1707,155,2,821,2,4554,5,20
1708,155,2,822,9,4563,1,90
1709,155,2,823,8,4571,7,80
1710,155,2,824,3,4574,4,30
1711,155,2,825,9,4583,4,90
1712,155,2,826,2,4585,1,20
1713,155,2,827,2,4587,1,20
1714,155,2,828,8,4595,1,80
1715,155,2,829,8,4603,1,80
1716,155,2,830,6,4609,1,60
1717,155,2,831,6,4615,4,60
1718,155,2,832,6,4621,4,60
1719,155,2,833,6,4627,1,60
1720,155,2,834,7,4634,1,70
1721,155,2,835,3,4637,1,30
1722,155,2,836,6,4643,4,60
1723,155,2,837,5,4648,1,50
1724,155,2,838,4,4652,1,40
1725,155,2,839,2,4654,6,20
1726,155,2,840,4,4658,3,40
1727,155,2,841,5,4663,7,50
1728,155,2,842,2,4665,3,20
1729,155,2,843,3,4668,1,30
1730,155,2,844,6,4674,0,60
1731,155,2,845,3,4677,1,30
1732,155,2,846,4,4681,1,40
1733,155,2,847,9,4690,2,90
1734,155,2,848,3,4693,1,30
1735,155,2,849,9,4702,4,90
1736,155,2,850,3,4705,6,30
1737,155,2,851,4,4709,1,40
1738,155,2,852,7,4716,1,70
1739,155,2,853,5,4721,1,50
1740,155,2,854,5,4726,1,50
1741,155,2,855,7,4733,3,70
1742,155,2,856,4,4737,1,40
1743,155,2,857,7,4744,1,70
1744,155,2,858,5,4749,1,50
1745,155,2,859,2,4751,1,20
1746,155,2,860,3,4754,6,30
1747,155,2,861,8,4762,1,80
1748,155,2,862,9,4771,4,90
1749,155,2,863,6,4777,1,60
1750,155,2,864,2,4779,1,20
1751,155,2,865,2,4781,4,20
1752,155,2,866,5,4786,1,50
1753,155,2,867,4,4790,1,40
1754,155,2,868,4,4794,1,40
1755,155,2,869,2,4796,1,20
1756,155,2,870,6,4802,1,60
1757,155,2,871,4,4806,4,40
1758,155,2,872,9,4815,1,90
1759,155,2,873,6,4821,1,60
1760,155,2,874,5,4826,6,50
1761,155,2,875,4,4830,1,40
1762,155,2,876,6,4836,2,60
1763,155,2,877,7,4843,1,70
1764,155,2,878,2,4845,1,20
1765,155,2,879,2,4847,1,20
1766,155,2,880,6,4853,8,60
1767,155,2,881,9,4862,1,90
1768,155,2,882,8,4870,1,80
1769,155,2,883,5,4875,1,50
1770,155,2,884,4,4879,6,40
1771,155,2,885,6,4885,3,60
1772,155,2,886,2,4887,1,20
1773,155,2,887,9,4896,5,90
1774,155,2,888,3,4899,6,30
1775,155,2,889,2,4901,4,20
1776,155,2,890,8,4909,2,80
1777,155,2,891,5,4914,1,50
1778,155,2,892,6,4920,1,60
1779,155,2,893,4,4924,1,40
1780,155,2,894,4,4928,5,40
1781,155,2,895,2,4930,2,20
1782,155,2,896,6,4936,1,60
1783,155,2,897,8,4944,4,80
1784,155,2,898,2,4946,6,20
1785,155,2,899,8,4954,1,80
1786,155,2,900,8,4962,3,80
1787,155,2,901,6,4968,4,60
1788,155,2,902,3,4971,1,30
1789,155,2,903,9,4980,1,90
1790,155,2,904,8,4988,1,80
1791,155,2,905,9,4997,8,90
1792,155,3,1,4,4,1,40
1793,155,3,2,4,8,1,40
1794,155,3,3,5,13,1,50
1795,155,3,4,2,15,2,20
1796,155,3,5,8,23,1,80
1797,155,3,6,3,26,1,30
1798,155,3,7,4,30,1,40
1799,155,3,8,7,37,3,70
1800,155,3,9,3,40,1,30
1801,155,3,10,6,46,1,60
1802,155,3,11,6,52,2,60
1803,155,3,12,9,61,4,90
1804,155,3,13,4,65,3,40
1805,155,3,14,7,72,6,70
1806,155,3,15,6,78,4,60
1807,155,3,16,9,87,3,90
1808,155,3,17,5,92,0,50
1809,155,3,18,7,99,0,70
1810,155,3,19,7,106,1,70
1811,155,3,20,2,108,1,20
1812,155,3,21,2,110,1,20
1813,155,3,22,4,114,1,40
1814,155,3,23,4,118,1,40
1815,155,3,24,6,124,1,60
1816,155,3,25,7,131,9,70
1817,155,3,26,6,137,1,60
1818,155,3,27,9,146,1,90
1819,155,3,28,3,149,1,30
1820,155,3,29,5,154,6,50
1821,155,3,30,7,161,1,70
1822,155,3,31,4,165,5,40
1823,155,3,32,5,170,1,50
1824,155,3,33,8,178,1,80
1825,155,3,34,4,182,3,40
1826,155,3,35,8,190,7,80
1827,155,3,36,9,199,6,90
1828,155,3,37,9,208,2,90
1829,155,3,38,4,212,1,40
1830,155,3,39,6,218,1,60
1831,155,3,40,5,223,6,50
1832,155,3,41,2,225,1,20
1833,155,3,42,5,230,1,50
1834,155,3,43,4,234,6,40
1835,155,3,44,6,240,1,60
1836,155,3,45,6,246,5,60
1837,155,3,46,7,253,1,70
1838,155,3,47,7,260,3,70
1839,155,3,48,9,269,8,90
1840,155,3,49,8,277,1,80
1841,155,3,50,9,286,4,90
1842,155,3,51,5,291,1,50
1843,155,3,52,2,293,1,20
1844,155,3,53,4,297,1,40
1845,155,3,54,4,301,6,40
1846,155,3,55,6,307,5,60
1847,155,3,56,8,315,7,80
1848,155,3,57,8,323,5,80
1849,155,3,58,3,326,2,30
1850,155,3,59,9,335,1,90
1851,155,3,60,9,344,1,90
1852,155,3,61,2,346,1,20
1853,155,3,62,8,354,1,80
1854,155,3,63,4,358,3,40
1855,155,3,64,8,366,3,80
1856,155,3,65,3,369,1,30
1857,155,3,66,4,373,4,40
1858,155,3,67,4,377,1,40
1859,155,3,68,2,379,1,20
1860,155,3,69,9,388,1,90
1861,155,3,70,5,393,7,50
1862,155,3,71,6,399,3,60
1863,155,3,72,2,401,3,20
1864,155,3,73,4,405,6,40
1865,155,3,74,7,412,1,70
1866,155,3,75,3,415,4,30
1867,155,3,76,6,421,3,60
1868,155,3,77,3,424,1,30
1869,155,3,78,3,427,1,30
1870,155,3,79,7,434,5,70
1871,155,3,80,4,438,7,40
1872,155,3,81,2,440,1,20
1873,155,3,82,3,443,1,30
1874,155,3,83,2,445,4,20
1875,155,3,84,8,453,1,80
1876,155,3,85,4,457,5,40
1877,155,3,86,8,465,1,80
1878,155,3,87,4,469,4,40
1879,155,3,88,7,476,4,70
1880,155,3,89,3,479,2,30
1881,155,3,90,7,486,5,70
1882,155,3,91,8,494,1,80
1883,155,3,92,4,498,1,40
1884,155,3,93,9,507,1,90
1885,155,3,94,7,514,5,70
1886,155,3,95,2,516,2,20
1887,155,3,96,2,518,5,20
1888,155,3,97,4,522,1,40
1889,155,3,98,5,527,1,50
1890,155,3,99,5,532,3,50
1891,155,3,100,9,541,6,90
1892,155,3,101,7,548,3,70
1893,155,3,102,3,551,4,30
1894,155,3,103,8,559,1,80
1895,155,3,104,8,567,1,80
1896,155,3,105,5,572,1,50
1897,155,3,106,6,578,2,60
1898,155,3,107,8,586,1,80
1899,155,3,108,6,592,1,60
1900,155,3,109,8,600,1,80
1901,155,3,110,7,607,1,70
1902,155,3,111,9,616,1,90
1903,155,3,112,9,625,1,90
1904,155,3,113,6,631,7,60
1905,155,3,114,7,638,3,70
1906,155,3,115,7,645,1,70
1907,155,3,116,7,652,4,70
1908,155,3,117,9,661,6,90
1909,155,3,118,5,666,12,50
1910,155,3,119,8,674,3,80
1911,155,3,120,4,678,2,40
1912,155,3,121,5,683,1,50
1913,155,3,122,2,685,5,20
1914,155,3,123,9,694,1,90
1915,155,3,124,5,699,6,50
1916,155,3,125,2,701,5,20
1917,155,3,126,5,706,1,50
1918,155,3,127,9,715,1,90
1919,155,3,128,6,721,1,60
1920,155,3,129,4,725,8,40
1921,155,3,130,7,732,4,70
1922,155,3,131,4,736,1,40
1923,155,3,132,6,742,5,60
1924,155,3,133,7,749,1,70
1925,155,3,134,9,758,1,90
1926,155,3,135,4,762,1,40
1927,155,3,136,4,766,1,40
1928,155,3,137,6,772,5,60
1929,155,3,138,4,776,5,40
1930,155,3,139,5,781,1,50
1931,155,3,140,2,783,1,20
1932,155,3,141,6,789,2,60
1933,155,3,142,7,796,1,70
1934,155,3,143,2,798,7,20
1935,155,3,144,8,806,1,80
1936,155,3,145,4,810,6,40
1937,155,3,146,2,812,5,20
1938,155,3,147,9,821,3,90
1939,155,3,148,9,830,1,90
1940,155,3,149,4,834,1,40
1941,155,3,150,4,838,1,40
1942,155,3,151,4,842,5,40
1943,155,3,152,5,847,5,50
1944,155,3,153,3,850,5,30
1945,155,3,154,3,853,7,30
1946,155,3,155,6,859,1,60
1947,155,3,156,7,866,5,70
1948,155,3,157,7,873,1,70
1949,155,3,158,8,881,1,80
1950,155,3,159,8,889,7,80
1951,155,3,160,8,897,1,80
1952,155,3,161,7,904,1,70
1953,155,3,162,3,907,4,30
1954,155,3,163,8,915,1,80
1955,155,3,164,7,922,1,70
1956,155,3,165,7,929,2,70
1957,155,3,166,7,936,5,70
1958,155,3,167,9,945,2,90
1959,155,3,168,4,949,1,40
1960,155,3,169,4,953,4,40
1961,155,3,170,3,956,1,30
1962,155,3,171,5,961,3,50
1963,155,3,172,7,968,4,70
1964,155,3,173,5,973,2,50
1965,155,3,174,5,978,4,50
1966,155,3,175,9,987,1,90
1967,155,3,176,4,991,8,40
1968,155,3,177,3,994,1,30
1969,155,3,178,3,997,1,30
1970,155,3,179,5,1002,5,50
1971,155,3,180,6,1008,1,60
1972,155,3,181,9,1017,1,90
1973,155,3,182,4,1021,4,40
1974,155,3,183,4,1025,1,40
1975,155,3,184,9,1034,1,90
1976,155,3,185,8,1042,1,80
1977,155,3,186,4,1046,3,40
1978,155,3,187,3,1049,1,30
1979,155,3,188,7,1056,1,70
1980,155,3,189,9,1065,3,90
1981,155,3,190,3,1068,1,30
1982,155,3,191,7,1075,2,70
1983,155,3,192,2,1077,4,20
1984,155,3,193,4,1081,1,40
1985,155,3,194,5,1086,5,50
1986,155,3,195,4,1090,1,40
1987,155,3,196,7,1097,5,70
1988,155,3,197,3,1100,1,30
1989,155,3,198,3,1103,8,30
1990,155,3,199,2,1105,4,20
1991,155,3,200,6,1111,1,60
1992,155,3,201,9,1120,1,90
1993,155,3,202,2,1122,2,20
1994,155,3,203,4,1126,4,40
1995,155,3,204,2,1128,5,20
1996,155,3,205,7,1135,1,70
1997,155,3,206,3,1138,1,30
1998,155,3,207,2,1140,3,20
1999,155,3,208,7,1147,2,70
2000,155,3,209,7,1154,5,70
2001,155,3,210,2,1156,1,20
2002,155,3,211,5,1161,1,50
2003,155,3,212,8,1169,3,80
2004,155,3,213,3,1172,2,30
2005,155,3,214,2,1174,1,20
2006,155,3,215,2,1176,1,20
2007,155,3,216,8,1184,2,80
2008,155,3,217,5,1189,1,50
2009,155,3,218,7,1196,5,70
2010,155,3,219,6,1202,3,60
2011,155,3,220,8,1210,1,80
2012,155,3,221,2,1212,0,20
2013,155,3,222,9,1221,1,90
2014,155,3,223,8,1229,1,80
2015,155,3,224,5,1234,1,50
2016,155,3,225,2,1236,5,20
2017,155,3,226,8,1244,3,80
2018,155,3,227,9,1253,6,90
2019,155,3,228,6,1259,1,60
2020,155,3,229,5,1264,1,50
2021,155,3,230,6,1270,8,60
2022,155,3,231,4,1274,1,40
2023,155,3,232,3,1277,1,30
2024,155,3,233,6,1283,4,60
2025,155,3,234,3,1286,4,30
2026,155,3,235,3,1289,1,30
2027,155,3,236,4,1293,1,40
2028,155,3,237,2,1295,3,20
2029,155,3,238,2,1297,1,20
2030,155,3,239,3,1300,6,30
2031,155,3,240,8,1308,4,80
2032,155,3,241,8,1316,5,80
2033,155,3,242,3,1319,4,30
2034,155,3,243,4,1323,2,40
2035,155,3,244,9,1332,3,90
2036,155,3,245,3,1335,1,30
2037,155,3,246,9,1344,5,90
2038,155,3,247,6,1350,1,60
2039,155,3,248,9,1359,2,90
2040,155,3,249,9,1368,3,90
2041,155,3,250,2,1370,4,20
2042,155,3,251,3,1373,8,30
2043,155,3,252,9,1382,1,90
2044,155,3,253,4,1386,7,40
2045,155,3,254,9,1395,3,90
2046,155,3,255,2,1397,0,20
2047,155,3,256,5,1402,2,50
2048,155,3,257,4,1406,1,40
2049,155,3,258,7,1413,6,70
2050,155,3,259,6,1419,1,60
2051,155,3,260,4,1423,4,40
2052,155,3,261,3,1426,8,30
2053,155,3,262,4,1430,1,40
2054,155,3,263,2,1432,2,20
2055,155,3,264,7,1439,3,70
2056,155,3,265,5,1444,3,50
2057,155,3,266,6,1450,2,60
2058,155,3,267,6,1456,5,60
2059,155,3,268,8,1464,5,80
2060,155,3,269,7,1471,3,70
2061,155,3,270,4,1475,2,40
2062,155,3,271,7,1482,2,70
2063,155,3,272,2,1484,5,20
2064,155,3,273,3,1487,1,30
2065,155,3,274,9,1496,1,90
2066,155,3,275,2,1498,1,20
2067,155,3,276,9,1507,1,90
2068,155,3,277,5,1512,3,50
2069,155,3,278,3,1515,1,30
2070,155,3,279,6,1521,1,60
2071,155,3,280,2,1523,3,20
2072,155,3,281,7,1530,1,70
2073,155,3,282,5,1535,0,50
2074,155,3,283,9,1544,1,90
2075,155,3,284,3,1547,1,30
2076,155,3,285,3,1550,4,30
2077,155,3,286,4,1554,2,40
2078,155,3,287,2,1556,1,20
2079,155,3,288,2,1558,1,20
2080,155,3,289,6,1564,7,60
2081,155,3,290,3,1567,1,30
2082,155,3,291,9,1576,3,90
2083,155,3,292,9,1585,5,90
2084,155,3,293,7,1592,3,70
2085,155,3,294,6,1598,6,60
2086,155,3,295,6,1604,3,60
2087,155,3,296,9,1613,3,90
2088,155,3,297,4,1617,1,40
2089,155,3,298,4,1621,1,40
2090,155,3,299,4,1625,7,40
2091,155,3,300,2,1627,1,20
2092,155,3,301,2,1629,5,20
2093,155,3,302,5,1634,1,50
2094,155,3,303,2,1636,6,20
2095,155,3,304,6,1642,1,60
2096,155,3,305,8,1650,1,80
2097,155,3,306,5,1655,3,50
2098,155,3,307,2,1657,1,20
2099,155,3,308,6,1663,1,60
2100,155,3,309,6,1669,3,60
2101,155,3,310,9,1678,1,90
2102,155,3,311,9,1687,1,90
2103,155,3,312,8,1695,6,80
2104,155,3,313,7,1702,1,70
2105,155,3,314,5,1707,4,50
2106,155,3,315,2,1709,6,20
2107,155,3,316,9,1718,1,90
2108,155,3,317,8,1726,1,80
2109,155,3,318,8,1734,1,80
2110,155,3,319,8,1742,1,80
2111,155,3,320,7,1749,12,70
2112,155,3,321,9,1758,10,90
2113,155,3,322,5,1763,8,50
2114,155,3,323,8,1771,1,80
2115,155,3,324,5,1776,13,50
2116,155,3,325,2,1778,1,20
2117,155,3,326,6,1784,1,60
2118,155,3,327,5,1789,7,50
2119,155,3,328,2,1791,2,20
2120,155,3,329,2,1793,2,20
2121,155,3,330,6,1799,1,60
2122,155,3,331,4,1803,1,40
2123,155,3,332,6,1809,1,60
2124,155,3,333,9,1818,1,90
2125,155,3,334,2,1820,6,20
2126,155,3,335,7,1827,7,70
2127,155,3,336,4,1831,6,40
2128,155,3,337,6,1837,1,60
2129,155,3,338,2,1839,3,20
2130,155,3,339,7,1846,4,70
2131,155,3,340,9,1855,1,90
2132,155,3,341,3,1858,4,30
2133,155,3,342,7,1865,1,70
2134,155,3,343,3,1868,3,30
2135,155,3,344,2,1870,4,20
2136,155,3,345,7,1877,1,70
2137,155,3,346,6,1883,1,60
2138,155,3,347,4,1887,2,40
2139,155,3,348,4,1891,1,40
2140,155,3,349,4,1895,1,40
2141,155,3,350,2,1897,1,20
2142,155,3,351,6,1903,1,60
2143,155,3,352,6,1909,1,60
2144,155,3,353,2,1911,0,20
2145,155,3,354,6,1917,2,60
2146,155,3,355,7,1924,2,70
2147,155,3,356,8,1932,3,80
2148,155,3,357,8,1940,1,80
2149,155,3,358,3,1943,4,30
2150,155,3,359,4,1947,6,40
2151,155,3,360,4,1951,2,40
2152,155,3,361,3,1954,1,30
2153,155,3,362,8,1962,1,80
2154,155,3,363,2,1964,4,20
2155,155,3,364,5,1969,3,50
2156,155,3,365,3,1972,3,30
2157,155,3,366,9,1981,1,90
2158,155,3,367,5,1986,3,50
2159,155,3,368,5,1991,1,50
2160,155,3,369,6,1997,2,60
2161,155,3,370,2,1999,1,20
2162,155,3,371,9,2008,1,90
2163,155,3,372,3,2011,1,30
2164,155,3,373,5,2016,1,50
2165,155,3,374,5,2021,5,50
2166,155,3,375,5,2026,5,50
2167,155,3,376,7,2033,1,70
2168,155,3,377,5,2038,1,50
2169,155,3,378,4,2042,4,40
2170,155,3,379,9,2051,2,90
2171,155,3,380,2,2053,3,20
2172,155,3,381,8,2061,1,80
2173,155,3,382,2,2063,2,20
2174,155,3,383,5,2068,1,50
2175,155,3,384,4,2072,1,40
2176,155,3,385,8,2080,2,80
2177,155,3,386,5,2085,1,50
2178,155,3,387,8,2093,5,80
2179,155,3,388,3,2096,1,30
2180,155,3,389,8,2104,3,80
2181,155,3,390,2,2106,0,20
2182,155,3,391,2,2108,1,20
2183,155,3,392,5,2113,5,50
2184,155,3,393,4,2117,1,40
2185,155,3,394,5,2122,1,50
2186,155,3,395,3,2125,3,30
2187,155,3,396,8,2133,1,80
2188,155,3,397,6,2139,10,60
2189,155,3,398,8,2147,1,80
2190,155,3,399,4,2151,1,40
2191,155,3,400,8,2159,7,80
2192,155,3,401,7,2166,1,70
2193,155,3,402,5,2171,1,50
2194,155,3,403,6,2177,5,60
2195,155,3,404,9,2186,1,90
2196,155,3,405,3,2189,1,30
2197,155,3,406,2,2191,1,20
2198,155,3,407,5,2196,1,50
2199,155,3,408,6,2202,1,60
2200,155,3,409,6,2208,1,60
2201,155,3,410,9,2217,1,90
2202,155,3,411,9,2226,6,90
2203,155,3,412,4,2230,7,40
2204,155,3,413,7,2237,1,70
2205,155,3,414,5,2242,1,50
2206,155,3,415,5,2247,9,50
2207,155,3,416,5,2252,1,50
2208,155,3,417,6,2258,1,60
2209,155,3,418,5,2263,4,50
2210,155,3,419,4,2267,2,40
2211,155,3,420,8,2275,4,80
2212,155,3,421,7,2282,5,70
2213,155,3,422,3,2285,5,30
2214,155,3,423,6,2291,6,60
2215,155,3,424,5,2296,1,50
2216,155,3,425,4,2300,1,40
2217,155,3,426,6,2306,1,60
2218,155,3,427,2,2308,4,20
2219,155,3,428,7,2315,1,70
2220,155,3,429,2,2317,6,20
2221,155,3,430,6,2323,4,60
2222,155,3,431,2,2325,3,20
2223,155,3,432,8,2333,1,80
2224,155,3,433,8,2341,1,80
2225,155,3,434,6,2347,5,60
2226,155,3,435,6,2353,3,60
2227,155,3,436,2,2355,1,20
2228,155,3,437,8,2363,1,80
2229,155,3,438,5,2368,8,50
2230,155,3,439,2,2370,1,20
2231,155,3,440,8,2378,2,80
2232,155,3,441,9,2387,1,90
2233,155,3,442,4,2391,4,40
2234,155,3,443,4,2395,1,40
2235,155,3,444,9,2404,1,90
2236,155,3,445,5,2409,1,50
2237,155,3,446,7,2416,1,70
2238,155,3,447,4,2420,4,40
2239,155,3,448,2,2422,5,20
2240,155,3,449,3,2425,4,30
2241,155,3,450,7,2432,1,70
2242,155,3,451,7,2439,5,70
2243,155,3,452,5,2444,1,50
2244,155,3,453,6,2450,4,60
2245,155,3,454,3,2453,4,30
2246,155,3,455,8,2461,1,80
2247,155,3,456,4,2465,1,40
2248,155,3,457,3,2468,1,30
2249,155,3,458,2,2470,8,20
2250,155,3,459,9,2479,2,90
2251,155,3,460,3,2482,1,30
2252,155,3,461,4,2486,1,40
2253,155,3,462,9,2495,1,90
2254,155,3,463,4,2499,6,40
2255,155,3,464,4,2503,1,40
2256,155,3,465,9,2512,3,90
2257,155,3,466,6,2518,3,60
2258,155,3,467,5,2523,3,50
2259,155,3,468,3,2526,1,30
2260,155,3,469,9,2535,1,90
2261,155,3,470,6,2541,1,60
2262,155,3,471,7,2548,9,70
2263,155,3,472,2,2550,1,20
2264,155,3,473,8,2558,5,80
2265,155,3,474,8,2566,4,80
2266,155,3,475,6,2572,2,60
2267,155,3,476,5,2577,3,50
2268,155,3,477,6,2583,9,60
2269,155,3,478,7,2590,3,70
2270,155,3,479,3,2593,4,30
2271,155,3,480,9,2602,1,90
2272,155,3,481,2,2604,3,20
2273,155,3,482,6,2610,1,60
2274,155,3,483,7,2617,3,70
2275,155,3,484,2,2619,1,20
2276,155,3,485,5,2624,1,50
2277,155,3,486,4,2628,7,40
2278,155,3,487,5,2633,1,50
2279,155,3,488,5,2638,5,50
2280,155,3,489,5,2643,2,50
2281,155,3,490,6,2649,7,60
2282,155,3,491,6,2655,1,60
2283,155,3,492,3,2658,1,30
2284,155,3,493,4,2662,1,40
2285,155,3,494,9,2671,1,90
2286,155,3,495,7,2678,1,70
2287,155,3,496,8,2686,1,80
2288,155,3,497,8,2694,2,80
2289,155,3,498,8,2702,3,80
2290,155,3,499,9,2711,4,90
2291,155,3,500,8,2719,1,80
2292,155,3,501,5,2724,6,50
2293,155,3,502,3,2727,2,30
2294,155,3,503,3,2730,8,30
2295,155,3,504,6,2736,6,60
2296,155,3,505,4,2740,1,40
2297,155,3,506,5,2745,6,50
2298,155,3,507,9,2754,2,90
2299,155,3,508,4,2758,1,40
2300,155,3,509,9,2767,1,90
2301,155,3,510,3,2770,1,30
2302,155,3,511,5,2775,6,50
2303,155,3,512,3,2778,5,30
2304,155,3,513,7,2785,1,70
2305,155,3,514,5,2790,1,50
2306,155,3,515,4,2794,4,40
2307,155,3,516,8,2802,1,80
2308,155,3,517,7,2809,1,70
2309,155,3,518,7,2816,4,70
2310,155,3,519,4,2820,3,40
2311,155,3,520,9,2829,3,90
2312,155,3,521,9,2838,1,90
2313,155,3,522,3,2841,0,30
2314,155,3,523,7,2848,6,70
2315,155,3,524,6,2854,6,60
2316,155,3,525,7,2861,4,70
2317,155,3,526,6,2867,1,60
2318,155,3,527,9,2876,5,90
2319,155,3,528,5,2881,5,50
2320,155,3,529,2,2883,1,20
2321,155,3,530,6,2889,5,60
2322,155,3,531,5,2894,1,50
2323,155,3,532,7,2901,1,70
2324,155,3,533,7,2908,1,70
2325,155,3,534,4,2912,1,40
2326,155,3,535,3,2915,4,30
2327,155,3,536,7,2922,0,70
2328,155,3,537,8,2930,1,80
2329,155,3,538,2,2932,4,20
2330,155,3,539,8,2940,4,80
2331,155,3,540,4,2944,1,40
2332,155,3,541,3,2947,4,30
2333,155,3,542,8,2955,1,80
2334,155,3,543,3,2958,8,30
2335,155,3,544,3,2961,1,30
2336,155,3,545,5,2966,3,50
2337,155,3,546,2,2968,1,20
2338,155,3,547,2,2970,5,20
2339,155,3,548,4,2974,5,40
2340,155,3,549,6,2980,4,60
2341,155,3,550,4,2984,4,40
2342,155,3,551,4,2988,1,40
2343,155,3,552,9,2997,1,90
2344,155,3,553,7,3004,0,70
2345,155,3,554,8,3012,5,80
2346,155,3,555,9,3021,3,90
2347,155,3,556,3,3024,4,30
2348,155,3,557,7,3031,1,70
2349,155,3,558,5,3036,1,50
2350,155,3,559,7,3043,6,70
2351,155,3,560,4,3047,4,40
2352,155,3,561,2,3049,6,20
2353,155,3,562,2,3051,1,20
2354,155,3,563,4,3055,1,40
2355,155,3,564,2,3057,4,20
2356,155,3,565,5,3062,0,50
2357,155,3,566,2,3064,1,20
2358,155,3,567,6,3070,2,60
2359,155,3,568,4,3074,1,40
2360,155,3,569,9,3083,2,90
2361,155,3,570,3,3086,0,30
2362,155,3,571,8,3094,2,80
2363,155,3,572,7,3101,1,70
2364,155,3,573,7,3108,1,70
2365,155,3,574,4,3112,1,40
2366,155,3,575,2,3114,6,20
2367,155,3,576,2,3116,4,20
2368,155,3,577,5,3121,3,50
2369,155,3,578,4,3125,4,40
2370,155,3,579,9,3134,2,90
2371,155,3,580,5,3139,1,50
2372,155,3,581,4,3143,2,40
2373,155,3,582,4,3147,1,40
2374,155,3,583,2,3149,5,20
2375,155,3,584,2,3151,1,20
2376,155,3,585,7,3158,4,70
2377,155,3,586,2,3160,1,20
2378,155,3,587,8,3168,3,80
2379,155,3,588,9,3177,1,90
2380,155,3,589,5,3182,1,50
2381,155,3,590,7,3189,3,70
2382,155,3,591,3,3192,5,30
2383,155,3,592,5,3197,5,50
2384,155,3,593,7,3204,1,70
2385,155,3,594,5,3209,4,50
2386,155,3,595,3,3212,2,30
2387,155,3,596,7,3219,5,70
2388,155,3,597,7,3226,1,70
2389,155,3,598,3,3229,2,30
2390,155,3,599,8,3237,3,80
2391,155,3,600,4,3241,2,40
2392,155,3,601,3,3244,4,30
2393,155,3,602,9,3253,3,90
2394,155,3,603,5,3258,1,50
2395,155,3,604,4,3262,4,40
2396,155,3,605,8,3270,1,80
2397,155,3,606,9,3279,1,90
2398,155,3,607,9,3288,1,90
2399,155,3,608,8,3296,5,80
2400,155,3,609,6,3302,1,60
2401,155,3,610,5,3307,5,50
2402,155,3,611,7,3314,3,70
2403,155,3,612,8,3322,1,80
2404,155,3,613,5,3327,1,50
2405,155,3,614,4,3331,1,40
2406,155,3,615,5,3336,5,50
2407,155,3,616,9,3345,2,90
2408,155,3,617,3,3348,4,30
2409,155,3,618,3,3351,1,30
2410,155,3,619,8,3359,5,80
2411,155,3,620,2,3361,1,20
2412,155,3,621,3,3364,1,30
2413,155,3,622,8,3372,1,80
2414,155,3,623,6,3378,4,60
2415,155,3,624,8,3386,1,80
2416,155,3,625,3,3389,6,30
2417,155,3,626,3,3392,3,30
2418,155,3,627,8,3400,1,80
2419,155,3,628,2,3402,9,20
2420,155,3,629,4,3406,3,40
2421,155,3,630,3,3409,3,30
2422,155,3,631,2,3411,5,20
2423,155,3,632,8,3419,3,80
2424,155,3,633,4,3423,4,40
2425,155,3,634,2,3425,8,20
2426,155,3,635,4,3429,3,40
2427,155,3,636,3,3432,1,30
2428,155,3,637,9,3441,1,90
2429,155,3,638,5,3446,3,50
2430,155,3,639,7,3453,5,70
2431,155,3,640,3,3456,1,30
2432,155,3,641,6,3462,5,60
2433,155,3,642,2,3464,8,20
2434,155,3,643,7,3471,5,70
2435,155,3,644,2,3473,1,20
2436,155,3,645,2,3475,2,20
2437,155,3,646,2,3477,3,20
2438,155,3,647,7,3484,1,70
2439,155,3,648,4,3488,3,40
2440,155,3,649,3,3491,1,30
2441,155,3,650,8,3499,5,80
2442,155,3,651,4,3503,1,40
2443,155,3,652,7,3510,1,70
2444,155,3,653,3,3513,1,30
2445,155,3,654,4,3517,0,40
2446,155,3,655,8,3525,3,80
2447,155,3,656,3,3528,2,30
2448,155,3,657,2,3530,1,20
2449,155,3,658,6,3536,1,60
2450,155,3,659,6,3542,3,60
2451,155,3,660,6,3548,7,60
2452,155,3,661,7,3555,1,70
2453,155,3,662,5,3560,1,50
2454,155,3,663,5,3565,1,50
2455,155,3,664,4,3569,5,40
2456,155,3,665,4,3573,1,40
2457,155,3,666,4,3577,8,40
2458,155,3,667,9,3586,3,90
2459,155,3,668,7,3593,3,70
2460,155,3,669,6,3599,3,60
2461,155,3,670,7,3606,1,70
2462,155,3,671,7,3613,1,70
2463,155,3,672,9,3622,5,90
2464,155,3,673,4,3626,4,40
2465,155,3,674,3,3629,1,30
2466,155,3,675,4,3633,1,40
2467,155,3,676,2,3635,1,20
2468,155,3,677,2,3637,2,20
2469,155,3,678,9,3646,2,90
2470,155,3,679,4,3650,1,40
2471,155,3,680,2,3652,4,20
2472,155,3,681,5,3657,1,50
2473,155,3,682,9,3666,2,90
2474,155,3,683,3,3669,1,30
2475,155,3,684,6,3675,5,60
2476,155,3,685,9,3684,1,90
2477,155,3,686,4,3688,1,40
2478,155,3,687,8,3696,1,80
2479,155,3,688,6,3702,1,60
2480,155,3,689,7,3709,3,70
2481,155,3,690,6,3715,8,60
2482,155,3,691,5,3720,1,50
2483,155,3,692,9,3729,1,90
2484,155,3,693,8,3737,6,80
2485,155,3,694,8,3745,1,80
2486,155,3,695,8,3753,6,80
2487,155,3,696,2,3755,5,20
2488,155,3,697,4,3759,4,40
2489,155,3,698,8,3767,1,80
2490,155,3,699,2,3769,1,20
2491,155,3,700,6,3775,1,60
2492,155,3,701,7,3782,1,70
2493,155,3,702,5,3787,1,50
2494,155,3,703,4,3791,2,40
2495,155,3,704,2,3793,6,20
2496,155,3,705,2,3795,1,20
2497,155,3,706,4,3799,0,40
2498,155,3,707,5,3804,6,50
2499,155,3,708,3,3807,1,30
2500,155,3,709,3,3810,1,30
2501,155,3,710,8,3818,2,80
2502,155,3,711,7,3825,3,70
2503,155,3,712,5,3830,0,50
2504,155,3,713,6,3836,1,60
2505,155,3,714,2,3838,1,20
2506,155,3,715,6,3844,3,60
2507,155,3,716,2,3846,2,20
2508,155,3,717,5,3851,1,50
2509,155,3,718,6,3857,1,60
2510,155,3,719,3,3860,1,30
2511,155,3,720,5,3865,1,50
2512,155,3,721,3,3868,1,30
2513,155,3,722,6,3874,4,60
2514,155,3,723,6,3880,1,60
2515,155,3,724,7,3887,3,70
2516,155,3,725,7,3894,1,70
2517,155,3,726,8,3902,4,80
2518,155,3,727,3,3905,1,30
2519,155,3,728,7,3912,1,70
2520,155,3,729,4,3916,4,40
2521,155,3,730,9,3925,5,90
2522,155,3,731,2,3927,3,20
2523,155,3,732,2,3929,7,20
2524,155,3,733,3,3932,1,30
2525,155,3,734,5,3937,6,50
2526,155,3,735,4,3941,1,40
2527,155,3,736,7,3948,7,70
2528,155,3,737,7,3955,1,70
2529,155,3,738,6,3961,5,60
2530,155,3,739,4,3965,1,40
2531,155,3,740,2,3967,5,20
2532,155,3,741,3,3970,1,30
2533,155,3,742,2,3972,4,20
2534,155,3,743,6,3978,3,60
2535,155,3,744,8,3986,1,80
2536,155,3,745,9,3995,1,90
2537,155,3,746,2,3997,1,20
2538,155,3,747,2,3999,3,20
2539,155,3,748,7,4006,4,70
2540,155,3,749,7,4013,1,70
2541,155,3,750,9,4022,5,90
2542,155,3,751,6,4028,1,60
2543,155,3,752,4,4032,4,40
2544,155,3,753,9,4041,1,90
2545,155,3,754,3,4044,1,30
2546,155,3,755,2,4046,4,20
2547,155,3,756,7,4053,6,70
2548,155,3,757,8,4061,2,80
2549,155,3,758,3,4064,1,30
2550,155,3,759,8,4072,6,80
2551,155,3,760,5,4077,1,50
2552,155,3,761,3,4080,4,30
2553,155,3,762,7,4087,5,70
2554,155,3,763,3,4090,1,30
2555,155,3,764,2,4092,4,20
2556,155,3,765,5,4097,0,50
2557,155,3,766,9,4106,1,90
2558,155,3,767,9,4115,1,90
2559,155,3,768,8,4123,1,80
2560,155,3,769,3,4126,2,30
2561,155,3,770,3,4129,1,30
2562,155,3,771,3,4132,1,30
2563,155,3,772,2,4134,1,20
2564,155,3,773,4,4138,3,40
2565,155,3,774,3,4141,1,30
2566,155,3,775,4,4145,1,40
2567,155,3,776,4,4149,5,40
2568,155,3,777,9,4158,1,90
2569,155,3,778,9,4167,5,90
2570,155,3,779,4,4171,4,40
2571,155,3,780,8,4179,1,80
2572,155,3,781,5,4184,4,50
2573,155,3,782,6,4190,1,60
2574,155,3,783,5,4195,6,50
2575,155,3,784,5,4200,1,50
2576,155,3,785,9,4209,1,90
2577,155,3,786,7,4216,1,70
2578,155,3,787,2,4218,1,20
2579,155,3,788,7,4225,1,70
2580,155,3,789,6,4231,1,60
2581,155,3,790,5,4236,1,50
2582,155,3,791,4,4240,4,40
2583,155,3,792,6,4246,5,60
2584,155,3,793,2,4248,4,20
2585,155,3,794,7,4255,1,70
2586,155,3,795,5,4260,2,50
2587,155,3,796,5,4265,1,50
2588,155,3,797,7,4272,1,70
2589,155,3,798,2,4274,2,20
2590,155,3,799,9,4283,6,90
2591,155,3,800,2,4285,1,20
2592,155,3,801,2,4287,6,20
2593,155,3,802,3,4290,2,30
2594,155,3,803,8,4298,1,80
2595,155,3,804,7,4305,5,70
2596,155,3,805,6,4311,1,60
2597,155,3,806,8,4319,7,80
2598,155,3,807,6,4325,3,60
2599,155,3,808,7,4332,6,70
2600,155,3,809,2,4334,1,20
2601,155,3,810,7,4341,1,70
2602,155,3,811,4,4345,2,40
2603,155,3,812,8,4353,1,80
2604,155,3,813,9,4362,1,90
2605,155,3,814,6,4368,6,60
2606,155,3,815,3,4371,1,30
2607,155,3,816,2,4373,8,20
2608,155,3,817,3,4376,5,30
2609,155,3,818,5,4381,7,50
2610,155,3,819,5,4386,5,50
2611,155,3,820,4,4390,1,40
2612,155,3,821,9,4399,8,90
2613,155,3,822,7,4406,1,70
2614,155,3,823,4,4410,4,40
2615,155,3,824,8,4418,1,80
2616,155,3,825,3,4421,1,30
2617,155,3,826,5,4426,1,50
2618,155,3,827,4,4430,2,40
2619,155,3,828,8,4438,2,80
2620,155,3,829,2,4440,1,20
2621,155,3,830,4,4444,1,40
2622,155,3,831,7,4451,3,70
2623,155,3,832,9,4460,2,90
2624,155,3,833,3,4463,5,30
2625,155,3,834,7,4470,4,70
2626,155,3,835,8,4478,8,80
2627,155,3,836,9,4487,2,90
2628,155,3,837,7,4494,1,70
2629,155,3,838,9,4503,1,90
2630,155,3,839,6,4509,1,60
2631,155,3,840,9,4518,1,90
2632,155,3,841,5,4523,1,50
2633,155,3,842,4,4527,6,40
2634,155,3,843,9,4536,1,90
2635,155,3,844,2,4538,7,20
2636,155,3,845,7,4545,1,70
2637,155,3,846,5,4550,1,50
2638,155,3,847,7,4557,8,70
2639,155,3,848,8,4565,1,80
2640,155,3,849,8,4573,1,80
2641,155,3,850,4,4577,1,40
2642,155,3,851,9,4586,5,90
2643,155,3,852,4,4590,8,40
2644,155,3,853,9,4599,3,90
2645,155,3,854,5,4604,1,50
2646,155,3,855,2,4606,1,20
2647,155,3,856,5,4611,1,50
2648,155,3,857,5,4616,1,50
2649,155,3,858,8,4624,2,80
2650,155,3,859,2,4626,1,20
2651,155,3,860,2,4628,1,20
2652,155,3,861,2,4630,1,20
2653,155,3,862,9,4639,7,90
2654,155,3,863,7,4646,1,70
2655,155,3,864,4,4650,3,40
2656,155,3,865,9,4659,1,90
2657,155,3,866,2,4661,1,20
2658,155,3,867,3,4664,5,30
2659,155,3,868,4,4668,1,40
2660,155,3,869,2,4670,6,20
2661,155,3,870,6,4676,1,60
2662,155,3,871,9,4685,3,90
2663,155,3,872,7,4692,1,70
2664,155,3,873,5,4697,7,50
2665,155,3,874,9,4706,1,90
2666,155,3,875,8,4714,3,80
2667,155,3,876,5,4719,1,50
2668,155,3,877,3,4722,1,30
2669,155,3,878,4,4726,1,40
2670,155,3,879,6,4732,1,60
2671,155,3,880,2,4734,4,20
2672,155,3,881,6,4740,1,60
2673,155,3,882,4,4744,7,40
2674,155,3,883,3,4747,3,30
2675,155,3,884,6,4753,6,60
2676,155,3,885,3,4756,1,30
2677,155,3,886,7,4763,1,70
2678,155,3,887,5,4768,0,50
2679,155,3,888,5,4773,3,50
2680,155,3,889,7,4780,2,70
2681,155,3,890,5,4785,5,50
2682,155,3,891,5,4790,1,50
2683,155,3,892,4,4794,1,40
2684,155,3,893,3,4797,5,30
2685,155,3,894,7,4804,4,70
2686,155,3,895,9,4813,4,90
2687,155,3,896,4,4817,1,40
2688,155,3,897,7,4824,5,70
2689,155,3,898,3,4827,1,30
2690,155,3,899,7,4834,3,70
2691,155,3,900,6,4840,1,60
2692,155,3,901,2,4842,1,20
2693,155,3,902,9,4851,1,90
2694,155,3,903,4,4855,9,40
2695,155,3,904,8,4863,6,80
2696,155,3,905,5,4868,1,50
2697,155,3,906,9,4877,3,90
2698,155,3,907,9,4886,4,90
2699,155,3,908,9,4895,5,90
2700,155,3,909,2,4897,3,20
2701,155,3,910,5,4902,1,50
2702,155,3,911,6,4908,1,60
2703,155,3,912,9,4917,4,90
2704,155,3,913,9,4926,7,90
2705,155,3,914,6,4932,1,60
2706,155,3,915,3,4935,1,30
2707,155,3,916,5,4940,4,50
2708,155,3,917,8,4948,5,80
2709,155,3,918,8,4956,1,80
2710,155,3,919,8,4964,1,80
2711,155,3,920,9,4973,3,90
2712,155,3,921,4,4977,6,40
2713,155,3,922,4,4981,1,40
2714,155,3,923,5,4986,1,50
2715,155,3,924,4,4990,1,40
2716,155,3,925,7,4997,1,70
