,Scenario,Trial,Inspection,Interval,Time,Defects,Rate
0,254,1,1,6,6,22,60
1,254,1,2,8,14,53,80
2,254,1,3,2,16,27,20
3,254,1,4,7,23,49,70
4,254,1,5,5,28,46,50
5,254,1,6,2,30,1,20
6,254,1,7,5,35,53,50
7,254,1,8,7,42,1,70
8,254,1,9,2,44,1,20
9,254,1,10,9,53,93,90
10,254,1,11,9,62,1,90
11,254,1,12,3,65,1,30
12,254,1,13,9,74,1,90
13,254,1,14,9,83,151,90
14,254,1,15,3,86,1,30
15,254,1,16,7,93,1,70
16,254,1,17,8,101,1,80
17,254,1,18,5,106,1,50
18,254,1,19,5,111,203,50
19,254,1,20,8,119,1,80
20,254,1,21,2,121,141,20
21,254,1,22,6,127,160,60
22,254,1,23,6,133,1,60
23,254,1,24,3,136,1,30
24,254,1,25,4,140,1,40
25,254,1,26,3,143,145,30
26,254,1,27,3,146,1,30
27,254,1,28,2,148,1,20
28,254,1,29,6,154,1,60
29,254,1,30,8,162,1,80
30,254,1,31,7,169,205,70
31,254,1,32,2,171,1,20
32,254,1,33,3,174,137,30
33,254,1,34,2,176,1,20
34,254,1,35,5,181,135,50
35,254,1,36,7,188,1,70
36,254,1,37,8,196,1,80
37,254,1,38,9,205,1,90
38,254,1,39,2,207,1,20
39,254,1,40,5,212,194,50
40,254,1,41,8,220,1,80
41,254,1,42,5,225,1,50
42,254,1,43,9,234,1,90
43,254,1,44,4,238,1,40
44,254,1,45,4,242,1,40
45,254,1,46,5,247,1,50
46,254,1,47,5,252,1,50
47,254,1,48,2,254,266,20
48,254,1,49,7,261,1,70
49,254,1,50,3,264,197,30
50,254,1,51,5,269,1,50
51,254,1,52,2,271,1,20
52,254,1,53,3,274,197,30
53,254,1,54,7,281,121,70
54,254,1,55,8,289,116,80
55,254,1,56,4,293,81,40
56,254,1,57,3,296,84,30
57,254,1,58,9,305,1,90
58,254,1,59,8,313,1,80
59,254,1,60,2,315,1,20
60,254,1,61,8,323,133,80
61,254,1,62,3,326,1,30
62,254,1,63,8,334,130,80
63,254,1,64,4,338,1,40
64,254,1,65,6,344,1,60
65,254,1,66,8,352,1,80
66,254,1,67,6,358,1,60
67,254,1,68,2,360,154,20
68,254,1,69,7,367,1,70
69,254,1,70,8,375,1,80
70,254,1,71,2,377,1,20
71,254,1,72,7,384,1,70
72,254,1,73,9,393,1,90
73,254,1,74,6,399,1,60
74,254,1,75,5,404,272,50
75,254,1,76,3,407,1,30
76,254,1,77,8,415,227,80
77,254,1,78,5,420,1,50
78,254,1,79,7,427,1,70
79,254,1,80,5,432,1,50
80,254,1,81,7,439,194,70
81,254,1,82,8,447,1,80
82,254,1,83,7,454,1,70
83,254,1,84,4,458,1,40
84,254,1,85,2,460,233,20
85,254,1,86,7,467,1,70
86,254,1,87,2,469,1,20
87,254,1,88,3,472,1,30
88,254,1,89,7,479,1,70
89,254,1,90,9,488,236,90
90,254,1,91,2,490,1,20
91,254,1,92,9,499,191,90
92,254,1,93,5,504,1,50
93,254,1,94,3,507,158,30
94,254,1,95,2,509,1,20
95,254,1,96,7,516,1,70
96,254,1,97,3,519,147,30
97,254,1,98,7,526,1,70
98,254,1,99,3,529,1,30
99,254,1,100,6,535,134,60
100,254,1,101,3,538,1,30
101,254,1,102,4,542,129,40
102,254,1,103,9,551,1,90
103,254,1,104,4,555,1,40
104,254,1,105,6,561,1,60
105,254,1,106,3,564,155,30
106,254,1,107,7,571,1,70
107,254,1,108,2,573,132,20
108,254,1,109,5,578,1,50
109,254,1,110,6,584,1,60
110,254,1,111,9,593,1,90
111,254,1,112,5,598,167,50
112,254,1,113,8,606,141,80
113,254,1,114,3,609,1,30
114,254,1,115,3,612,104,30
115,254,1,116,6,618,79,60
116,254,1,117,9,627,104,90
117,254,1,118,5,632,1,50
118,254,1,119,5,637,1,50
119,254,1,120,8,645,1,80
120,254,1,121,9,654,142,90
121,254,1,122,8,662,1,80
122,254,1,123,9,671,1,90
123,254,1,124,9,680,186,90
124,254,1,125,4,684,1,40
125,254,1,126,5,689,1,50
126,254,1,127,9,698,1,90
127,254,1,128,4,702,175,40
128,254,1,129,8,710,1,80
129,254,1,130,6,716,175,60
130,254,1,131,6,722,132,60
131,254,1,132,8,730,148,80
132,254,1,133,6,736,1,60
133,254,1,134,3,739,1,30
134,254,1,135,4,743,1,40
135,254,1,136,9,752,1,90
136,254,1,137,5,757,1,50
137,254,1,138,6,763,189,60
138,254,1,139,3,766,1,30
139,254,1,140,9,775,1,90
140,254,1,141,3,778,1,30
141,254,1,142,4,782,206,40
142,254,1,143,6,788,1,60
143,254,1,144,6,794,1,60
144,254,1,145,5,799,1,50
145,254,1,146,3,802,1,30
146,254,1,147,7,809,1,70
147,254,1,148,6,815,1,60
148,254,1,149,3,818,1,30
149,254,1,150,3,821,1,30
150,254,1,151,2,823,1,20
151,254,1,152,3,826,1,30
152,254,1,153,2,828,1,20
153,254,1,154,9,837,1,90
154,254,1,155,9,846,1,90
155,254,1,156,9,855,1,90
156,254,1,157,7,862,1,70
157,254,1,158,3,865,1,30
158,254,1,159,5,870,1,50
159,254,1,160,2,872,1,20
160,254,1,161,3,875,409,30
161,254,1,162,3,878,1,30
162,254,1,163,9,887,349,90
163,254,1,164,2,889,1,20
164,254,1,165,4,893,1,40
165,254,1,166,3,896,1,30
166,254,1,167,6,902,1,60
167,254,1,168,7,909,1,70
168,254,1,169,3,912,1,30
169,254,1,170,5,917,1,50
170,254,1,171,6,923,352,60
171,254,1,172,8,931,236,80
172,254,1,173,5,936,1,50
173,254,1,174,7,943,1,70
174,254,1,175,7,950,1,70
175,254,1,176,7,957,1,70
176,254,1,177,8,965,1,80
177,254,1,178,7,972,1,70
178,254,1,179,7,979,1,70
179,254,1,180,3,982,326,30
180,254,1,181,2,984,1,20
181,254,1,182,9,993,234,90
182,254,1,183,5,998,1,50
183,254,1,184,8,1006,218,80
184,254,1,185,9,1015,1,90
185,254,1,186,8,1023,1,80
186,254,1,187,9,1032,203,90
187,254,1,188,3,1035,1,30
188,254,1,189,9,1044,186,90
189,254,1,190,9,1053,1,90
190,254,1,191,3,1056,1,30
191,254,1,192,7,1063,1,70
192,254,1,193,6,1069,1,60
193,254,1,194,8,1077,1,80
194,254,1,195,8,1085,1,80
195,254,1,196,6,1091,1,60
196,254,1,197,7,1098,282,70
197,254,1,198,5,1103,238,50
198,254,1,199,9,1112,1,90
199,254,1,200,5,1117,171,50
200,254,1,201,9,1126,1,90
201,254,1,202,4,1130,1,40
202,254,1,203,5,1135,1,50
203,254,1,204,3,1138,1,30
204,254,1,205,5,1143,1,50
205,254,1,206,9,1152,1,90
206,254,1,207,5,1157,1,50
207,254,1,208,4,1161,1,40
208,254,1,209,6,1167,1,60
209,254,1,210,3,1170,1,30
210,254,1,211,8,1178,347,80
211,254,1,212,4,1182,216,40
212,254,1,213,4,1186,150,40
213,254,1,214,2,1188,111,20
214,254,1,215,8,1196,108,80
215,254,1,216,6,1202,1,60
216,254,1,217,6,1208,92,60
217,254,1,218,8,1216,1,80
218,254,1,219,4,1220,1,40
219,254,1,220,8,1228,1,80
220,254,1,221,9,1237,1,90
221,254,1,222,3,1240,1,30
222,254,1,223,9,1249,1,90
223,254,1,224,3,1252,1,30
224,254,1,225,8,1260,1,80
225,254,1,226,9,1269,278,90
226,254,1,227,3,1272,189,30
227,254,1,228,9,1281,1,90
228,254,1,229,3,1284,1,30
229,254,1,230,6,1290,1,60
230,254,1,231,3,1293,1,30
231,254,1,232,4,1297,205,40
232,254,1,233,3,1300,1,30
233,254,1,234,6,1306,162,60
234,254,1,235,2,1308,1,20
235,254,1,236,7,1315,157,70
236,254,1,237,7,1322,1,70
237,254,1,238,4,1326,1,40
238,254,1,239,6,1332,150,60
239,254,1,240,5,1337,1,50
240,254,1,241,8,1345,1,80
241,254,1,242,7,1352,170,70
242,254,1,243,6,1358,137,60
243,254,1,244,4,1362,1,40
244,254,1,245,8,1370,128,80
245,254,1,246,5,1375,1,50
246,254,1,247,7,1382,112,70
247,254,1,248,8,1390,1,80
248,254,1,249,4,1394,1,40
249,254,1,250,5,1399,124,50
250,254,1,251,2,1401,1,20
251,254,1,252,2,1403,1,20
252,254,1,253,6,1409,119,60
253,254,1,254,7,1416,121,70
254,254,1,255,3,1419,1,30
255,254,1,256,9,1428,1,90
256,254,1,257,3,1431,1,30
257,254,1,258,9,1440,144,90
258,254,1,259,6,1446,135,60
259,254,1,260,3,1449,1,30
260,254,1,261,3,1452,1,30
261,254,1,262,2,1454,1,20
262,254,1,263,9,1463,143,90
263,254,1,264,9,1472,127,90
264,254,1,265,8,1480,1,80
265,254,1,266,2,1482,107,20
266,254,1,267,8,1490,1,80
267,254,1,268,8,1498,1,80
268,254,1,269,9,1507,1,90
269,254,1,270,5,1512,189,50
270,254,1,271,4,1516,1,40
271,254,1,272,6,1522,1,60
272,254,1,273,7,1529,1,70
273,254,1,274,2,1531,200,20
274,254,1,275,8,1539,1,80
275,254,1,276,4,1543,1,40
276,254,1,277,6,1549,1,60
277,254,1,278,8,1557,1,80
278,254,1,279,5,1562,1,50
279,254,1,280,5,1567,244,50
280,254,1,281,3,1570,1,30
281,254,1,282,7,1577,1,70
282,254,1,283,3,1580,210,30
283,254,1,284,2,1582,1,20
284,254,1,285,6,1588,1,60
285,254,1,286,3,1591,1,30
286,254,1,287,7,1598,1,70
287,254,1,288,6,1604,1,60
288,254,1,289,9,1613,1,90
289,254,1,290,5,1618,261,50
290,254,1,291,2,1620,198,20
291,254,1,292,8,1628,1,80
292,254,1,293,3,1631,1,30
293,254,1,294,7,1638,1,70
294,254,1,295,3,1641,1,30
295,254,1,296,3,1644,1,30
296,254,1,297,8,1652,1,80
297,254,1,298,9,1661,252,90
298,254,1,299,6,1667,1,60
299,254,1,300,5,1672,1,50
300,254,1,301,6,1678,232,60
301,254,1,302,5,1683,178,50
302,254,1,303,9,1692,124,90
303,254,1,304,9,1701,1,90
304,254,1,305,9,1710,1,90
305,254,1,306,8,1718,1,80
306,254,1,307,5,1723,1,50
307,254,1,308,7,1730,219,70
308,254,1,309,2,1732,1,20
309,254,1,310,6,1738,1,60
310,254,1,311,9,1747,1,90
311,254,1,312,5,1752,1,50
312,254,1,313,2,1754,1,20
313,254,1,314,5,1759,1,50
314,254,1,315,4,1763,1,40
315,254,1,316,6,1769,1,60
316,254,1,317,9,1778,1,90
317,254,1,318,9,1787,344,90
318,254,1,319,4,1791,234,40
319,254,1,320,3,1794,1,30
320,254,1,321,8,1802,195,80
321,254,1,322,9,1811,1,90
322,254,1,323,4,1815,1,40
323,254,1,324,5,1820,1,50
324,254,1,325,7,1827,1,70
325,254,1,326,9,1836,1,90
326,254,1,327,2,1838,243,20
327,254,1,328,5,1843,1,50
328,254,1,329,4,1847,1,40
329,254,1,330,7,1854,204,70
330,254,1,331,4,1858,1,40
331,254,1,332,5,1863,1,50
332,254,1,333,3,1866,1,30
333,254,1,334,6,1872,1,60
334,254,1,335,2,1874,203,20
335,254,1,336,2,1876,1,20
336,254,1,337,9,1885,1,90
337,254,1,338,7,1892,176,70
338,254,1,339,5,1897,1,50
339,254,1,340,7,1904,1,70
340,254,1,341,6,1910,1,60
341,254,1,342,8,1918,1,80
342,254,1,343,9,1927,1,90
343,254,1,344,5,1932,1,50
344,254,1,345,7,1939,291,70
345,254,1,346,8,1947,1,80
346,254,1,347,8,1955,1,80
347,254,1,348,9,1964,273,90
348,254,1,349,7,1971,210,70
349,254,1,350,7,1978,1,70
350,254,1,351,8,1986,1,80
351,254,1,352,9,1995,172,90
352,254,1,353,2,1997,172,20
353,254,1,354,9,2006,1,90
354,254,1,355,7,2013,132,70
355,254,1,356,2,2015,1,20
356,254,1,357,5,2020,1,50
357,254,1,358,4,2024,140,40
358,254,1,359,8,2032,1,80
359,254,1,360,3,2035,1,30
360,254,1,361,6,2041,1,60
361,254,1,362,6,2047,1,60
362,254,1,363,2,2049,1,20
363,254,1,364,4,2053,165,40
364,254,1,365,6,2059,1,60
365,254,1,366,2,2061,1,20
366,254,1,367,8,2069,1,80
367,254,1,368,9,2078,234,90
368,254,1,369,3,2081,153,30
369,254,1,370,4,2085,1,40
370,254,1,371,8,2093,1,80
371,254,1,372,2,2095,1,20
372,254,1,373,3,2098,1,30
373,254,1,374,2,2100,1,20
374,254,1,375,5,2105,1,50
375,254,1,376,9,2114,1,90
376,254,1,377,6,2120,1,60
377,254,1,378,8,2128,1,80
378,254,1,379,3,2131,267,30
379,254,1,380,7,2138,190,70
380,254,1,381,4,2142,1,40
381,254,1,382,4,2146,165,40
382,254,1,383,7,2153,1,70
383,254,1,384,5,2158,143,50
384,254,1,385,3,2161,1,30
385,254,1,386,5,2166,1,50
386,254,1,387,2,2168,140,20
387,254,1,388,2,2170,96,20
388,254,1,389,8,2178,1,80
389,254,1,390,9,2187,1,90
390,254,1,391,8,2195,167,80
391,254,1,392,9,2204,143,90
392,254,1,393,8,2212,1,80
393,254,1,394,6,2218,1,60
394,254,1,395,4,2222,1,40
395,254,1,396,5,2227,1,50
396,254,1,397,8,2235,190,80
397,254,1,398,9,2244,1,90
398,254,1,399,2,2246,173,20
399,254,1,400,4,2250,1,40
400,254,1,401,8,2258,1,80
401,254,1,402,8,2266,1,80
402,254,1,403,2,2268,182,20
403,254,1,404,6,2274,1,60
404,254,1,405,4,2278,1,40
405,254,1,406,8,2286,190,80
406,254,1,407,9,2295,1,90
407,254,1,408,5,2300,1,50
408,254,1,409,6,2306,1,60
409,254,1,410,4,2310,1,40
410,254,1,411,5,2315,244,50
411,254,1,412,3,2318,1,30
412,254,1,413,6,2324,1,60
413,254,1,414,3,2327,179,30
414,254,1,415,4,2331,120,40
415,254,1,416,3,2334,1,30
416,254,1,417,2,2336,1,20
417,254,1,418,9,2345,1,90
418,254,1,419,4,2349,1,40
419,254,1,420,5,2354,1,50
420,254,1,421,9,2363,218,90
421,254,1,422,3,2366,1,30
422,254,1,423,4,2370,162,40
423,254,1,424,8,2378,105,80
424,254,1,425,3,2381,106,30
425,254,1,426,3,2384,1,30
426,254,1,427,9,2393,91,90
427,254,1,428,4,2397,1,40
428,254,1,429,6,2403,1,60
429,254,1,430,7,2410,1,70
430,254,1,431,5,2415,1,50
431,254,1,432,6,2421,1,60
432,254,1,433,5,2426,1,50
433,254,1,434,7,2433,1,70
434,254,1,435,8,2441,219,80
435,254,1,436,6,2447,1,60
436,254,1,437,4,2451,1,40
437,254,1,438,2,2453,1,20
438,254,1,439,2,2455,1,20
439,254,1,440,7,2462,232,70
440,254,1,441,5,2467,1,50
441,254,1,442,4,2471,1,40
442,254,1,443,5,2476,1,50
443,254,1,444,2,2478,186,20
444,254,1,445,3,2481,1,30
445,254,1,446,3,2484,154,30
446,254,1,447,2,2486,1,20
447,254,1,448,2,2488,121,20
448,254,1,449,9,2497,1,90
449,254,1,450,5,2502,1,50
450,254,1,451,2,2504,1,20
451,254,1,452,3,2507,1,30
452,254,1,453,6,2513,1,60
453,254,1,454,6,2519,1,60
454,254,1,455,2,2521,1,20
455,254,1,456,3,2524,1,30
456,254,1,457,9,2533,1,90
457,254,1,458,2,2535,1,20
458,254,1,459,7,2542,1,70
459,254,1,460,3,2545,1,30
460,254,1,461,7,2552,304,70
461,254,1,462,7,2559,1,70
462,254,1,463,4,2563,223,40
463,254,1,464,3,2566,1,30
464,254,1,465,7,2573,164,70
465,254,1,466,6,2579,145,60
466,254,1,467,3,2582,1,30
467,254,1,468,9,2591,121,90
468,254,1,469,2,2593,1,20
469,254,1,470,6,2599,1,60
470,254,1,471,4,2603,1,40
471,254,1,472,7,2610,1,70
472,254,1,473,6,2616,1,60
473,254,1,474,5,2621,1,50
474,254,1,475,2,2623,1,20
475,254,1,476,9,2632,191,90
476,254,1,477,7,2639,157,70
477,254,1,478,8,2647,1,80
478,254,1,479,8,2655,172,80
479,254,1,480,6,2661,1,60
480,254,1,481,3,2664,1,30
481,254,1,482,9,2673,203,90
482,254,1,483,8,2681,145,80
483,254,1,484,7,2688,108,70
484,254,1,485,7,2695,1,70
485,254,1,486,4,2699,1,40
486,254,1,487,4,2703,1,40
487,254,1,488,8,2711,173,80
488,254,1,489,6,2717,1,60
489,254,1,490,5,2722,1,50
490,254,1,491,4,2726,152,40
491,254,1,492,7,2733,1,70
492,254,1,493,7,2740,1,70
493,254,1,494,2,2742,151,20
494,254,1,495,2,2744,1,20
495,254,1,496,4,2748,1,40
496,254,1,497,3,2751,1,30
497,254,1,498,3,2754,1,30
498,254,1,499,8,2762,1,80
499,254,1,500,2,2764,1,20
500,254,1,501,4,2768,1,40
501,254,1,502,5,2773,179,50
502,254,1,503,2,2775,1,20
503,254,1,504,2,2777,1,20
504,254,1,505,2,2779,154,20
505,254,1,506,8,2787,1,80
506,254,1,507,3,2790,147,30
507,254,1,508,3,2793,107,30
508,254,1,509,7,2800,1,70
509,254,1,510,3,2803,108,30
510,254,1,511,2,2805,1,20
511,254,1,512,9,2814,1,90
512,254,1,513,3,2817,1,30
513,254,1,514,6,2823,115,60
514,254,1,515,6,2829,1,60
515,254,1,516,4,2833,1,40
516,254,1,517,4,2837,1,40
517,254,1,518,5,2842,155,50
518,254,1,519,8,2850,105,80
519,254,1,520,2,2852,1,20
520,254,1,521,7,2859,1,70
521,254,1,522,6,2865,137,60
522,254,1,523,6,2871,95,60
523,254,1,524,2,2873,81,20
524,254,1,525,6,2879,1,60
525,254,1,526,8,2887,1,80
526,254,1,527,8,2895,1,80
527,254,1,528,9,2904,126,90
528,254,1,529,3,2907,109,30
529,254,1,530,4,2911,89,40
530,254,1,531,8,2919,1,80
531,254,1,532,7,2926,1,70
532,254,1,533,4,2930,1,40
533,254,1,534,3,2933,119,30
534,254,1,535,7,2940,121,70
535,254,1,536,2,2942,1,20
536,254,1,537,8,2950,1,80
537,254,1,538,7,2957,1,70
538,254,1,539,3,2960,1,30
539,254,1,540,5,2965,1,50
540,254,1,541,5,2970,180,50
541,254,1,542,5,2975,1,50
542,254,1,543,3,2978,1,30
543,254,1,544,8,2986,147,80
544,254,1,545,4,2990,1,40
545,254,1,546,8,2998,1,80
546,254,1,547,7,3005,1,70
547,254,1,548,3,3008,168,30
548,254,1,549,4,3012,136,40
549,254,1,550,2,3014,1,20
550,254,1,551,5,3019,1,50
551,254,1,552,5,3024,1,50
552,254,1,553,2,3026,154,20
553,254,1,554,2,3028,1,20
554,254,1,555,5,3033,1,50
555,254,1,556,9,3042,1,90
556,254,1,557,3,3045,1,30
557,254,1,558,2,3047,1,20
558,254,1,559,6,3053,1,60
559,254,1,560,8,3061,221,80
560,254,1,561,6,3067,164,60
561,254,1,562,9,3076,1,90
562,254,1,563,4,3080,1,40
563,254,1,564,5,3085,1,50
564,254,1,565,2,3087,167,20
565,254,1,566,8,3095,1,80
566,254,1,567,4,3099,1,40
567,254,1,568,6,3105,1,60
568,254,1,569,6,3111,187,60
569,254,1,570,7,3118,1,70
570,254,1,571,6,3124,1,60
571,254,1,572,8,3132,209,80
572,254,1,573,4,3136,1,40
573,254,1,574,6,3142,1,60
574,254,1,575,5,3147,209,50
575,254,1,576,7,3154,1,70
576,254,1,577,4,3158,154,40
577,254,1,578,5,3163,1,50
578,254,1,579,2,3165,1,20
579,254,1,580,8,3173,1,80
580,254,1,581,4,3177,1,40
581,254,1,582,6,3183,197,60
582,254,1,583,4,3187,1,40
583,254,1,584,8,3195,1,80
584,254,1,585,3,3198,167,30
585,254,1,586,6,3204,1,60
586,254,1,587,6,3210,1,60
587,254,1,588,3,3213,1,30
588,254,1,589,8,3221,163,80
589,254,1,590,3,3224,138,30
590,254,1,591,7,3231,120,70
591,254,1,592,2,3233,1,20
592,254,1,593,3,3236,1,30
593,254,1,594,8,3244,124,80
594,254,1,595,8,3252,1,80
595,254,1,596,6,3258,1,60
596,254,1,597,6,3264,1,60
597,254,1,598,9,3273,1,90
598,254,1,599,4,3277,1,40
599,254,1,600,8,3285,216,80
600,254,1,601,2,3287,176,20
601,254,1,602,7,3294,1,70
602,254,1,603,6,3300,1,60
603,254,1,604,8,3308,1,80
604,254,1,605,3,3311,1,30
605,254,1,606,7,3318,1,70
606,254,1,607,6,3324,1,60
607,254,1,608,7,3331,1,70
608,254,1,609,8,3339,1,80
609,254,1,610,2,3341,1,20
610,254,1,611,6,3347,1,60
611,254,1,612,5,3352,344,50
612,254,1,613,8,3360,1,80
613,254,1,614,9,3369,1,90
614,254,1,615,5,3374,262,50
615,254,1,616,5,3379,1,50
616,254,1,617,7,3386,1,70
617,254,1,618,9,3395,1,90
618,254,1,619,2,3397,1,20
619,254,1,620,3,3400,1,30
620,254,1,621,8,3408,1,80
621,254,1,622,4,3412,1,40
622,254,1,623,4,3416,1,40
623,254,1,624,8,3424,1,80
624,254,1,625,4,3428,1,40
625,254,1,626,7,3435,1,70
626,254,1,627,2,3437,390,20
627,254,1,628,2,3439,1,20
628,254,1,629,2,3441,1,20
629,254,1,630,3,3444,1,30
630,254,1,631,2,3446,1,20
631,254,1,632,5,3451,1,50
632,254,1,633,6,3457,303,60
633,254,1,634,6,3463,1,60
634,254,1,635,2,3465,1,20
635,254,1,636,7,3472,1,70
636,254,1,637,8,3480,1,80
637,254,1,638,3,3483,1,30
638,254,1,639,7,3490,1,70
639,254,1,640,4,3494,1,40
640,254,1,641,6,3500,1,60
641,254,1,642,2,3502,427,20
642,254,1,643,2,3504,1,20
643,254,1,644,5,3509,1,50
644,254,1,645,3,3512,1,30
645,254,1,646,2,3514,283,20
646,254,1,647,4,3518,1,40
647,254,1,648,6,3524,1,60
648,254,1,649,4,3528,1,40
649,254,1,650,8,3536,274,80
650,254,1,651,8,3544,1,80
651,254,1,652,9,3553,1,90
652,254,1,653,5,3558,267,50
653,254,1,654,4,3562,1,40
654,254,1,655,6,3568,1,60
655,254,1,656,6,3574,221,60
656,254,1,657,3,3577,129,30
657,254,1,658,5,3582,1,50
658,254,1,659,8,3590,1,80
659,254,1,660,6,3596,1,60
660,254,1,661,3,3599,191,30
661,254,1,662,2,3601,1,20
662,254,1,663,4,3605,1,40
663,254,1,664,2,3607,1,20
664,254,1,665,7,3614,1,70
665,254,1,666,9,3623,188,90
666,254,1,667,2,3625,152,20
667,254,1,668,3,3628,1,30
668,254,1,669,7,3635,1,70
669,254,1,670,8,3643,1,80
670,254,1,671,7,3650,1,70
671,254,1,672,6,3656,1,60
672,254,1,673,3,3659,1,30
673,254,1,674,8,3667,229,80
674,254,1,675,3,3670,165,30
675,254,1,676,5,3675,1,50
676,254,1,677,8,3683,154,80
677,254,1,678,3,3686,1,30
678,254,1,679,8,3694,1,80
679,254,1,680,6,3700,1,60
680,254,1,681,5,3705,153,50
681,254,1,682,3,3708,1,30
682,254,1,683,6,3714,1,60
683,254,1,684,5,3719,1,50
684,254,1,685,8,3727,1,80
685,254,1,686,4,3731,1,40
686,254,1,687,8,3739,1,80
687,254,1,688,2,3741,1,20
688,254,1,689,9,3750,1,90
689,254,1,690,4,3754,1,40
690,254,1,691,8,3762,294,80
691,254,1,692,9,3771,1,90
692,254,1,693,5,3776,1,50
693,254,1,694,7,3783,271,70
694,254,1,695,3,3786,1,30
695,254,1,696,6,3792,1,60
696,254,1,697,4,3796,1,40
697,254,1,698,7,3803,1,70
698,254,1,699,7,3810,1,70
699,254,1,700,5,3815,1,50
700,254,1,701,8,3823,1,80
701,254,1,702,4,3827,1,40
702,254,1,703,2,3829,338,20
703,254,1,704,7,3836,1,70
704,254,1,705,5,3841,248,50
705,254,1,706,5,3846,1,50
706,254,1,707,8,3854,1,80
707,254,1,708,4,3858,229,40
708,254,1,709,3,3861,1,30
709,254,1,710,9,3870,1,90
710,254,1,711,4,3874,1,40
711,254,1,712,5,3879,230,50
712,254,1,713,2,3881,164,20
713,254,1,714,3,3884,1,30
714,254,1,715,6,3890,1,60
715,254,1,716,4,3894,1,40
716,254,1,717,3,3897,182,30
717,254,1,718,3,3900,1,30
718,254,1,719,8,3908,135,80
719,254,1,720,3,3911,94,30
720,254,1,721,8,3919,1,80
721,254,1,722,8,3927,1,80
722,254,1,723,6,3933,1,60
723,254,1,724,6,3939,140,60
724,254,1,725,7,3946,1,70
725,254,1,726,9,3955,1,90
726,254,1,727,4,3959,1,40
727,254,1,728,2,3961,1,20
728,254,1,729,4,3965,196,40
729,254,1,730,3,3968,133,30
730,254,1,731,5,3973,1,50
731,254,1,732,9,3982,1,90
732,254,1,733,9,3991,1,90
733,254,1,734,3,3994,1,30
734,254,1,735,5,3999,1,50
735,254,1,736,2,4001,1,20
736,254,1,737,4,4005,236,40
737,254,1,738,9,4014,142,90
738,254,1,739,6,4020,135,60
739,254,1,740,5,4025,1,50
740,254,1,741,4,4029,105,40
741,254,1,742,8,4037,1,80
742,254,1,743,6,4043,1,60
743,254,1,744,9,4052,1,90
744,254,1,745,7,4059,1,70
745,254,1,746,9,4068,1,90
746,254,1,747,7,4075,1,70
747,254,1,748,5,4080,1,50
748,254,1,749,6,4086,1,60
749,254,1,750,4,4090,296,40
750,254,1,751,3,4093,186,30
751,254,1,752,6,4099,1,60
752,254,1,753,5,4104,1,50
753,254,1,754,8,4112,186,80
754,254,1,755,6,4118,1,60
755,254,1,756,3,4121,1,30
756,254,1,757,7,4128,173,70
757,254,1,758,8,4136,1,80
758,254,1,759,9,4145,1,90
759,254,1,760,6,4151,173,60
760,254,1,761,7,4158,1,70
761,254,1,762,8,4166,1,80
762,254,1,763,4,4170,208,40
763,254,1,764,9,4179,1,90
764,254,1,765,2,4181,1,20
765,254,1,766,6,4187,1,60
766,254,1,767,6,4193,1,60
767,254,1,768,2,4195,1,20
768,254,1,769,6,4201,217,60
769,254,1,770,4,4205,1,40
770,254,1,771,7,4212,1,70
771,254,1,772,3,4215,1,30
772,254,1,773,8,4223,246,80
773,254,1,774,8,4231,1,80
774,254,1,775,4,4235,1,40
775,254,1,776,8,4243,1,80
776,254,1,777,4,4247,1,40
777,254,1,778,3,4250,1,30
778,254,1,779,5,4255,278,50
779,254,1,780,3,4258,1,30
780,254,1,781,9,4267,1,90
781,254,1,782,6,4273,1,60
782,254,1,783,3,4276,214,30
783,254,1,784,4,4280,173,40
784,254,1,785,5,4285,1,50
785,254,1,786,6,4291,138,60
786,254,1,787,2,4293,1,20
787,254,1,788,7,4300,130,70
788,254,1,789,3,4303,1,30
789,254,1,790,9,4312,1,90
790,254,1,791,5,4317,154,50
791,254,1,792,8,4325,1,80
792,254,1,793,7,4332,148,70
793,254,1,794,3,4335,1,30
794,254,1,795,5,4340,1,50
795,254,1,796,2,4342,143,20
796,254,1,797,2,4344,1,20
797,254,1,798,5,4349,1,50
798,254,1,799,2,4351,123,20
799,254,1,800,9,4360,1,90
800,254,1,801,6,4366,1,60
801,254,1,802,2,4368,1,20
802,254,1,803,2,4370,1,20
803,254,1,804,3,4373,1,30
804,254,1,805,8,4381,165,80
805,254,1,806,5,4386,1,50
806,254,1,807,7,4393,151,70
807,254,1,808,4,4397,1,40
808,254,1,809,7,4404,1,70
809,254,1,810,3,4407,1,30
810,254,1,811,3,4410,1,30
811,254,1,812,9,4419,1,90
812,254,1,813,3,4422,1,30
813,254,1,814,6,4428,1,60
814,254,1,815,5,4433,1,50
815,254,1,816,6,4439,1,60
816,254,1,817,3,4442,257,30
817,254,1,818,3,4445,1,30
818,254,1,819,9,4454,1,90
819,254,1,820,3,4457,1,30
820,254,1,821,9,4466,1,90
821,254,1,822,8,4474,273,80
822,254,1,823,5,4479,1,50
823,254,1,824,9,4488,1,90
824,254,1,825,8,4496,1,80
825,254,1,826,6,4502,1,60
826,254,1,827,2,4504,300,20
827,254,1,828,4,4508,1,40
828,254,1,829,2,4510,1,20
829,254,1,830,9,4519,262,90
830,254,1,831,6,4525,1,60
831,254,1,832,6,4531,1,60
832,254,1,833,2,4533,197,20
833,254,1,834,8,4541,1,80
834,254,1,835,6,4547,1,60
835,254,1,836,5,4552,1,50
836,254,1,837,4,4556,1,40
837,254,1,838,4,4560,1,40
838,254,1,839,2,4562,1,20
839,254,1,840,6,4568,263,60
840,254,1,841,5,4573,1,50
841,254,1,842,4,4577,1,40
842,254,1,843,6,4583,227,60
843,254,1,844,6,4589,1,60
844,254,1,845,8,4597,1,80
845,254,1,846,9,4606,1,90
846,254,1,847,4,4610,181,40
847,254,1,848,8,4618,1,80
848,254,1,849,6,4624,217,60
849,254,1,850,5,4629,1,50
850,254,1,851,7,4636,191,70
851,254,1,852,5,4641,1,50
852,254,1,853,6,4647,1,60
853,254,1,854,6,4653,1,60
854,254,1,855,6,4659,1,60
855,254,1,856,2,4661,194,20
856,254,1,857,7,4668,143,70
857,254,1,858,3,4671,1,30
858,254,1,859,3,4674,123,30
859,254,1,860,8,4682,108,80
860,254,1,861,3,4685,1,30
861,254,1,862,9,4694,1,90
862,254,1,863,6,4700,145,60
863,254,1,864,3,4703,90,30
864,254,1,865,4,4707,1,40
865,254,1,866,9,4716,1,90
866,254,1,867,6,4722,1,60
867,254,1,868,4,4726,1,40
868,254,1,869,2,4728,1,20
869,254,1,870,9,4737,1,90
870,254,1,871,4,4741,1,40
871,254,1,872,9,4750,1,90
872,254,1,873,2,4752,1,20
873,254,1,874,5,4757,1,50
874,254,1,875,6,4763,1,60
875,254,1,876,2,4765,1,20
876,254,1,877,9,4774,306,90
877,254,1,878,9,4783,1,90
878,254,1,879,2,4785,1,20
879,254,1,880,9,4794,1,90
880,254,1,881,7,4801,1,70
881,254,1,882,8,4809,301,80
882,254,1,883,5,4814,216,50
883,254,1,884,9,4823,181,90
884,254,1,885,6,4829,1,60
885,254,1,886,7,4836,151,70
886,254,1,887,7,4843,1,70
887,254,1,888,7,4850,151,70
888,254,1,889,7,4857,129,70
889,254,1,890,3,4860,1,30
890,254,1,891,7,4867,125,70
891,254,1,892,5,4872,1,50
892,254,1,893,3,4875,1,30
893,254,1,894,5,4880,1,50
894,254,1,895,2,4882,133,20
895,254,1,896,4,4886,106,40
896,254,1,897,4,4890,1,40
897,254,1,898,7,4897,90,70
898,254,1,899,4,4901,80,40
899,254,1,900,6,4907,1,60
900,254,1,901,6,4913,1,60
901,254,1,902,6,4919,1,60
902,254,1,903,7,4926,1,70
903,254,1,904,3,4929,145,30
904,254,1,905,5,4934,1,50
905,254,1,906,4,4938,1,40
906,254,1,907,5,4943,1,50
907,254,1,908,9,4952,170,90
908,254,1,909,9,4961,1,90
909,254,1,910,4,4965,153,40
910,254,1,911,6,4971,1,60
911,254,1,912,2,4973,1,20
912,254,1,913,8,4981,1,80
913,254,1,914,7,4988,178,70
914,254,1,915,9,4997,147,90
915,254,2,1,3,3,9,30
916,254,2,2,9,12,1,90
917,254,2,3,4,16,1,40
918,254,2,4,8,24,1,80
919,254,2,5,3,27,1,30
920,254,2,6,4,31,1,40
921,254,2,7,7,38,129,70
922,254,2,8,9,47,110,90
923,254,2,9,6,53,1,60
924,254,2,10,4,57,1,40
925,254,2,11,9,66,1,90
926,254,2,12,9,75,1,90
927,254,2,13,6,81,210,60
928,254,2,14,4,85,1,40
929,254,2,15,7,92,1,70
930,254,2,16,4,96,1,40
931,254,2,17,8,104,201,80
932,254,2,18,5,109,1,50
933,254,2,19,7,116,175,70
934,254,2,20,8,124,132,80
935,254,2,21,2,126,1,20
936,254,2,22,4,130,1,40
937,254,2,23,4,134,123,40
938,254,2,24,6,140,105,60
939,254,2,25,2,142,67,20
940,254,2,26,9,151,1,90
941,254,2,27,7,158,1,70
942,254,2,28,3,161,1,30
943,254,2,29,5,166,135,50
944,254,2,30,6,172,1,60
945,254,2,31,4,176,1,40
946,254,2,32,9,185,1,90
947,254,2,33,5,190,1,50
948,254,2,34,7,197,1,70
949,254,2,35,5,202,1,50
950,254,2,36,3,205,217,30
951,254,2,37,4,209,147,40
952,254,2,38,8,217,1,80
953,254,2,39,5,222,1,50
954,254,2,40,9,231,1,90
955,254,2,41,2,233,1,20
956,254,2,42,8,241,205,80
957,254,2,43,2,243,150,20
958,254,2,44,8,251,1,80
959,254,2,45,8,259,1,80
960,254,2,46,7,266,1,70
961,254,2,47,4,270,1,40
962,254,2,48,5,275,1,50
963,254,2,49,5,280,1,50
964,254,2,50,4,284,1,40
965,254,2,51,9,293,1,90
966,254,2,52,5,298,1,50
967,254,2,53,4,302,1,40
968,254,2,54,5,307,1,50
969,254,2,55,7,314,1,70
970,254,2,56,2,316,1,20
971,254,2,57,4,320,324,40
972,254,2,58,2,322,1,20
973,254,2,59,9,331,270,90
974,254,2,60,2,333,1,20
975,254,2,61,7,340,1,70
976,254,2,62,4,344,231,40
977,254,2,63,2,346,1,20
978,254,2,64,6,352,1,60
979,254,2,65,8,360,1,80
980,254,2,66,9,369,1,90
981,254,2,67,9,378,1,90
982,254,2,68,2,380,1,20
983,254,2,69,2,382,265,20
984,254,2,70,5,387,1,50
985,254,2,71,2,389,1,20
986,254,2,72,5,394,209,50
987,254,2,73,4,398,1,40
988,254,2,74,6,404,176,60
989,254,2,75,3,407,123,30
990,254,2,76,3,410,1,30
991,254,2,77,6,416,1,60
992,254,2,78,3,419,1,30
993,254,2,79,5,424,1,50
994,254,2,80,4,428,1,40
995,254,2,81,3,431,1,30
996,254,2,82,4,435,1,40
997,254,2,83,8,443,1,80
998,254,2,84,8,451,1,80
999,254,2,85,7,458,1,70
1000,254,2,86,4,462,1,40
1001,254,2,87,4,466,270,40
1002,254,2,88,8,474,1,80
1003,254,2,89,5,479,1,50
1004,254,2,90,8,487,1,80
1005,254,2,91,3,490,272,30
1006,254,2,92,4,494,1,40
1007,254,2,93,9,503,1,90
1008,254,2,94,7,510,237,70
1009,254,2,95,8,518,1,80
1010,254,2,96,9,527,1,90
1011,254,2,97,2,529,1,20
1012,254,2,98,8,537,1,80
1013,254,2,99,3,540,267,30
1014,254,2,100,7,547,1,70
1015,254,2,101,5,552,1,50
1016,254,2,102,4,556,226,40
1017,254,2,103,9,565,1,90
1018,254,2,104,7,572,1,70
1019,254,2,105,2,574,228,20
1020,254,2,106,4,578,141,40
1021,254,2,107,8,586,1,80
1022,254,2,108,2,588,148,20
1023,254,2,109,4,592,1,40
1024,254,2,110,4,596,1,40
1025,254,2,111,2,598,1,20
1026,254,2,112,2,600,1,20
1027,254,2,113,5,605,1,50
1028,254,2,114,3,608,1,30
1029,254,2,115,3,611,1,30
1030,254,2,116,4,615,1,40
1031,254,2,117,3,618,1,30
1032,254,2,118,9,627,1,90
1033,254,2,119,3,630,212,30
1034,254,2,120,7,637,1,70
1035,254,2,121,7,644,1,70
1036,254,2,122,9,653,1,90
1037,254,2,123,6,659,1,60
1038,254,2,124,6,665,1,60
1039,254,2,125,9,674,1,90
1040,254,2,126,8,682,1,80
1041,254,2,127,3,685,316,30
1042,254,2,128,3,688,1,30
1043,254,2,129,9,697,263,90
1044,254,2,130,2,699,161,20
1045,254,2,131,5,704,1,50
1046,254,2,132,8,712,1,80
1047,254,2,133,9,721,1,90
1048,254,2,134,9,730,1,90
1049,254,2,135,3,733,1,30
1050,254,2,136,3,736,1,30
1051,254,2,137,4,740,1,40
1052,254,2,138,4,744,1,40
1053,254,2,139,8,752,1,80
1054,254,2,140,7,759,1,70
1055,254,2,141,9,768,1,90
1056,254,2,142,6,774,405,60
1057,254,2,143,8,782,1,80
1058,254,2,144,5,787,1,50
1059,254,2,145,8,795,333,80
1060,254,2,146,8,803,261,80
1061,254,2,147,4,807,1,40
1062,254,2,148,5,812,192,50
1063,254,2,149,7,819,150,70
1064,254,2,150,6,825,126,60
1065,254,2,151,8,833,1,80
1066,254,2,152,4,837,1,40
1067,254,2,153,8,845,1,80
1068,254,2,154,3,848,1,30
1069,254,2,155,5,853,177,50
1070,254,2,156,4,857,1,40
1071,254,2,157,7,864,1,70
1072,254,2,158,8,872,178,80
1073,254,2,159,7,879,1,70
1074,254,2,160,9,888,147,90
1075,254,2,161,4,892,1,40
1076,254,2,162,4,896,1,40
1077,254,2,163,8,904,1,80
1078,254,2,164,3,907,1,30
1079,254,2,165,6,913,1,60
1080,254,2,166,6,919,1,60
1081,254,2,167,7,926,1,70
1082,254,2,168,4,930,260,40
1083,254,2,169,4,934,190,40
1084,254,2,170,6,940,1,60
1085,254,2,171,5,945,1,50
1086,254,2,172,6,951,178,60
1087,254,2,173,6,957,1,60
1088,254,2,174,8,965,1,80
1089,254,2,175,7,972,1,70
1090,254,2,176,8,980,1,80
1091,254,2,177,2,982,1,20
1092,254,2,178,6,988,1,60
1093,254,2,179,8,996,1,80
1094,254,2,180,4,1000,279,40
1095,254,2,181,5,1005,1,50
1096,254,2,182,3,1008,1,30
1097,254,2,183,4,1012,1,40
1098,254,2,184,3,1015,1,30
1099,254,2,185,2,1017,1,20
1100,254,2,186,7,1024,286,70
1101,254,2,187,5,1029,1,50
1102,254,2,188,3,1032,1,30
1103,254,2,189,5,1037,1,50
1104,254,2,190,2,1039,1,20
1105,254,2,191,6,1045,1,60
1106,254,2,192,2,1047,1,20
1107,254,2,193,3,1050,1,30
1108,254,2,194,5,1055,1,50
1109,254,2,195,2,1057,309,20
1110,254,2,196,9,1066,210,90
1111,254,2,197,3,1069,1,30
1112,254,2,198,4,1073,1,40
1113,254,2,199,9,1082,1,90
1114,254,2,200,8,1090,236,80
1115,254,2,201,5,1095,1,50
1116,254,2,202,6,1101,1,60
1117,254,2,203,9,1110,1,90
1118,254,2,204,7,1117,1,70
1119,254,2,205,3,1120,1,30
1120,254,2,206,6,1126,1,60
1121,254,2,207,8,1134,1,80
1122,254,2,208,9,1143,1,90
1123,254,2,209,2,1145,354,20
1124,254,2,210,3,1148,1,30
1125,254,2,211,8,1156,1,80
1126,254,2,212,7,1163,1,70
1127,254,2,213,8,1171,330,80
1128,254,2,214,8,1179,1,80
1129,254,2,215,8,1187,1,80
1130,254,2,216,9,1196,1,90
1131,254,2,217,3,1199,1,30
1132,254,2,218,2,1201,307,20
1133,254,2,219,9,1210,1,90
1134,254,2,220,5,1215,257,50
1135,254,2,221,7,1222,1,70
1136,254,2,222,9,1231,1,90
1137,254,2,223,3,1234,1,30
1138,254,2,224,4,1238,1,40
1139,254,2,225,5,1243,1,50
1140,254,2,226,4,1247,1,40
1141,254,2,227,2,1249,1,20
1142,254,2,228,2,1251,313,20
1143,254,2,229,3,1254,1,30
1144,254,2,230,6,1260,214,60
1145,254,2,231,6,1266,164,60
1146,254,2,232,5,1271,110,50
1147,254,2,233,2,1273,78,20
1148,254,2,234,5,1278,61,50
1149,254,2,235,8,1286,1,80
1150,254,2,236,3,1289,92,30
1151,254,2,237,8,1297,1,80
1152,254,2,238,7,1304,104,70
1153,254,2,239,3,1307,1,30
1154,254,2,240,8,1315,1,80
1155,254,2,241,7,1322,1,70
1156,254,2,242,4,1326,1,40
1157,254,2,243,4,1330,172,40
1158,254,2,244,8,1338,120,80
1159,254,2,245,3,1341,1,30
1160,254,2,246,8,1349,109,80
1161,254,2,247,6,1355,1,60
1162,254,2,248,7,1362,1,70
1163,254,2,249,9,1371,1,90
1164,254,2,250,9,1380,1,90
1165,254,2,251,7,1387,193,70
1166,254,2,252,2,1389,140,20
1167,254,2,253,6,1395,103,60
1168,254,2,254,3,1398,75,30
1169,254,2,255,4,1402,66,40
1170,254,2,256,6,1408,66,60
1171,254,2,257,6,1414,1,60
1172,254,2,258,5,1419,91,50
1173,254,2,259,4,1423,1,40
1174,254,2,260,8,1431,84,80
1175,254,2,261,3,1434,1,30
1176,254,2,262,9,1443,1,90
1177,254,2,263,8,1451,1,80
1178,254,2,264,7,1458,156,70
1179,254,2,265,3,1461,111,30
1180,254,2,266,2,1463,1,20
1181,254,2,267,5,1468,1,50
1182,254,2,268,9,1477,1,90
1183,254,2,269,4,1481,1,40
1184,254,2,270,8,1489,1,80
1185,254,2,271,8,1497,185,80
1186,254,2,272,9,1506,1,90
1187,254,2,273,5,1511,162,50
1188,254,2,274,8,1519,1,80
1189,254,2,275,4,1523,156,40
1190,254,2,276,7,1530,1,70
1191,254,2,277,7,1537,1,70
1192,254,2,278,8,1545,1,80
1193,254,2,279,9,1554,1,90
1194,254,2,280,6,1560,1,60
1195,254,2,281,8,1568,263,80
1196,254,2,282,2,1570,174,20
1197,254,2,283,7,1577,1,70
1198,254,2,284,6,1583,1,60
1199,254,2,285,6,1589,187,60
1200,254,2,286,3,1592,1,30
1201,254,2,287,4,1596,1,40
1202,254,2,288,6,1602,170,60
1203,254,2,289,9,1611,137,90
1204,254,2,290,6,1617,1,60
1205,254,2,291,4,1621,1,40
1206,254,2,292,4,1625,1,40
1207,254,2,293,6,1631,1,60
1208,254,2,294,4,1635,1,40
1209,254,2,295,8,1643,1,80
1210,254,2,296,9,1652,244,90
1211,254,2,297,3,1655,1,30
1212,254,2,298,6,1661,1,60
1213,254,2,299,4,1665,1,40
1214,254,2,300,3,1668,1,30
1215,254,2,301,2,1670,1,20
1216,254,2,302,9,1679,224,90
1217,254,2,303,7,1686,1,70
1218,254,2,304,9,1695,1,90
1219,254,2,305,4,1699,1,40
1220,254,2,306,8,1707,248,80
1221,254,2,307,8,1715,1,80
1222,254,2,308,3,1718,1,30
1223,254,2,309,5,1723,1,50
1224,254,2,310,7,1730,1,70
1225,254,2,311,7,1737,274,70
1226,254,2,312,7,1744,1,70
1227,254,2,313,9,1753,1,90
1228,254,2,314,6,1759,258,60
1229,254,2,315,8,1767,183,80
1230,254,2,316,9,1776,1,90
1231,254,2,317,9,1785,1,90
1232,254,2,318,7,1792,222,70
1233,254,2,319,2,1794,152,20
1234,254,2,320,2,1796,1,20
1235,254,2,321,4,1800,121,40
1236,254,2,322,8,1808,1,80
1237,254,2,323,7,1815,1,70
1238,254,2,324,7,1822,1,70
1239,254,2,325,7,1829,1,70
1240,254,2,326,5,1834,1,50
1241,254,2,327,9,1843,1,90
1242,254,2,328,9,1852,1,90
1243,254,2,329,6,1858,1,60
1244,254,2,330,3,1861,255,30
1245,254,2,331,6,1867,225,60
1246,254,2,332,6,1873,1,60
1247,254,2,333,7,1880,1,70
1248,254,2,334,5,1885,1,50
1249,254,2,335,9,1894,243,90
1250,254,2,336,8,1902,1,80
1251,254,2,337,4,1906,1,40
1252,254,2,338,2,1908,210,20
1253,254,2,339,8,1916,1,80
1254,254,2,340,4,1920,1,40
1255,254,2,341,3,1923,1,30
1256,254,2,342,9,1932,1,90
1257,254,2,343,3,1935,239,30
1258,254,2,344,6,1941,156,60
1259,254,2,345,4,1945,108,40
1260,254,2,346,8,1953,126,80
1261,254,2,347,5,1958,67,50
1262,254,2,348,5,1963,1,50
1263,254,2,349,5,1968,90,50
1264,254,2,350,9,1977,1,90
1265,254,2,351,7,1984,1,70
1266,254,2,352,5,1989,1,50
1267,254,2,353,9,1998,1,90
1268,254,2,354,9,2007,204,90
1269,254,2,355,4,2011,1,40
1270,254,2,356,6,2017,1,60
1271,254,2,357,9,2026,174,90
1272,254,2,358,7,2033,1,70
1273,254,2,359,3,2036,1,30
1274,254,2,360,8,2044,175,80
1275,254,2,361,9,2053,1,90
1276,254,2,362,3,2056,1,30
1277,254,2,363,5,2061,1,50
1278,254,2,364,4,2065,187,40
1279,254,2,365,4,2069,1,40
1280,254,2,366,8,2077,155,80
1281,254,2,367,6,2083,1,60
1282,254,2,368,7,2090,1,70
1283,254,2,369,2,2092,139,20
1284,254,2,370,2,2094,1,20
1285,254,2,371,3,2097,1,30
1286,254,2,372,4,2101,1,40
1287,254,2,373,8,2109,1,80
1288,254,2,374,7,2116,180,70
1289,254,2,375,9,2125,1,90
1290,254,2,376,6,2131,1,60
1291,254,2,377,3,2134,1,30
1292,254,2,378,4,2138,1,40
1293,254,2,379,8,2146,1,80
1294,254,2,380,3,2149,1,30
1295,254,2,381,3,2152,1,30
1296,254,2,382,7,2159,1,70
1297,254,2,383,3,2162,1,30
1298,254,2,384,9,2171,1,90
1299,254,2,385,9,2180,1,90
1300,254,2,386,6,2186,1,60
1301,254,2,387,9,2195,389,90
1302,254,2,388,2,2197,284,20
1303,254,2,389,8,2205,1,80
1304,254,2,390,4,2209,1,40
1305,254,2,391,7,2216,1,70
1306,254,2,392,3,2219,1,30
1307,254,2,393,6,2225,268,60
1308,254,2,394,5,2230,1,50
1309,254,2,395,5,2235,1,50
1310,254,2,396,2,2237,206,20
1311,254,2,397,3,2240,1,30
1312,254,2,398,7,2247,1,70
1313,254,2,399,3,2250,1,30
1314,254,2,400,4,2254,1,40
1315,254,2,401,3,2257,200,30
1316,254,2,402,9,2266,1,90
1317,254,2,403,6,2272,1,60
1318,254,2,404,5,2277,1,50
1319,254,2,405,9,2286,1,90
1320,254,2,406,6,2292,1,60
1321,254,2,407,2,2294,1,20
1322,254,2,408,9,2303,314,90
1323,254,2,409,2,2305,206,20
1324,254,2,410,6,2311,152,60
1325,254,2,411,8,2319,1,80
1326,254,2,412,8,2327,1,80
1327,254,2,413,4,2331,1,40
1328,254,2,414,9,2340,1,90
1329,254,2,415,7,2347,1,70
1330,254,2,416,6,2353,1,60
1331,254,2,417,9,2362,249,90
1332,254,2,418,3,2365,215,30
1333,254,2,419,8,2373,1,80
1334,254,2,420,6,2379,1,60
1335,254,2,421,4,2383,1,40
1336,254,2,422,4,2387,207,40
1337,254,2,423,3,2390,1,30
1338,254,2,424,5,2395,1,50
1339,254,2,425,6,2401,1,60
1340,254,2,426,8,2409,201,80
1341,254,2,427,3,2412,1,30
1342,254,2,428,3,2415,1,30
1343,254,2,429,8,2423,203,80
1344,254,2,430,7,2430,1,70
1345,254,2,431,2,2432,1,20
1346,254,2,432,8,2440,186,80
1347,254,2,433,7,2447,1,70
1348,254,2,434,4,2451,1,40
1349,254,2,435,5,2456,163,50
1350,254,2,436,9,2465,1,90
1351,254,2,437,4,2469,1,40
1352,254,2,438,7,2476,198,70
1353,254,2,439,3,2479,140,30
1354,254,2,440,4,2483,1,40
1355,254,2,441,8,2491,1,80
1356,254,2,442,5,2496,1,50
1357,254,2,443,9,2505,1,90
1358,254,2,444,4,2509,1,40
1359,254,2,445,6,2515,1,60
1360,254,2,446,2,2517,1,20
1361,254,2,447,8,2525,1,80
1362,254,2,448,3,2528,1,30
1363,254,2,449,9,2537,1,90
1364,254,2,450,6,2543,298,60
1365,254,2,451,6,2549,1,60
1366,254,2,452,9,2558,262,90
1367,254,2,453,3,2561,1,30
1368,254,2,454,6,2567,179,60
1369,254,2,455,6,2573,162,60
1370,254,2,456,9,2582,127,90
1371,254,2,457,3,2585,1,30
1372,254,2,458,2,2587,1,20
1373,254,2,459,5,2592,128,50
1374,254,2,460,9,2601,1,90
1375,254,2,461,2,2603,1,20
1376,254,2,462,7,2610,1,70
1377,254,2,463,9,2619,158,90
1378,254,2,464,7,2626,1,70
1379,254,2,465,2,2628,1,20
1380,254,2,466,9,2637,1,90
1381,254,2,467,7,2644,1,70
1382,254,2,468,4,2648,1,40
1383,254,2,469,8,2656,230,80
1384,254,2,470,3,2659,174,30
1385,254,2,471,4,2663,119,40
1386,254,2,472,4,2667,1,40
1387,254,2,473,6,2673,112,60
1388,254,2,474,6,2679,1,60
1389,254,2,475,6,2685,1,60
1390,254,2,476,3,2688,140,30
1391,254,2,477,7,2695,1,70
1392,254,2,478,8,2703,143,80
1393,254,2,479,2,2705,1,20
1394,254,2,480,9,2714,1,90
1395,254,2,481,5,2719,1,50
1396,254,2,482,9,2728,194,90
1397,254,2,483,6,2734,1,60
1398,254,2,484,8,2742,144,80
1399,254,2,485,2,2744,107,20
1400,254,2,486,9,2753,1,90
1401,254,2,487,8,2761,1,80
1402,254,2,488,5,2766,162,50
1403,254,2,489,9,2775,131,90
1404,254,2,490,8,2783,1,80
1405,254,2,491,5,2788,104,50
1406,254,2,492,8,2796,1,80
1407,254,2,493,4,2800,1,40
1408,254,2,494,7,2807,1,70
1409,254,2,495,6,2813,1,60
1410,254,2,496,6,2819,177,60
1411,254,2,497,9,2828,1,90
1412,254,2,498,5,2833,1,50
1413,254,2,499,8,2841,1,80
1414,254,2,500,2,2843,209,20
1415,254,2,501,3,2846,1,30
1416,254,2,502,3,2849,147,30
1417,254,2,503,3,2852,126,30
1418,254,2,504,6,2858,1,60
1419,254,2,505,5,2863,100,50
1420,254,2,506,5,2868,1,50
1421,254,2,507,6,2874,1,60
1422,254,2,508,7,2881,1,70
1423,254,2,509,9,2890,1,90
1424,254,2,510,4,2894,180,40
1425,254,2,511,8,2902,1,80
1426,254,2,512,5,2907,1,50
1427,254,2,513,6,2913,1,60
1428,254,2,514,4,2917,1,40
1429,254,2,515,8,2925,1,80
1430,254,2,516,2,2927,228,20
1431,254,2,517,9,2936,175,90
1432,254,2,518,4,2940,1,40
1433,254,2,519,2,2942,1,20
1434,254,2,520,5,2947,170,50
1435,254,2,521,9,2956,1,90
1436,254,2,522,7,2963,152,70
1437,254,2,523,2,2965,1,20
1438,254,2,524,3,2968,1,30
1439,254,2,525,6,2974,1,60
1440,254,2,526,9,2983,165,90
1441,254,2,527,2,2985,1,20
1442,254,2,528,3,2988,123,30
1443,254,2,529,7,2995,1,70
1444,254,2,530,7,3002,1,70
1445,254,2,531,4,3006,127,40
1446,254,2,532,4,3010,1,40
1447,254,2,533,7,3017,1,70
1448,254,2,534,3,3020,141,30
1449,254,2,535,9,3029,110,90
1450,254,2,536,2,3031,1,20
1451,254,2,537,2,3033,1,20
1452,254,2,538,4,3037,1,40
1453,254,2,539,3,3040,116,30
1454,254,2,540,7,3047,96,70
1455,254,2,541,8,3055,81,80
1456,254,2,542,4,3059,71,40
1457,254,2,543,2,3061,1,20
1458,254,2,544,9,3070,94,90
1459,254,2,545,2,3072,1,20
1460,254,2,546,4,3076,1,40
1461,254,2,547,9,3085,94,90
1462,254,2,548,7,3092,102,70
1463,254,2,549,7,3099,1,70
1464,254,2,550,8,3107,1,80
1465,254,2,551,8,3115,1,80
1466,254,2,552,7,3122,175,70
1467,254,2,553,9,3131,1,90
1468,254,2,554,5,3136,1,50
1469,254,2,555,9,3145,1,90
1470,254,2,556,5,3150,1,50
1471,254,2,557,4,3154,218,40
1472,254,2,558,7,3161,156,70
1473,254,2,559,8,3169,1,80
1474,254,2,560,3,3172,1,30
1475,254,2,561,3,3175,160,30
1476,254,2,562,3,3178,1,30
1477,254,2,563,4,3182,1,40
1478,254,2,564,7,3189,1,70
1479,254,2,565,3,3192,1,30
1480,254,2,566,5,3197,1,50
1481,254,2,567,5,3202,1,50
1482,254,2,568,7,3209,1,70
1483,254,2,569,7,3216,1,70
1484,254,2,570,6,3222,1,60
1485,254,2,571,2,3224,262,20
1486,254,2,572,5,3229,1,50
1487,254,2,573,9,3238,222,90
1488,254,2,574,8,3246,192,80
1489,254,2,575,8,3254,153,80
1490,254,2,576,6,3260,1,60
1491,254,2,577,2,3262,1,20
1492,254,2,578,9,3271,148,90
1493,254,2,579,3,3274,1,30
1494,254,2,580,2,3276,1,20
1495,254,2,581,4,3280,1,40
1496,254,2,582,2,3282,1,20
1497,254,2,583,6,3288,1,60
1498,254,2,584,3,3291,1,30
1499,254,2,585,7,3298,1,70
1500,254,2,586,5,3303,1,50
1501,254,2,587,3,3306,1,30
1502,254,2,588,8,3314,1,80
1503,254,2,589,9,3323,1,90
1504,254,2,590,2,3325,307,20
1505,254,2,591,9,3334,1,90
1506,254,2,592,7,3341,255,70
1507,254,2,593,9,3350,195,90
1508,254,2,594,5,3355,1,50
1509,254,2,595,2,3357,1,20
1510,254,2,596,9,3366,1,90
1511,254,2,597,8,3374,1,80
1512,254,2,598,8,3382,1,80
1513,254,2,599,4,3386,1,40
1514,254,2,600,3,3389,1,30
1515,254,2,601,2,3391,1,20
1516,254,2,602,3,3394,1,30
1517,254,2,603,8,3402,1,80
1518,254,2,604,5,3407,315,50
1519,254,2,605,3,3410,221,30
1520,254,2,606,7,3417,1,70
1521,254,2,607,2,3419,1,20
1522,254,2,608,4,3423,1,40
1523,254,2,609,8,3431,191,80
1524,254,2,610,4,3435,144,40
1525,254,2,611,4,3439,1,40
1526,254,2,612,3,3442,116,30
1527,254,2,613,5,3447,1,50
1528,254,2,614,4,3451,1,40
1529,254,2,615,8,3459,1,80
1530,254,2,616,5,3464,1,50
1531,254,2,617,8,3472,1,80
1532,254,2,618,9,3481,1,90
1533,254,2,619,9,3490,284,90
1534,254,2,620,5,3495,1,50
1535,254,2,621,3,3498,170,30
1536,254,2,622,2,3500,1,20
1537,254,2,623,3,3503,150,30
1538,254,2,624,3,3506,1,30
1539,254,2,625,9,3515,1,90
1540,254,2,626,5,3520,1,50
1541,254,2,627,6,3526,189,60
1542,254,2,628,4,3530,1,40
1543,254,2,629,8,3538,156,80
1544,254,2,630,2,3540,1,20
1545,254,2,631,9,3549,1,90
1546,254,2,632,2,3551,1,20
1547,254,2,633,3,3554,1,30
1548,254,2,634,5,3559,1,50
1549,254,2,635,6,3565,1,60
1550,254,2,636,7,3572,211,70
1551,254,2,637,4,3576,1,40
1552,254,2,638,7,3583,1,70
1553,254,2,639,5,3588,207,50
1554,254,2,640,4,3592,148,40
1555,254,2,641,3,3595,1,30
1556,254,2,642,2,3597,1,20
1557,254,2,643,4,3601,125,40
1558,254,2,644,8,3609,116,80
1559,254,2,645,8,3617,97,80
1560,254,2,646,3,3620,1,30
1561,254,2,647,9,3629,1,90
1562,254,2,648,9,3638,1,90
1563,254,2,649,3,3641,139,30
1564,254,2,650,3,3644,107,30
1565,254,2,651,8,3652,106,80
1566,254,2,652,6,3658,1,60
1567,254,2,653,9,3667,1,90
1568,254,2,654,5,3672,1,50
1569,254,2,655,7,3679,180,70
1570,254,2,656,8,3687,1,80
1571,254,2,657,5,3692,1,50
1572,254,2,658,3,3695,153,30
1573,254,2,659,4,3699,1,40
1574,254,2,660,4,3703,1,40
1575,254,2,661,4,3707,1,40
1576,254,2,662,9,3716,1,90
1577,254,2,663,8,3724,1,80
1578,254,2,664,2,3726,1,20
1579,254,2,665,5,3731,1,50
1580,254,2,666,2,3733,229,20
1581,254,2,667,2,3735,1,20
1582,254,2,668,6,3741,1,60
1583,254,2,669,8,3749,1,80
1584,254,2,670,2,3751,1,20
1585,254,2,671,9,3760,1,90
1586,254,2,672,6,3766,251,60
1587,254,2,673,3,3769,1,30
1588,254,2,674,5,3774,1,50
1589,254,2,675,2,3776,1,20
1590,254,2,676,9,3785,1,90
1591,254,2,677,9,3794,323,90
1592,254,2,678,8,3802,1,80
1593,254,2,679,5,3807,1,50
1594,254,2,680,4,3811,1,40
1595,254,2,681,4,3815,262,40
1596,254,2,682,8,3823,184,80
1597,254,2,683,9,3832,146,90
1598,254,2,684,9,3841,1,90
1599,254,2,685,6,3847,153,60
1600,254,2,686,9,3856,118,90
1601,254,2,687,4,3860,101,40
1602,254,2,688,9,3869,1,90
1603,254,2,689,6,3875,1,60
1604,254,2,690,9,3884,1,90
1605,254,2,691,9,3893,170,90
1606,254,2,692,4,3897,1,40
1607,254,2,693,2,3899,1,20
1608,254,2,694,6,3905,1,60
1609,254,2,695,3,3908,164,30
1610,254,2,696,6,3914,1,60
1611,254,2,697,3,3917,1,30
1612,254,2,698,8,3925,190,80
1613,254,2,699,7,3932,134,70
1614,254,2,700,7,3939,1,70
1615,254,2,701,4,3943,123,40
1616,254,2,702,6,3949,1,60
1617,254,2,703,2,3951,1,20
1618,254,2,704,7,3958,1,70
1619,254,2,705,3,3961,1,30
1620,254,2,706,4,3965,1,40
1621,254,2,707,7,3972,1,70
1622,254,2,708,8,3980,1,80
1623,254,2,709,8,3988,1,80
1624,254,2,710,2,3990,1,20
1625,254,2,711,9,3999,1,90
1626,254,2,712,2,4001,1,20
1627,254,2,713,2,4003,1,20
1628,254,2,714,5,4008,1,50
1629,254,2,715,5,4013,1,50
1630,254,2,716,2,4015,1,20
1631,254,2,717,2,4017,1,20
1632,254,2,718,5,4022,1,50
1633,254,2,719,3,4025,1,30
1634,254,2,720,7,4032,409,70
1635,254,2,721,7,4039,1,70
1636,254,2,722,5,4044,273,50
1637,254,2,723,9,4053,1,90
1638,254,2,724,7,4060,1,70
1639,254,2,725,3,4063,274,30
1640,254,2,726,7,4070,1,70
1641,254,2,727,9,4079,1,90
1642,254,2,728,3,4082,1,30
1643,254,2,729,9,4091,1,90
1644,254,2,730,4,4095,268,40
1645,254,2,731,4,4099,1,40
1646,254,2,732,3,4102,1,30
1647,254,2,733,4,4106,1,40
1648,254,2,734,4,4110,1,40
1649,254,2,735,3,4113,1,30
1650,254,2,736,5,4118,1,50
1651,254,2,737,3,4121,266,30
1652,254,2,738,6,4127,1,60
1653,254,2,739,4,4131,1,40
1654,254,2,740,3,4134,1,30
1655,254,2,741,6,4140,1,60
1656,254,2,742,9,4149,1,90
1657,254,2,743,7,4156,307,70
1658,254,2,744,7,4163,1,70
1659,254,2,745,2,4165,1,20
1660,254,2,746,6,4171,1,60
1661,254,2,747,7,4178,1,70
1662,254,2,748,6,4184,274,60
1663,254,2,749,5,4189,1,50
1664,254,2,750,4,4193,217,40
1665,254,2,751,9,4202,175,90
1666,254,2,752,9,4211,1,90
1667,254,2,753,7,4218,158,70
1668,254,2,754,8,4226,1,80
1669,254,2,755,8,4234,166,80
1670,254,2,756,9,4243,138,90
1671,254,2,757,8,4251,1,80
1672,254,2,758,6,4257,1,60
1673,254,2,759,5,4262,175,50
1674,254,2,760,5,4267,1,50
1675,254,2,761,5,4272,1,50
1676,254,2,762,8,4280,1,80
1677,254,2,763,2,4282,149,20
1678,254,2,764,6,4288,130,60
1679,254,2,765,7,4295,1,70
1680,254,2,766,7,4302,1,70
1681,254,2,767,3,4305,1,30
1682,254,2,768,7,4312,1,70
1683,254,2,769,4,4316,1,40
1684,254,2,770,5,4321,198,50
1685,254,2,771,2,4323,1,20
1686,254,2,772,6,4329,1,60
1687,254,2,773,7,4336,163,70
1688,254,2,774,9,4345,1,90
1689,254,2,775,9,4354,1,90
1690,254,2,776,3,4357,1,30
1691,254,2,777,6,4363,1,60
1692,254,2,778,9,4372,254,90
1693,254,2,779,3,4375,1,30
1694,254,2,780,8,4383,1,80
1695,254,2,781,9,4392,205,90
1696,254,2,782,7,4399,1,70
1697,254,2,783,7,4406,1,70
1698,254,2,784,9,4415,1,90
1699,254,2,785,9,4424,247,90
1700,254,2,786,7,4431,1,70
1701,254,2,787,2,4433,1,20
1702,254,2,788,2,4435,1,20
1703,254,2,789,9,4444,1,90
1704,254,2,790,6,4450,1,60
1705,254,2,791,2,4452,1,20
1706,254,2,792,7,4459,1,70
1707,254,2,793,3,4462,299,30
1708,254,2,794,8,4470,185,80
1709,254,2,795,8,4478,1,80
1710,254,2,796,7,4485,1,70
1711,254,2,797,7,4492,246,70
1712,254,2,798,2,4494,1,20
1713,254,2,799,6,4500,1,60
1714,254,2,800,4,4504,1,40
1715,254,2,801,3,4507,194,30
1716,254,2,802,2,4509,135,20
1717,254,2,803,8,4517,1,80
1718,254,2,804,9,4526,145,90
1719,254,2,805,7,4533,128,70
1720,254,2,806,6,4539,1,60
1721,254,2,807,6,4545,1,60
1722,254,2,808,7,4552,1,70
1723,254,2,809,2,4554,1,20
1724,254,2,810,8,4562,184,80
1725,254,2,811,4,4566,154,40
1726,254,2,812,8,4574,108,80
1727,254,2,813,5,4579,1,50
1728,254,2,814,6,4585,1,60
1729,254,2,815,8,4593,1,80
1730,254,2,816,5,4598,151,50
1731,254,2,817,9,4607,1,90
1732,254,2,818,3,4610,148,30
1733,254,2,819,5,4615,109,50
1734,254,2,820,4,4619,1,40
1735,254,2,821,7,4626,144,70
1736,254,2,822,3,4629,84,30
1737,254,2,823,3,4632,71,30
1738,254,2,824,4,4636,1,40
1739,254,2,825,2,4638,1,20
1740,254,2,826,5,4643,78,50
1741,254,2,827,7,4650,1,70
1742,254,2,828,5,4655,1,50
1743,254,2,829,3,4658,109,30
1744,254,2,830,2,4660,1,20
1745,254,2,831,2,4662,1,20
1746,254,2,832,3,4665,1,30
1747,254,2,833,6,4671,1,60
1748,254,2,834,6,4677,134,60
1749,254,2,835,5,4682,105,50
1750,254,2,836,4,4686,1,40
1751,254,2,837,9,4695,107,90
1752,254,2,838,9,4704,1,90
1753,254,2,839,5,4709,1,50
1754,254,2,840,8,4717,130,80
1755,254,2,841,8,4725,1,80
1756,254,2,842,5,4730,1,50
1757,254,2,843,9,4739,1,90
1758,254,2,844,8,4747,186,80
1759,254,2,845,3,4750,1,30
1760,254,2,846,6,4756,1,60
1761,254,2,847,3,4759,1,30
1762,254,2,848,6,4765,189,60
1763,254,2,849,7,4772,1,70
1764,254,2,850,7,4779,158,70
1765,254,2,851,7,4786,1,70
1766,254,2,852,9,4795,1,90
1767,254,2,853,8,4803,1,80
1768,254,2,854,4,4807,1,40
1769,254,2,855,2,4809,1,20
1770,254,2,856,4,4813,1,40
1771,254,2,857,8,4821,1,80
1772,254,2,858,3,4824,1,30
1773,254,2,859,6,4830,1,60
1774,254,2,860,5,4835,1,50
1775,254,2,861,4,4839,1,40
1776,254,2,862,5,4844,1,50
1777,254,2,863,5,4849,1,50
1778,254,2,864,6,4855,390,60
1779,254,2,865,6,4861,1,60
1780,254,2,866,8,4869,1,80
1781,254,2,867,7,4876,318,70
1782,254,2,868,4,4880,223,40
1783,254,2,869,6,4886,1,60
1784,254,2,870,3,4889,1,30
1785,254,2,871,7,4896,1,70
1786,254,2,872,8,4904,1,80
1787,254,2,873,4,4908,1,40
1788,254,2,874,4,4912,1,40
1789,254,2,875,7,4919,1,70
1790,254,2,876,2,4921,1,20
1791,254,2,877,6,4927,1,60
1792,254,2,878,2,4929,1,20
1793,254,2,879,5,4934,321,50
1794,254,2,880,8,4942,1,80
1795,254,2,881,9,4951,1,90
1796,254,2,882,6,4957,289,60
1797,254,2,883,3,4960,208,30
1798,254,2,884,3,4963,132,30
1799,254,2,885,6,4969,1,60
1800,254,2,886,2,4971,1,20
1801,254,2,887,5,4976,151,50
1802,254,2,888,2,4978,1,20
1803,254,2,889,5,4983,1,50
1804,254,2,890,3,4986,1,30
1805,254,2,891,9,4995,1,90
1806,254,2,892,2,4997,156,20
1807,254,3,1,7,7,1,70
1808,254,3,2,5,12,1,50
1809,254,3,3,4,16,53,40
1810,254,3,4,4,20,1,40
1811,254,3,5,9,29,1,90
1812,254,3,6,8,37,111,80
1813,254,3,7,3,40,1,30
1814,254,3,8,7,47,1,70
1815,254,3,9,5,52,1,50
1816,254,3,10,9,61,1,90
1817,254,3,11,9,70,1,90
1818,254,3,12,9,79,1,90
1819,254,3,13,6,85,1,60
1820,254,3,14,7,92,1,70
1821,254,3,15,8,100,1,80
1822,254,3,16,4,104,294,40
1823,254,3,17,5,109,202,50
1824,254,3,18,9,118,1,90
1825,254,3,19,2,120,1,20
1826,254,3,20,7,127,1,70
1827,254,3,21,9,136,225,90
1828,254,3,22,6,142,1,60
1829,254,3,23,8,150,182,80
1830,254,3,24,2,152,1,20
1831,254,3,25,8,160,1,80
1832,254,3,26,5,165,1,50
1833,254,3,27,5,170,1,50
1834,254,3,28,2,172,1,20
1835,254,3,29,9,181,1,90
1836,254,3,30,3,184,252,30
1837,254,3,31,8,192,1,80
1838,254,3,32,5,197,221,50
1839,254,3,33,7,204,1,70
1840,254,3,34,4,208,1,40
1841,254,3,35,5,213,1,50
1842,254,3,36,8,221,1,80
1843,254,3,37,2,223,1,20
1844,254,3,38,6,229,1,60
1845,254,3,39,3,232,1,30
1846,254,3,40,7,239,1,70
1847,254,3,41,5,244,1,50
1848,254,3,42,5,249,1,50
1849,254,3,43,6,255,1,60
1850,254,3,44,8,263,1,80
1851,254,3,45,6,269,368,60
1852,254,3,46,4,273,1,40
1853,254,3,47,7,280,1,70
1854,254,3,48,2,282,280,20
1855,254,3,49,8,290,1,80
1856,254,3,50,6,296,1,60
1857,254,3,51,7,303,1,70
1858,254,3,52,8,311,1,80
1859,254,3,53,6,317,1,60
1860,254,3,54,7,324,337,70
1861,254,3,55,4,328,1,40
1862,254,3,56,3,331,239,30
1863,254,3,57,4,335,1,40
1864,254,3,58,5,340,1,50
1865,254,3,59,3,343,179,30
1866,254,3,60,6,349,141,60
1867,254,3,61,2,351,1,20
1868,254,3,62,4,355,1,40
1869,254,3,63,9,364,138,90
1870,254,3,64,3,367,97,30
1871,254,3,65,8,375,91,80
1872,254,3,66,6,381,1,60
1873,254,3,67,6,387,1,60
1874,254,3,68,6,393,1,60
1875,254,3,69,4,397,134,40
1876,254,3,70,5,402,1,50
1877,254,3,71,9,411,152,90
1878,254,3,72,5,416,1,50
1879,254,3,73,7,423,1,70
1880,254,3,74,8,431,1,80
1881,254,3,75,2,433,1,20
1882,254,3,76,4,437,178,40
1883,254,3,77,8,445,140,80
1884,254,3,78,5,450,1,50
1885,254,3,79,8,458,134,80
1886,254,3,80,4,462,110,40
1887,254,3,81,3,465,1,30
1888,254,3,82,7,472,103,70
1889,254,3,83,8,480,1,80
1890,254,3,84,7,487,1,70
1891,254,3,85,4,491,1,40
1892,254,3,86,9,500,1,90
1893,254,3,87,9,509,1,90
1894,254,3,88,6,515,1,60
1895,254,3,89,7,522,1,70
1896,254,3,90,7,529,1,70
1897,254,3,91,3,532,289,30
1898,254,3,92,7,539,196,70
1899,254,3,93,9,548,1,90
1900,254,3,94,3,551,179,30
1901,254,3,95,3,554,115,30
1902,254,3,96,3,557,1,30
1903,254,3,97,4,561,121,40
1904,254,3,98,4,565,77,40
1905,254,3,99,9,574,77,90
1906,254,3,100,4,578,1,40
1907,254,3,101,4,582,1,40
1908,254,3,102,2,584,96,20
1909,254,3,103,5,589,1,50
1910,254,3,104,7,596,95,70
1911,254,3,105,2,598,1,20
1912,254,3,106,8,606,1,80
1913,254,3,107,6,612,1,60
1914,254,3,108,9,621,161,90
1915,254,3,109,9,630,1,90
1916,254,3,110,4,634,1,40
1917,254,3,111,5,639,1,50
1918,254,3,112,9,648,204,90
1919,254,3,113,5,653,159,50
1920,254,3,114,9,662,1,90
1921,254,3,115,8,670,161,80
1922,254,3,116,5,675,1,50
1923,254,3,117,9,684,1,90
1924,254,3,118,8,692,159,80
1925,254,3,119,4,696,1,40
1926,254,3,120,9,705,142,90
1927,254,3,121,8,713,1,80
1928,254,3,122,8,721,1,80
1929,254,3,123,8,729,1,80
1930,254,3,124,2,731,1,20
1931,254,3,125,7,738,1,70
1932,254,3,126,9,747,1,90
1933,254,3,127,6,753,294,60
1934,254,3,128,7,760,1,70
1935,254,3,129,4,764,1,40
1936,254,3,130,3,767,1,30
1937,254,3,131,2,769,1,20
1938,254,3,132,5,774,1,50
1939,254,3,133,7,781,1,70
1940,254,3,134,3,784,261,30
1941,254,3,135,9,793,1,90
1942,254,3,136,2,795,186,20
1943,254,3,137,7,802,159,70
1944,254,3,138,2,804,1,20
1945,254,3,139,8,812,117,80
1946,254,3,140,5,817,1,50
1947,254,3,141,2,819,1,20
1948,254,3,142,7,826,147,70
1949,254,3,143,5,831,1,50
1950,254,3,144,9,840,151,90
1951,254,3,145,7,847,1,70
1952,254,3,146,3,850,1,30
1953,254,3,147,7,857,1,70
1954,254,3,148,6,863,1,60
1955,254,3,149,8,871,1,80
1956,254,3,150,4,875,1,40
1957,254,3,151,9,884,1,90
1958,254,3,152,5,889,1,50
1959,254,3,153,2,891,1,20
1960,254,3,154,5,896,1,50
1961,254,3,155,9,905,347,90
1962,254,3,156,3,908,1,30
1963,254,3,157,6,914,1,60
1964,254,3,158,8,922,1,80
1965,254,3,159,4,926,1,40
1966,254,3,160,8,934,1,80
1967,254,3,161,3,937,1,30
1968,254,3,162,4,941,313,40
1969,254,3,163,5,946,1,50
1970,254,3,164,8,954,256,80
1971,254,3,165,2,956,1,20
1972,254,3,166,3,959,1,30
1973,254,3,167,4,963,1,40
1974,254,3,168,3,966,207,30
1975,254,3,169,7,973,1,70
1976,254,3,170,8,981,1,80
1977,254,3,171,5,986,1,50
1978,254,3,172,4,990,1,40
1979,254,3,173,9,999,240,90
1980,254,3,174,8,1007,1,80
1981,254,3,175,5,1012,1,50
1982,254,3,176,7,1019,1,70
1983,254,3,177,2,1021,235,20
1984,254,3,178,8,1029,1,80
1985,254,3,179,6,1035,1,60
1986,254,3,180,8,1043,255,80
1987,254,3,181,3,1046,1,30
1988,254,3,182,8,1054,1,80
1989,254,3,183,6,1060,1,60
1990,254,3,184,5,1065,211,50
1991,254,3,185,7,1072,1,70
1992,254,3,186,8,1080,1,80
1993,254,3,187,9,1089,242,90
1994,254,3,188,8,1097,1,80
1995,254,3,189,6,1103,1,60
1996,254,3,190,2,1105,1,20
1997,254,3,191,5,1110,1,50
1998,254,3,192,9,1119,263,90
1999,254,3,193,3,1122,1,30
2000,254,3,194,6,1128,1,60
2001,254,3,195,3,1131,1,30
2002,254,3,196,5,1136,239,50
2003,254,3,197,8,1144,1,80
2004,254,3,198,5,1149,1,50
2005,254,3,199,7,1156,1,70
2006,254,3,200,9,1165,1,90
2007,254,3,201,9,1174,1,90
2008,254,3,202,7,1181,275,70
2009,254,3,203,9,1190,266,90
2010,254,3,204,9,1199,165,90
2011,254,3,205,9,1208,137,90
2012,254,3,206,5,1213,1,50
2013,254,3,207,7,1220,1,70
2014,254,3,208,6,1226,1,60
2015,254,3,209,4,1230,175,40
2016,254,3,210,8,1238,1,80
2017,254,3,211,6,1244,161,60
2018,254,3,212,9,1253,1,90
2019,254,3,213,7,1260,1,70
2020,254,3,214,8,1268,1,80
2021,254,3,215,2,1270,1,20
2022,254,3,216,5,1275,1,50
2023,254,3,217,3,1278,237,30
2024,254,3,218,9,1287,1,90
2025,254,3,219,4,1291,1,40
2026,254,3,220,9,1300,1,90
2027,254,3,221,5,1305,1,50
2028,254,3,222,2,1307,1,20
2029,254,3,223,5,1312,214,50
2030,254,3,224,9,1321,1,90
2031,254,3,225,6,1327,254,60
2032,254,3,226,7,1334,1,70
2033,254,3,227,7,1341,203,70
2034,254,3,228,3,1344,1,30
2035,254,3,229,8,1352,1,80
2036,254,3,230,9,1361,1,90
2037,254,3,231,2,1363,1,20
2038,254,3,232,5,1368,1,50
2039,254,3,233,7,1375,1,70
2040,254,3,234,9,1384,1,90
2041,254,3,235,9,1393,1,90
2042,254,3,236,4,1397,335,40
2043,254,3,237,2,1399,1,20
2044,254,3,238,9,1408,1,90
2045,254,3,239,8,1416,1,80
2046,254,3,240,4,1420,1,40
2047,254,3,241,3,1423,308,30
2048,254,3,242,6,1429,1,60
2049,254,3,243,3,1432,236,30
2050,254,3,244,7,1439,170,70
2051,254,3,245,7,1446,1,70
2052,254,3,246,9,1455,1,90
2053,254,3,247,4,1459,180,40
2054,254,3,248,2,1461,122,20
2055,254,3,249,8,1469,100,80
2056,254,3,250,9,1478,1,90
2057,254,3,251,2,1480,107,20
2058,254,3,252,8,1488,1,80
2059,254,3,253,7,1495,1,70
2060,254,3,254,6,1501,1,60
2061,254,3,255,4,1505,1,40
2062,254,3,256,5,1510,173,50
2063,254,3,257,9,1519,1,90
2064,254,3,258,5,1524,1,50
2065,254,3,259,8,1532,1,80
2066,254,3,260,4,1536,199,40
2067,254,3,261,3,1539,149,30
2068,254,3,262,6,1545,111,60
2069,254,3,263,3,1548,1,30
2070,254,3,264,3,1551,91,30
2071,254,3,265,3,1554,1,30
2072,254,3,266,3,1557,1,30
2073,254,3,267,5,1562,92,50
2074,254,3,268,7,1569,1,70
2075,254,3,269,4,1573,1,40
2076,254,3,270,9,1582,148,90
2077,254,3,271,8,1590,1,80
2078,254,3,272,7,1597,148,70
2079,254,3,273,5,1602,1,50
2080,254,3,274,8,1610,1,80
2081,254,3,275,5,1615,1,50
2082,254,3,276,6,1621,1,60
2083,254,3,277,5,1626,1,50
2084,254,3,278,8,1634,1,80
2085,254,3,279,6,1640,1,60
2086,254,3,280,4,1644,1,40
2087,254,3,281,9,1653,1,90
2088,254,3,282,4,1657,301,40
2089,254,3,283,4,1661,201,40
2090,254,3,284,7,1668,1,70
2091,254,3,285,9,1677,194,90
2092,254,3,286,8,1685,1,80
2093,254,3,287,3,1688,1,30
2094,254,3,288,3,1691,1,30
2095,254,3,289,4,1695,1,40
2096,254,3,290,8,1703,1,80
2097,254,3,291,8,1711,1,80
2098,254,3,292,6,1717,292,60
2099,254,3,293,4,1721,1,40
2100,254,3,294,2,1723,203,20
2101,254,3,295,5,1728,1,50
2102,254,3,296,9,1737,1,90
2103,254,3,297,9,1746,1,90
2104,254,3,298,6,1752,1,60
2105,254,3,299,7,1759,225,70
2106,254,3,300,8,1767,209,80
2107,254,3,301,7,1774,1,70
2108,254,3,302,8,1782,1,80
2109,254,3,303,4,1786,1,40
2110,254,3,304,2,1788,1,20
2111,254,3,305,2,1790,170,20
2112,254,3,306,3,1793,1,30
2113,254,3,307,6,1799,1,60
2114,254,3,308,4,1803,1,40
2115,254,3,309,9,1812,176,90
2116,254,3,310,9,1821,1,90
2117,254,3,311,6,1827,1,60
2118,254,3,312,6,1833,224,60
2119,254,3,313,5,1838,1,50
2120,254,3,314,2,1840,144,20
2121,254,3,315,2,1842,1,20
2122,254,3,316,5,1847,1,50
2123,254,3,317,4,1851,1,40
2124,254,3,318,3,1854,157,30
2125,254,3,319,5,1859,1,50
2126,254,3,320,7,1866,150,70
2127,254,3,321,4,1870,1,40
2128,254,3,322,3,1873,1,30
2129,254,3,323,2,1875,1,20
2130,254,3,324,8,1883,1,80
2131,254,3,325,7,1890,1,70
2132,254,3,326,8,1898,194,80
2133,254,3,327,4,1902,1,40
2134,254,3,328,9,1911,1,90
2135,254,3,329,6,1917,1,60
2136,254,3,330,9,1926,1,90
2137,254,3,331,8,1934,259,80
2138,254,3,332,5,1939,1,50
2139,254,3,333,3,1942,200,30
2140,254,3,334,6,1948,1,60
2141,254,3,335,7,1955,1,70
2142,254,3,336,6,1961,1,60
2143,254,3,337,2,1963,1,20
2144,254,3,338,7,1970,1,70
2145,254,3,339,6,1976,1,60
2146,254,3,340,8,1984,1,80
2147,254,3,341,8,1992,1,80
2148,254,3,342,3,1995,314,30
2149,254,3,343,4,1999,1,40
2150,254,3,344,3,2002,248,30
2151,254,3,345,8,2010,191,80
2152,254,3,346,2,2012,147,20
2153,254,3,347,9,2021,1,90
2154,254,3,348,3,2024,1,30
2155,254,3,349,6,2030,1,60
2156,254,3,350,6,2036,149,60
2157,254,3,351,7,2043,138,70
2158,254,3,352,4,2047,1,40
2159,254,3,353,9,2056,1,90
2160,254,3,354,2,2058,139,20
2161,254,3,355,5,2063,89,50
2162,254,3,356,8,2071,98,80
2163,254,3,357,9,2080,94,90
2164,254,3,358,2,2082,1,20
2165,254,3,359,9,2091,1,90
2166,254,3,360,4,2095,117,40
2167,254,3,361,2,2097,1,20
2168,254,3,362,7,2104,1,70
2169,254,3,363,9,2113,1,90
2170,254,3,364,5,2118,1,50
2171,254,3,365,5,2123,1,50
2172,254,3,366,7,2130,1,70
2173,254,3,367,7,2137,1,70
2174,254,3,368,7,2144,1,70
2175,254,3,369,2,2146,246,20
2176,254,3,370,6,2152,151,60
2177,254,3,371,4,2156,132,40
2178,254,3,372,4,2160,105,40
2179,254,3,373,4,2164,1,40
2180,254,3,374,7,2171,100,70
2181,254,3,375,5,2176,78,50
2182,254,3,376,8,2184,89,80
2183,254,3,377,5,2189,1,50
2184,254,3,378,2,2191,1,20
2185,254,3,379,9,2200,119,90
2186,254,3,380,4,2204,1,40
2187,254,3,381,2,2206,1,20
2188,254,3,382,7,2213,1,70
2189,254,3,383,8,2221,141,80
2190,254,3,384,4,2225,1,40
2191,254,3,385,9,2234,173,90
2192,254,3,386,2,2236,1,20
2193,254,3,387,7,2243,1,70
2194,254,3,388,4,2247,1,40
2195,254,3,389,6,2253,152,60
2196,254,3,390,4,2257,1,40
2197,254,3,391,7,2264,1,70
2198,254,3,392,7,2271,1,70
2199,254,3,393,8,2279,1,80
2200,254,3,394,5,2284,210,50
2201,254,3,395,8,2292,1,80
2202,254,3,396,4,2296,1,40
2203,254,3,397,2,2298,168,20
2204,254,3,398,3,2301,1,30
2205,254,3,399,8,2309,1,80
2206,254,3,400,9,2318,184,90
2207,254,3,401,8,2326,162,80
2208,254,3,402,3,2329,1,30
2209,254,3,403,3,2332,1,30
2210,254,3,404,7,2339,136,70
2211,254,3,405,4,2343,1,40
2212,254,3,406,6,2349,1,60
2213,254,3,407,7,2356,1,70
2214,254,3,408,7,2363,180,70
2215,254,3,409,7,2370,1,70
2216,254,3,410,3,2373,1,30
2217,254,3,411,8,2381,1,80
2218,254,3,412,9,2390,1,90
2219,254,3,413,7,2397,211,70
2220,254,3,414,9,2406,1,90
2221,254,3,415,7,2413,206,70
2222,254,3,416,4,2417,1,40
2223,254,3,417,7,2424,179,70
2224,254,3,418,2,2426,1,20
2225,254,3,419,6,2432,1,60
2226,254,3,420,9,2441,1,90
2227,254,3,421,6,2447,1,60
2228,254,3,422,2,2449,1,20
2229,254,3,423,6,2455,1,60
2230,254,3,424,5,2460,1,50
2231,254,3,425,4,2464,1,40
2232,254,3,426,8,2472,1,80
2233,254,3,427,6,2478,1,60
2234,254,3,428,7,2485,1,70
2235,254,3,429,7,2492,1,70
2236,254,3,430,2,2494,1,20
2237,254,3,431,8,2502,408,80
2238,254,3,432,7,2509,1,70
2239,254,3,433,5,2514,1,50
2240,254,3,434,6,2520,1,60
2241,254,3,435,2,2522,318,20
2242,254,3,436,7,2529,1,70
2243,254,3,437,2,2531,232,20
2244,254,3,438,6,2537,175,60
2245,254,3,439,2,2539,1,20
2246,254,3,440,6,2545,165,60
2247,254,3,441,9,2554,1,90
2248,254,3,442,9,2563,1,90
2249,254,3,443,3,2566,1,30
2250,254,3,444,4,2570,1,40
2251,254,3,445,6,2576,1,60
2252,254,3,446,2,2578,1,20
2253,254,3,447,3,2581,1,30
2254,254,3,448,4,2585,224,40
2255,254,3,449,3,2588,1,30
2256,254,3,450,9,2597,190,90
2257,254,3,451,9,2606,141,90
2258,254,3,452,6,2612,1,60
2259,254,3,453,9,2621,153,90
2260,254,3,454,5,2626,1,50
2261,254,3,455,9,2635,1,90
2262,254,3,456,4,2639,1,40
2263,254,3,457,3,2642,181,30
2264,254,3,458,8,2650,1,80
2265,254,3,459,8,2658,178,80
2266,254,3,460,7,2665,1,70
2267,254,3,461,4,2669,1,40
2268,254,3,462,2,2671,1,20
2269,254,3,463,6,2677,1,60
2270,254,3,464,5,2682,180,50
2271,254,3,465,3,2685,142,30
2272,254,3,466,9,2694,111,90
2273,254,3,467,7,2701,1,70
2274,254,3,468,9,2710,1,90
2275,254,3,469,7,2717,1,70
2276,254,3,470,7,2724,1,70
2277,254,3,471,9,2733,209,90
2278,254,3,472,3,2736,1,30
2279,254,3,473,4,2740,1,40
2280,254,3,474,2,2742,1,20
2281,254,3,475,3,2745,187,30
2282,254,3,476,4,2749,1,40
2283,254,3,477,3,2752,1,30
2284,254,3,478,9,2761,1,90
2285,254,3,479,9,2770,214,90
2286,254,3,480,7,2777,1,70
2287,254,3,481,4,2781,1,40
2288,254,3,482,9,2790,1,90
2289,254,3,483,7,2797,1,70
2290,254,3,484,6,2803,1,60
2291,254,3,485,9,2812,1,90
2292,254,3,486,9,2821,1,90
2293,254,3,487,9,2830,1,90
2294,254,3,488,7,2837,1,70
2295,254,3,489,5,2842,376,50
2296,254,3,490,3,2845,252,30
2297,254,3,491,6,2851,202,60
2298,254,3,492,5,2856,1,50
2299,254,3,493,5,2861,1,50
2300,254,3,494,8,2869,201,80
2301,254,3,495,2,2871,115,20
2302,254,3,496,5,2876,92,50
2303,254,3,497,6,2882,1,60
2304,254,3,498,3,2885,1,30
2305,254,3,499,3,2888,109,30
2306,254,3,500,4,2892,1,40
2307,254,3,501,6,2898,1,60
2308,254,3,502,8,2906,1,80
2309,254,3,503,9,2915,1,90
2310,254,3,504,3,2918,1,30
2311,254,3,505,8,2926,1,80
2312,254,3,506,2,2928,1,20
2313,254,3,507,5,2933,1,50
2314,254,3,508,6,2939,234,60
2315,254,3,509,8,2947,200,80
2316,254,3,510,3,2950,1,30
2317,254,3,511,2,2952,128,20
2318,254,3,512,3,2955,116,30
2319,254,3,513,3,2958,1,30
2320,254,3,514,4,2962,1,40
2321,254,3,515,5,2967,94,50
2322,254,3,516,3,2970,61,30
2323,254,3,517,9,2979,1,90
2324,254,3,518,9,2988,1,90
2325,254,3,519,3,2991,1,30
2326,254,3,520,9,3000,1,90
2327,254,3,521,4,3004,1,40
2328,254,3,522,4,3008,154,40
2329,254,3,523,6,3014,1,60
2330,254,3,524,5,3019,1,50
2331,254,3,525,3,3022,1,30
2332,254,3,526,7,3029,1,70
2333,254,3,527,4,3033,1,40
2334,254,3,528,2,3035,235,20
2335,254,3,529,5,3040,160,50
2336,254,3,530,2,3042,1,20
2337,254,3,531,7,3049,164,70
2338,254,3,532,4,3053,1,40
2339,254,3,533,5,3058,1,50
2340,254,3,534,6,3064,1,60
2341,254,3,535,3,3067,143,30
2342,254,3,536,4,3071,1,40
2343,254,3,537,7,3078,139,70
2344,254,3,538,7,3085,1,70
2345,254,3,539,3,3088,1,30
2346,254,3,540,3,3091,1,30
2347,254,3,541,9,3100,1,90
2348,254,3,542,5,3105,168,50
2349,254,3,543,8,3113,1,80
2350,254,3,544,8,3121,1,80
2351,254,3,545,3,3124,1,30
2352,254,3,546,7,3131,209,70
2353,254,3,547,2,3133,145,20
2354,254,3,548,7,3140,1,70
2355,254,3,549,5,3145,1,50
2356,254,3,550,7,3152,1,70
2357,254,3,551,9,3161,1,90
2358,254,3,552,2,3163,1,20
2359,254,3,553,9,3172,1,90
2360,254,3,554,9,3181,285,90
2361,254,3,555,7,3188,1,70
2362,254,3,556,2,3190,1,20
2363,254,3,557,2,3192,1,20
2364,254,3,558,6,3198,221,60
2365,254,3,559,8,3206,1,80
2366,254,3,560,2,3208,1,20
2367,254,3,561,7,3215,218,70
2368,254,3,562,6,3221,1,60
2369,254,3,563,8,3229,1,80
2370,254,3,564,6,3235,1,60
2371,254,3,565,7,3242,1,70
2372,254,3,566,8,3250,251,80
2373,254,3,567,3,3253,1,30
2374,254,3,568,2,3255,185,20
2375,254,3,569,3,3258,1,30
2376,254,3,570,5,3263,126,50
2377,254,3,571,9,3272,130,90
2378,254,3,572,3,3275,76,30
2379,254,3,573,4,3279,1,40
2380,254,3,574,7,3286,1,70
2381,254,3,575,8,3294,110,80
2382,254,3,576,7,3301,115,70
2383,254,3,577,5,3306,1,50
2384,254,3,578,3,3309,94,30
2385,254,3,579,2,3311,65,20
2386,254,3,580,5,3316,1,50
2387,254,3,581,9,3325,105,90
2388,254,3,582,5,3330,76,50
2389,254,3,583,8,3338,74,80
2390,254,3,584,7,3345,66,70
2391,254,3,585,5,3350,1,50
2392,254,3,586,7,3357,97,70
2393,254,3,587,5,3362,1,50
2394,254,3,588,9,3371,1,90
2395,254,3,589,4,3375,1,40
2396,254,3,590,8,3383,143,80
2397,254,3,591,2,3385,1,20
2398,254,3,592,6,3391,1,60
2399,254,3,593,2,3393,1,20
2400,254,3,594,9,3402,1,90
2401,254,3,595,3,3405,1,30
2402,254,3,596,6,3411,1,60
2403,254,3,597,4,3415,207,40
2404,254,3,598,4,3419,1,40
2405,254,3,599,5,3424,1,50
2406,254,3,600,2,3426,1,20
2407,254,3,601,8,3434,192,80
2408,254,3,602,4,3438,144,40
2409,254,3,603,2,3440,1,20
2410,254,3,604,3,3443,1,30
2411,254,3,605,8,3451,143,80
2412,254,3,606,6,3457,131,60
2413,254,3,607,9,3466,105,90
2414,254,3,608,3,3469,1,30
2415,254,3,609,5,3474,1,50
2416,254,3,610,2,3476,1,20
2417,254,3,611,8,3484,1,80
2418,254,3,612,9,3493,1,90
2419,254,3,613,9,3502,1,90
2420,254,3,614,4,3506,212,40
2421,254,3,615,4,3510,1,40
2422,254,3,616,5,3515,1,50
2423,254,3,617,8,3523,197,80
2424,254,3,618,6,3529,1,60
2425,254,3,619,7,3536,1,70
2426,254,3,620,3,3539,1,30
2427,254,3,621,8,3547,1,80
2428,254,3,622,6,3553,1,60
2429,254,3,623,5,3558,1,50
2430,254,3,624,4,3562,1,40
2431,254,3,625,8,3570,1,80
2432,254,3,626,3,3573,1,30
2433,254,3,627,2,3575,295,20
2434,254,3,628,8,3583,1,80
2435,254,3,629,6,3589,1,60
2436,254,3,630,5,3594,1,50
2437,254,3,631,8,3602,1,80
2438,254,3,632,9,3611,321,90
2439,254,3,633,5,3616,1,50
2440,254,3,634,2,3618,1,20
2441,254,3,635,5,3623,253,50
2442,254,3,636,3,3626,1,30
2443,254,3,637,9,3635,1,90
2444,254,3,638,5,3640,1,50
2445,254,3,639,4,3644,1,40
2446,254,3,640,9,3653,1,90
2447,254,3,641,2,3655,1,20
2448,254,3,642,7,3662,1,70
2449,254,3,643,3,3665,1,30
2450,254,3,644,4,3669,1,40
2451,254,3,645,2,3671,1,20
2452,254,3,646,4,3675,344,40
2453,254,3,647,7,3682,1,70
2454,254,3,648,3,3685,256,30
2455,254,3,649,8,3693,1,80
2456,254,3,650,8,3701,1,80
2457,254,3,651,3,3704,1,30
2458,254,3,652,2,3706,1,20
2459,254,3,653,5,3711,1,50
2460,254,3,654,9,3720,1,90
2461,254,3,655,7,3727,1,70
2462,254,3,656,5,3732,1,50
2463,254,3,657,9,3741,353,90
2464,254,3,658,4,3745,226,40
2465,254,3,659,3,3748,1,30
2466,254,3,660,6,3754,168,60
2467,254,3,661,4,3758,154,40
2468,254,3,662,3,3761,1,30
2469,254,3,663,6,3767,120,60
2470,254,3,664,9,3776,1,90
2471,254,3,665,8,3784,146,80
2472,254,3,666,7,3791,1,70
2473,254,3,667,7,3798,1,70
2474,254,3,668,7,3805,146,70
2475,254,3,669,4,3809,1,40
2476,254,3,670,8,3817,149,80
2477,254,3,671,2,3819,1,20
2478,254,3,672,4,3823,1,40
2479,254,3,673,6,3829,123,60
2480,254,3,674,4,3833,1,40
2481,254,3,675,9,3842,127,90
2482,254,3,676,8,3850,1,80
2483,254,3,677,6,3856,1,60
2484,254,3,678,2,3858,1,20
2485,254,3,679,3,3861,1,30
2486,254,3,680,3,3864,1,30
2487,254,3,681,2,3866,1,20
2488,254,3,682,6,3872,1,60
2489,254,3,683,3,3875,163,30
2490,254,3,684,2,3877,1,20
2491,254,3,685,8,3885,1,80
2492,254,3,686,6,3891,1,60
2493,254,3,687,8,3899,216,80
2494,254,3,688,9,3908,1,90
2495,254,3,689,9,3917,1,90
2496,254,3,690,5,3922,207,50
2497,254,3,691,7,3929,163,70
2498,254,3,692,6,3935,113,60
2499,254,3,693,7,3942,1,70
2500,254,3,694,3,3945,1,30
2501,254,3,695,7,3952,1,70
2502,254,3,696,9,3961,1,90
2503,254,3,697,3,3964,1,30
2504,254,3,698,7,3971,1,70
2505,254,3,699,6,3977,237,60
2506,254,3,700,9,3986,1,90
2507,254,3,701,9,3995,1,90
2508,254,3,702,4,3999,1,40
2509,254,3,703,5,4004,1,50
2510,254,3,704,3,4007,1,30
2511,254,3,705,2,4009,1,20
2512,254,3,706,8,4017,1,80
2513,254,3,707,4,4021,1,40
2514,254,3,708,2,4023,321,20
2515,254,3,709,9,4032,243,90
2516,254,3,710,6,4038,196,60
2517,254,3,711,2,4040,1,20
2518,254,3,712,8,4048,1,80
2519,254,3,713,4,4052,1,40
2520,254,3,714,4,4056,1,40
2521,254,3,715,8,4064,201,80
2522,254,3,716,2,4066,1,20
2523,254,3,717,4,4070,1,40
2524,254,3,718,2,4072,1,20
2525,254,3,719,2,4074,1,20
2526,254,3,720,7,4081,1,70
2527,254,3,721,7,4088,1,70
2528,254,3,722,5,4093,1,50
2529,254,3,723,5,4098,238,50
2530,254,3,724,7,4105,171,70
2531,254,3,725,2,4107,1,20
2532,254,3,726,9,4116,1,90
2533,254,3,727,2,4118,1,20
2534,254,3,728,9,4127,174,90
2535,254,3,729,4,4131,1,40
2536,254,3,730,8,4139,1,80
2537,254,3,731,2,4141,1,20
2538,254,3,732,9,4150,222,90
2539,254,3,733,7,4157,1,70
2540,254,3,734,6,4163,1,60
2541,254,3,735,9,4172,1,90
2542,254,3,736,9,4181,1,90
2543,254,3,737,4,4185,1,40
2544,254,3,738,2,4187,1,20
2545,254,3,739,4,4191,294,40
2546,254,3,740,4,4195,211,40
2547,254,3,741,5,4200,1,50
2548,254,3,742,9,4209,181,90
2549,254,3,743,7,4216,1,70
2550,254,3,744,4,4220,144,40
2551,254,3,745,7,4227,136,70
2552,254,3,746,5,4232,1,50
2553,254,3,747,2,4234,1,20
2554,254,3,748,6,4240,139,60
2555,254,3,749,9,4249,1,90
2556,254,3,750,6,4255,123,60
2557,254,3,751,7,4262,1,70
2558,254,3,752,9,4271,1,90
2559,254,3,753,2,4273,128,20
2560,254,3,754,8,4281,1,80
2561,254,3,755,4,4285,1,40
2562,254,3,756,9,4294,1,90
2563,254,3,757,5,4299,1,50
2564,254,3,758,7,4306,203,70
2565,254,3,759,9,4315,168,90
2566,254,3,760,7,4322,1,70
2567,254,3,761,6,4328,134,60
2568,254,3,762,2,4330,1,20
2569,254,3,763,9,4339,1,90
2570,254,3,764,7,4346,1,70
2571,254,3,765,8,4354,1,80
2572,254,3,766,7,4361,1,70
2573,254,3,767,8,4369,232,80
2574,254,3,768,8,4377,1,80
2575,254,3,769,4,4381,1,40
2576,254,3,770,4,4385,1,40
2577,254,3,771,2,4387,1,20
2578,254,3,772,4,4391,1,40
2579,254,3,773,5,4396,1,50
2580,254,3,774,2,4398,259,20
2581,254,3,775,3,4401,1,30
2582,254,3,776,2,4403,1,20
2583,254,3,777,3,4406,1,30
2584,254,3,778,7,4413,1,70
2585,254,3,779,6,4419,1,60
2586,254,3,780,8,4427,260,80
2587,254,3,781,2,4429,1,20
2588,254,3,782,3,4432,1,30
2589,254,3,783,4,4436,1,40
2590,254,3,784,4,4440,1,40
2591,254,3,785,4,4444,1,40
2592,254,3,786,3,4447,1,30
2593,254,3,787,4,4451,243,40
2594,254,3,788,2,4453,1,20
2595,254,3,789,3,4456,1,30
2596,254,3,790,5,4461,1,50
2597,254,3,791,4,4465,1,40
2598,254,3,792,8,4473,239,80
2599,254,3,793,5,4478,1,50
2600,254,3,794,3,4481,1,30
2601,254,3,795,8,4489,1,80
2602,254,3,796,6,4495,243,60
2603,254,3,797,8,4503,1,80
2604,254,3,798,3,4506,1,30
2605,254,3,799,9,4515,1,90
2606,254,3,800,7,4522,1,70
2607,254,3,801,8,4530,1,80
2608,254,3,802,4,4534,1,40
2609,254,3,803,6,4540,1,60
2610,254,3,804,2,4542,1,20
2611,254,3,805,3,4545,1,30
2612,254,3,806,9,4554,1,90
2613,254,3,807,4,4558,1,40
2614,254,3,808,9,4567,1,90
2615,254,3,809,4,4571,1,40
2616,254,3,810,2,4573,1,20
2617,254,3,811,9,4582,1,90
2618,254,3,812,2,4584,1,20
2619,254,3,813,7,4591,1,70
2620,254,3,814,7,4598,1,70
2621,254,3,815,5,4603,1,50
2622,254,3,816,7,4610,1,70
2623,254,3,817,8,4618,1,80
2624,254,3,818,3,4621,1,30
2625,254,3,819,6,4627,1,60
2626,254,3,820,6,4633,632,60
2627,254,3,821,3,4636,1,30
2628,254,3,822,4,4640,1,40
2629,254,3,823,6,4646,1,60
2630,254,3,824,4,4650,494,40
2631,254,3,825,4,4654,1,40
2632,254,3,826,7,4661,1,70
2633,254,3,827,7,4668,1,70
2634,254,3,828,9,4677,413,90
2635,254,3,829,7,4684,1,70
2636,254,3,830,4,4688,1,40
2637,254,3,831,3,4691,1,30
2638,254,3,832,3,4694,323,30
2639,254,3,833,6,4700,217,60
2640,254,3,834,3,4703,164,30
2641,254,3,835,7,4710,1,70
2642,254,3,836,7,4717,1,70
2643,254,3,837,4,4721,181,40
2644,254,3,838,8,4729,1,80
2645,254,3,839,2,4731,1,20
2646,254,3,840,7,4738,1,70
2647,254,3,841,8,4746,181,80
2648,254,3,842,9,4755,1,90
2649,254,3,843,7,4762,161,70
2650,254,3,844,4,4766,1,40
2651,254,3,845,6,4772,155,60
2652,254,3,846,7,4779,1,70
2653,254,3,847,5,4784,1,50
2654,254,3,848,7,4791,1,70
2655,254,3,849,9,4800,211,90
2656,254,3,850,6,4806,1,60
2657,254,3,851,8,4814,171,80
2658,254,3,852,3,4817,1,30
2659,254,3,853,7,4824,1,70
2660,254,3,854,5,4829,1,50
2661,254,3,855,4,4833,172,40
2662,254,3,856,9,4842,130,90
2663,254,3,857,6,4848,1,60
2664,254,3,858,5,4853,1,50
2665,254,3,859,9,4862,1,90
2666,254,3,860,3,4865,1,30
2667,254,3,861,2,4867,188,20
2668,254,3,862,2,4869,1,20
2669,254,3,863,7,4876,1,70
2670,254,3,864,9,4885,175,90
2671,254,3,865,8,4893,1,80
2672,254,3,866,6,4899,155,60
2673,254,3,867,3,4902,1,30
2674,254,3,868,6,4908,140,60
2675,254,3,869,7,4915,1,70
2676,254,3,870,2,4917,113,20
2677,254,3,871,2,4919,1,20
2678,254,3,872,9,4928,1,90
2679,254,3,873,3,4931,1,30
2680,254,3,874,6,4937,1,60
2681,254,3,875,9,4946,199,90
2682,254,3,876,5,4951,140,50
2683,254,3,877,9,4960,1,90
2684,254,3,878,2,4962,1,20
2685,254,3,879,3,4965,131,30
2686,254,3,880,8,4973,1,80
2687,254,3,881,5,4978,1,50
2688,254,3,882,9,4987,1,90
2689,254,3,883,6,4993,1,60
