,Scenario,Trial,Inspection,Interval,Time,Accumulation,Defects,Rate
0,69,1,1,4,4,37,24,40
1,69,1,2,3,7,43,24,30
2,69,1,3,7,14,75,40,70
3,69,1,4,4,18,79,54,40
4,69,1,5,8,26,111,72,80
5,69,1,6,3,29,61,61,30
6,69,1,7,8,37,77,77,80
7,69,1,8,4,41,50,27,40
8,69,1,9,9,50,104,54,90
9,69,1,10,2,52,80,52,20
10,69,1,11,9,61,110,67,90
11,69,1,12,2,63,72,43,20
12,69,1,13,3,66,62,43,30
13,69,1,14,9,75,127,69,90
14,69,1,15,6,81,126,84,60
15,69,1,16,3,84,69,40,30
16,69,1,17,4,88,70,44,40
17,69,1,18,7,95,94,94,70
18,69,1,19,8,103,79,49,80
19,69,1,20,5,108,76,42,50
20,69,1,21,9,117,126,126,90
21,69,1,22,2,119,16,11,20
22,69,1,23,4,123,51,33,40
23,69,1,24,6,129,87,51,60
24,69,1,25,8,137,110,68,80
25,69,1,26,7,144,108,108,70
26,69,1,27,4,148,40,24,40
27,69,1,28,2,150,39,20,20
28,69,1,29,2,152,38,20,20
29,69,1,30,8,160,84,45,80
30,69,1,31,4,164,76,45,40
31,69,1,32,7,171,110,72,70
32,69,1,33,3,174,71,71,30
33,69,1,34,8,182,77,47,80
34,69,1,35,7,189,94,49,70
35,69,1,36,2,191,65,42,20
36,69,1,37,7,198,90,57,70
37,69,1,38,9,207,125,125,90
38,69,1,39,9,216,99,66,90
39,69,1,40,4,220,69,69,40
40,69,1,41,6,226,63,35,60
41,69,1,42,4,230,76,47,40
42,69,1,43,9,239,127,72,90
43,69,1,44,9,248,157,157,90
44,69,1,45,6,254,58,37,60
45,69,1,46,6,260,90,56,60
46,69,1,47,2,262,53,35,20
47,69,1,48,8,270,94,58,80
48,69,1,49,6,276,100,61,60
49,69,1,50,3,279,72,43,30
50,69,1,51,7,286,98,55,70
51,69,1,52,3,289,64,38,30
52,69,1,53,6,295,102,60,60
53,69,1,54,2,297,69,40,20
54,69,1,55,5,302,77,41,50
55,69,1,56,3,305,62,42,30
56,69,1,57,5,310,69,42,50
57,69,1,58,8,318,110,110,80
58,69,1,59,6,324,61,39,60
59,69,1,60,7,331,91,54,70
60,69,1,61,5,336,78,78,50
61,69,1,62,5,341,54,27,50
62,69,1,63,3,344,56,56,30
63,69,1,64,4,348,50,34,40
64,69,1,65,4,352,64,37,40
65,69,1,66,9,361,117,66,90
66,69,1,67,9,370,139,91,90
67,69,1,68,6,376,108,61,60
68,69,1,69,8,384,129,71,80
69,69,1,70,6,390,141,86,60
70,69,1,71,6,396,133,87,60
71,69,1,72,3,399,81,46,30
72,69,1,73,9,408,127,78,90
73,69,1,74,7,415,108,65,70
74,69,1,75,6,421,86,55,60
75,69,1,76,7,428,100,100,70
76,69,1,77,8,436,59,33,80
77,69,1,78,2,438,53,53,20
78,69,1,79,3,441,36,22,30
79,69,1,80,8,449,92,61,80
80,69,1,81,5,454,71,71,50
81,69,1,82,3,457,29,18,30
82,69,1,83,3,460,32,32,30
83,69,1,84,9,469,86,52,90
84,69,1,85,2,471,47,27,20
85,69,1,86,6,477,71,71,60
86,69,1,87,6,483,66,32,60
87,69,1,88,5,488,78,45,50
88,69,1,89,6,494,92,49,60
89,69,1,90,2,496,71,45,20
90,69,1,91,9,505,111,72,90
91,69,1,92,7,512,102,61,70
92,69,1,93,4,516,86,50,40
93,69,1,94,5,521,83,38,50
94,69,1,95,6,527,108,65,60
95,69,1,96,3,530,77,47,30
96,69,1,97,4,534,71,71,40
97,69,1,98,7,541,69,38,70
98,69,1,99,5,546,76,41,50
99,69,1,100,3,549,61,37,30
100,69,1,101,4,553,77,45,40
101,69,1,102,7,560,101,61,70
102,69,1,103,6,566,106,64,60
103,69,1,104,9,575,136,81,90
104,69,1,105,3,578,80,80,30
105,69,1,106,7,585,62,62,70
106,69,1,107,2,587,18,8,20
107,69,1,108,3,590,33,33,30
108,69,1,109,9,599,93,63,90
109,69,1,110,5,604,74,40,50
110,69,1,111,3,607,70,48,30
111,69,1,112,7,614,87,60,70
112,69,1,113,8,622,126,76,80
113,69,1,114,8,630,133,79,80
114,69,1,115,3,633,89,48,30
115,69,1,116,3,636,65,65,30
116,69,1,117,7,643,62,33,70
117,69,1,118,7,650,84,47,70
118,69,1,119,8,658,114,65,80
119,69,1,120,6,664,104,53,60
120,69,1,121,9,673,127,127,90
121,69,1,122,2,675,17,17,20
122,69,1,123,3,678,31,18,30
123,69,1,124,9,687,91,54,90
124,69,1,125,3,690,69,44,30
125,69,1,126,7,697,109,74,70
126,69,1,127,7,704,94,60,70
127,69,1,128,2,706,59,36,20
128,69,1,129,8,714,106,66,80
129,69,1,130,5,719,87,87,50
130,69,1,131,6,725,59,59,60
131,69,1,132,8,733,77,42,80
132,69,1,133,2,735,52,52,20
133,69,1,134,6,741,60,60,60
134,69,1,135,2,743,13,8,20
135,69,1,136,5,748,55,28,50
136,69,1,137,8,756,119,77,80
137,69,1,138,6,762,101,67,60
138,69,1,139,9,771,136,75,90
139,69,1,140,7,778,119,71,70
140,69,1,141,2,780,64,38,20
141,69,1,142,2,782,41,30,20
142,69,1,143,5,787,60,34,50
143,69,1,144,4,791,63,63,40
144,69,1,145,7,798,64,64,70
145,69,1,146,7,805,64,64,70
146,69,1,147,2,807,23,14,20
147,69,1,148,9,816,108,108,90
148,69,1,149,4,820,28,15,40
149,69,1,150,7,827,82,46,70
150,69,1,151,7,834,108,59,70
151,69,1,152,8,842,127,74,80
152,69,1,153,5,847,108,59,50
153,69,1,154,9,856,150,150,90
154,69,1,155,9,865,101,61,90
155,69,1,156,4,869,77,45,40
156,69,1,157,9,878,124,72,90
157,69,1,158,8,886,122,70,80
158,69,1,159,9,895,143,90,90
159,69,1,160,8,903,144,86,80
160,69,1,161,7,910,116,72,70
161,69,1,162,3,913,73,40,30
162,69,1,163,6,919,83,83,60
163,69,1,164,6,925,61,35,60
164,69,1,165,8,933,92,60,80
165,69,1,166,5,938,79,51,50
166,69,1,167,6,944,77,77,60
167,69,1,168,5,949,53,31,50
168,69,1,169,6,955,83,49,60
169,69,1,170,4,959,67,40,40
170,69,1,171,6,965,97,62,60
171,69,1,172,6,971,88,54,60
172,69,1,173,4,975,67,37,40
173,69,1,174,8,983,119,66,80
174,69,1,175,8,991,137,75,80
175,69,1,176,6,997,114,70,60
176,69,1,177,3,1000,71,71,30
177,69,1,178,3,1003,29,19,30
178,69,1,179,3,1006,37,22,30
179,69,1,180,5,1011,56,34,50
180,69,1,181,7,1018,89,48,70
181,69,1,182,5,1023,87,49,50
182,69,1,183,7,1030,105,71,70
183,69,1,184,6,1036,94,54,60
184,69,1,185,9,1045,127,81,90
185,69,1,186,9,1054,136,136,90
186,69,1,187,2,1056,17,13,20
187,69,1,188,5,1061,43,26,50
188,69,1,189,3,1064,41,21,30
189,69,1,190,5,1069,66,41,50
190,69,1,191,9,1078,110,62,90
191,69,1,192,2,1080,65,65,20
192,69,1,193,5,1085,46,24,50
193,69,1,194,2,1087,43,27,20
194,69,1,195,3,1090,41,25,30
195,69,1,196,3,1093,51,31,30
196,69,1,197,8,1101,101,61,80
197,69,1,198,2,1103,55,55,20
198,69,1,199,5,1108,41,22,50
199,69,1,200,2,1110,41,41,20
200,69,1,201,3,1113,38,22,30
201,69,1,202,9,1122,112,66,90
202,69,1,203,2,1124,60,35,20
203,69,1,204,4,1128,71,41,40
204,69,1,205,5,1133,79,51,50
205,69,1,206,8,1141,109,73,80
206,69,1,207,6,1147,97,97,60
207,69,1,208,8,1155,81,51,80
208,69,1,209,9,1164,105,62,90
209,69,1,210,3,1167,71,37,30
210,69,1,211,2,1169,54,32,20
211,69,1,212,4,1173,67,44,40
212,69,1,213,4,1177,55,30,40
213,69,1,214,9,1186,117,117,90
214,69,1,215,4,1190,36,36,40
215,69,1,216,7,1197,53,31,70
216,69,1,217,2,1199,44,20,20
217,69,1,218,6,1205,88,88,60
218,69,1,219,7,1212,63,39,70
219,69,1,220,8,1220,94,55,80
220,69,1,221,7,1227,106,59,70
221,69,1,222,4,1231,82,49,40
222,69,1,223,6,1237,101,101,60
223,69,1,224,4,1241,33,21,40
224,69,1,225,4,1245,48,23,40
225,69,1,226,2,1247,49,25,20
226,69,1,227,9,1256,100,54,90
227,69,1,228,9,1265,133,91,90
228,69,1,229,4,1269,87,87,40
229,69,1,230,8,1277,66,43,80
230,69,1,231,3,1280,65,33,30
231,69,1,232,7,1287,111,66,70
232,69,1,233,6,1293,94,63,60
233,69,1,234,8,1301,94,58,80
234,69,1,235,4,1305,89,53,40
235,69,1,236,5,1310,80,52,50
236,69,1,237,8,1318,109,64,80
237,69,1,238,4,1322,85,56,40
238,69,1,239,2,1324,53,34,20
239,69,1,240,5,1329,72,43,50
240,69,1,241,9,1338,117,84,90
241,69,1,242,2,1340,55,35,20
242,69,1,243,3,1343,54,54,30
243,69,1,244,5,1348,59,26,50
244,69,1,245,3,1351,69,39,30
245,69,1,246,6,1357,93,64,60
246,69,1,247,5,1362,84,45,50
247,69,1,248,3,1365,75,47,30
248,69,1,249,4,1369,62,37,40
249,69,1,250,3,1372,62,34,30
250,69,1,251,2,1374,50,50,20
251,69,1,252,8,1382,84,54,80
252,69,1,253,6,1388,85,49,60
253,69,1,254,6,1394,90,53,60
254,69,1,255,2,1396,57,33,20
255,69,1,256,5,1401,81,48,50
256,69,1,257,4,1405,73,39,40
257,69,1,258,2,1407,52,29,20
258,69,1,259,4,1411,61,39,40
259,69,1,260,7,1418,77,46,70
260,69,1,261,6,1424,84,84,60
261,69,1,262,6,1430,58,33,60
262,69,1,263,4,1434,59,34,40
263,69,1,264,6,1440,64,64,60
264,69,1,265,3,1443,31,31,30
265,69,1,266,4,1447,41,41,40
266,69,1,267,6,1453,57,40,60
267,69,1,268,8,1461,101,58,80
268,69,1,269,2,1463,68,35,20
269,69,1,270,8,1471,103,103,80
270,69,1,271,9,1480,110,54,90
271,69,1,272,2,1482,74,40,20
272,69,1,273,3,1485,63,63,30
273,69,1,274,7,1492,65,65,70
274,69,1,275,2,1494,22,14,20
275,69,1,276,4,1498,47,25,40
276,69,1,277,7,1505,93,56,70
277,69,1,278,9,1514,114,74,90
278,69,1,279,8,1522,125,70,80
279,69,1,280,2,1524,70,43,20
280,69,1,281,7,1531,111,68,70
281,69,1,282,9,1540,134,134,90
282,69,1,283,7,1547,72,43,70
283,69,1,284,2,1549,46,46,20
284,69,1,285,9,1558,97,97,90
285,69,1,286,3,1561,30,16,30
286,69,1,287,9,1570,81,51,90
287,69,1,288,6,1576,81,81,60
288,69,1,289,4,1580,44,31,40
289,69,1,290,2,1582,31,16,20
290,69,1,291,8,1590,95,55,80
291,69,1,292,7,1597,111,66,70
292,69,1,293,7,1604,114,64,70
293,69,1,294,8,1612,145,145,80
294,69,1,295,4,1616,47,27,40
295,69,1,296,9,1625,105,105,90
296,69,1,297,3,1628,28,17,30
297,69,1,298,2,1630,37,21,20
298,69,1,299,6,1636,62,38,60
299,69,1,300,2,1638,49,49,20
300,69,1,301,2,1640,22,14,20
301,69,1,302,6,1646,75,39,60
302,69,1,303,8,1654,115,66,80
303,69,1,304,2,1656,69,45,20
304,69,1,305,6,1662,71,45,60
305,69,1,306,3,1665,55,31,30
306,69,1,307,3,1668,68,36,30
307,69,1,308,4,1672,68,36,40
308,69,1,309,2,1674,51,32,20
309,69,1,310,8,1682,98,53,80
310,69,1,311,6,1688,96,56,60
311,69,1,312,7,1695,110,66,70
312,69,1,313,9,1704,128,128,90
313,69,1,314,2,1706,23,14,20
314,69,1,315,8,1714,88,62,80
315,69,1,316,7,1721,102,58,70
316,69,1,317,7,1728,117,117,70
317,69,1,318,2,1730,18,10,20
318,69,1,319,9,1739,111,68,90
319,69,1,320,4,1743,84,47,40
320,69,1,321,2,1745,57,37,20
321,69,1,322,5,1750,58,36,50
322,69,1,323,8,1758,96,53,80
323,69,1,324,2,1760,64,30,20
324,69,1,325,7,1767,110,68,70
325,69,1,326,8,1775,124,75,80
326,69,1,327,7,1782,123,123,70
327,69,1,328,3,1785,26,26,30
328,69,1,329,2,1787,15,7,20
329,69,1,330,2,1789,33,33,20
330,69,1,331,7,1796,57,33,70
331,69,1,332,4,1800,68,41,40
332,69,1,333,8,1808,98,59,80
333,69,1,334,8,1816,114,65,80
334,69,1,335,5,1821,96,53,50
335,69,1,336,2,1823,65,65,20
336,69,1,337,2,1825,11,7,20
337,69,1,338,2,1827,23,14,20
338,69,1,339,5,1832,54,30,50
339,69,1,340,5,1837,63,63,50
340,69,1,341,8,1845,88,88,80
341,69,1,342,9,1854,79,46,90
342,69,1,343,9,1863,128,81,90
343,69,1,344,7,1870,121,121,70
344,69,1,345,3,1873,32,18,30
345,69,1,346,3,1876,45,45,30
346,69,1,347,5,1881,47,27,50
347,69,1,348,7,1888,83,57,70
348,69,1,349,9,1897,131,88,90
349,69,1,350,3,1900,78,48,30
350,69,1,351,8,1908,116,72,80
351,69,1,352,9,1917,127,80,90
352,69,1,353,7,1924,130,74,70
353,69,1,354,7,1931,105,105,70
354,69,1,355,8,1939,80,49,80
355,69,1,356,4,1943,67,39,40
356,69,1,357,2,1945,52,26,20
357,69,1,358,7,1952,88,53,70
358,69,1,359,4,1956,82,51,40
359,69,1,360,2,1958,49,26,20
360,69,1,361,8,1966,117,60,80
361,69,1,362,7,1973,129,78,70
362,69,1,363,7,1980,108,108,70
363,69,1,364,5,1985,38,25,50
364,69,1,365,4,1989,48,30,40
365,69,1,366,2,1991,32,23,20
366,69,1,367,3,1994,36,21,30
367,69,1,368,9,2003,96,96,90
368,69,1,369,9,2012,97,55,90
369,69,1,370,8,2020,124,79,80
370,69,1,371,2,2022,64,45,20
371,69,1,372,4,2026,69,38,40
372,69,1,373,3,2029,70,70,30
373,69,1,374,9,2038,96,96,90
374,69,1,375,8,2046,95,53,80
375,69,1,376,7,2053,110,110,70
376,69,1,377,5,2058,62,38,50
377,69,1,378,9,2067,111,57,90
378,69,1,379,9,2076,134,134,90
379,69,1,380,2,2078,23,13,20
380,69,1,381,5,2083,67,43,50
381,69,1,382,8,2091,108,108,80
382,69,1,383,9,2100,95,57,90
383,69,1,384,8,2108,110,110,80
384,69,1,385,5,2113,49,28,50
385,69,1,386,3,2116,51,29,30
386,69,1,387,8,2124,120,77,80
387,69,1,388,5,2129,81,55,50
388,69,1,389,5,2134,67,38,50
389,69,1,390,5,2139,74,74,50
390,69,1,391,6,2145,66,44,60
391,69,1,392,9,2154,116,56,90
392,69,1,393,3,2157,94,94,30
393,69,1,394,9,2166,83,51,90
394,69,1,395,4,2170,81,49,40
395,69,1,396,4,2174,77,47,40
396,69,1,397,4,2178,73,48,40
397,69,1,398,8,2186,100,100,80
398,69,1,399,3,2189,30,17,30
399,69,1,400,3,2192,43,24,30
400,69,1,401,4,2196,46,21,40
401,69,1,402,8,2204,107,50,80
402,69,1,403,4,2208,99,62,40
403,69,1,404,8,2216,120,120,80
404,69,1,405,6,2222,66,41,60
405,69,1,406,8,2230,110,70,80
406,69,1,407,4,2234,86,86,40
407,69,1,408,5,2239,49,27,50
408,69,1,409,8,2247,110,73,80
409,69,1,410,3,2250,58,35,30
410,69,1,411,6,2256,84,46,60
411,69,1,412,3,2259,64,40,30
412,69,1,413,3,2262,58,35,30
413,69,1,414,2,2264,47,29,20
414,69,1,415,6,2270,83,46,60
415,69,1,416,6,2276,93,55,60
416,69,1,417,2,2278,49,28,20
417,69,1,418,5,2283,61,34,50
418,69,1,419,2,2285,49,30,20
419,69,1,420,8,2293,99,53,80
420,69,1,421,4,2297,92,92,40
421,69,1,422,6,2303,61,32,60
422,69,1,423,5,2308,86,86,50
423,69,1,424,6,2314,63,34,60
424,69,1,425,2,2316,50,50,20
425,69,1,426,7,2323,79,58,70
426,69,1,427,8,2331,104,56,80
427,69,1,428,9,2340,142,78,90
428,69,1,429,5,2345,114,72,50
429,69,1,430,5,2350,98,63,50
430,69,1,431,3,2353,55,33,30
431,69,1,432,8,2361,80,49,80
432,69,1,433,5,2366,78,78,50
433,69,1,434,4,2370,43,24,40
434,69,1,435,7,2377,88,53,70
435,69,1,436,3,2380,66,41,30
436,69,1,437,2,2382,47,27,20
437,69,1,438,8,2390,95,58,80
438,69,1,439,5,2395,96,59,50
439,69,1,440,8,2403,119,119,80
440,69,1,441,8,2411,97,59,80
441,69,1,442,4,2415,85,46,40
442,69,1,443,6,2421,117,77,60
443,69,1,444,9,2430,121,73,90
444,69,1,445,2,2432,67,43,20
445,69,1,446,5,2437,75,44,50
446,69,1,447,4,2441,66,37,40
447,69,1,448,5,2446,97,61,50
448,69,1,449,3,2449,64,37,30
449,69,1,450,5,2454,73,41,50
450,69,1,451,4,2458,76,52,40
451,69,1,452,7,2465,107,107,70
452,69,1,453,7,2472,69,41,70
453,69,1,454,9,2481,102,62,90
454,69,1,455,4,2485,74,50,40
455,69,1,456,8,2493,110,69,80
456,69,1,457,7,2500,112,63,70
457,69,1,458,3,2503,80,43,30
458,69,1,459,5,2508,93,55,50
459,69,1,460,9,2517,124,67,90
460,69,1,461,2,2519,82,43,20
461,69,1,462,9,2528,120,68,90
462,69,1,463,5,2533,104,53,50
463,69,1,464,2,2535,72,72,20
464,69,1,465,2,2537,18,12,20
465,69,1,466,8,2545,74,41,80
466,69,1,467,3,2548,58,32,30
467,69,1,468,9,2557,118,74,90
468,69,1,469,8,2565,136,93,80
469,69,1,470,8,2573,118,65,80
470,69,1,471,7,2580,120,75,70
471,69,1,472,4,2584,87,87,40
472,69,1,473,5,2589,57,37,50
473,69,1,474,9,2598,109,62,90
474,69,1,475,6,2604,115,77,60
475,69,1,476,5,2609,96,67,50
476,69,1,477,4,2613,71,71,40
477,69,1,478,3,2616,27,13,30
478,69,1,479,5,2621,70,50,50
479,69,1,480,4,2625,71,41,40
480,69,1,481,4,2629,81,52,40
481,69,1,482,3,2632,50,29,30
482,69,1,483,7,2639,98,60,70
483,69,1,484,2,2641,60,60,20
484,69,1,485,5,2646,44,44,50
485,69,1,486,4,2650,24,12,40
486,69,1,487,4,2654,40,28,40
487,69,1,488,4,2658,54,54,40
488,69,1,489,9,2667,104,104,90
489,69,1,490,8,2675,85,55,80
490,69,1,491,4,2679,66,41,40
491,69,1,492,5,2684,86,49,50
492,69,1,493,2,2686,54,30,20
493,69,1,494,7,2693,92,60,70
494,69,1,495,6,2699,87,56,60
495,69,1,496,8,2707,100,57,80
496,69,1,497,2,2709,62,32,20
497,69,1,498,9,2718,108,59,90
498,69,1,499,5,2723,92,53,50
499,69,1,500,9,2732,132,75,90
500,69,1,501,2,2734,71,36,20
501,69,1,502,4,2738,65,42,40
502,69,1,503,8,2746,110,62,80
503,69,1,504,5,2751,96,53,50
504,69,1,505,2,2753,63,63,20
505,69,1,506,5,2758,49,32,50
506,69,1,507,8,2766,91,45,80
507,69,1,508,3,2769,79,50,30
508,69,1,509,6,2775,91,48,60
509,69,1,510,6,2781,92,52,60
510,69,1,511,4,2785,83,58,40
511,69,1,512,3,2788,52,34,30
512,69,1,513,4,2792,66,40,40
513,69,1,514,3,2795,61,36,30
514,69,1,515,6,2801,78,78,60
515,69,1,516,2,2803,21,14,20
516,69,1,517,3,2806,34,21,30
517,69,1,518,7,2813,89,52,70
518,69,1,519,7,2820,124,124,70
519,69,1,520,4,2824,48,34,40
520,69,1,521,3,2827,55,30,30
521,69,1,522,4,2831,70,42,40
522,69,1,523,2,2833,51,26,20
523,69,1,524,6,2839,85,52,60
524,69,1,525,6,2845,103,59,60
525,69,1,526,5,2850,111,111,50
526,69,1,527,8,2858,73,40,80
527,69,1,528,4,2862,59,59,40
528,69,1,529,2,2864,18,18,20
529,69,1,530,2,2866,20,7,20
530,69,1,531,7,2873,78,46,70
531,69,1,532,9,2882,114,114,90
532,69,1,533,4,2886,38,23,40
533,69,1,534,7,2893,90,57,70
534,69,1,535,5,2898,79,79,50
535,69,1,536,2,2900,25,12,20
536,69,1,537,5,2905,54,36,50
537,69,1,538,2,2907,35,18,20
538,69,1,539,9,2916,110,110,90
539,69,1,540,7,2923,73,41,70
540,69,1,541,3,2926,63,37,30
541,69,1,542,4,2930,73,73,40
542,69,1,543,6,2936,46,29,60
543,69,1,544,5,2941,78,48,50
544,69,1,545,6,2947,89,50,60
545,69,1,546,9,2956,135,135,90
546,69,1,547,4,2960,41,23,40
547,69,1,548,2,2962,35,21,20
548,69,1,549,7,2969,90,55,70
549,69,1,550,5,2974,75,42,50
550,69,1,551,2,2976,52,31,20
551,69,1,552,7,2983,92,59,70
552,69,1,553,4,2987,72,50,40
553,69,1,554,7,2994,92,92,70
554,69,1,555,4,2998,46,26,40
555,69,1,556,8,3006,97,61,80
556,69,1,557,3,3009,53,29,30
557,69,1,558,8,3017,98,63,80
558,69,1,559,9,3026,120,72,90
559,69,1,560,2,3028,73,40,20
560,69,1,561,7,3035,99,56,70
561,69,1,562,3,3038,68,68,30
562,69,1,563,6,3044,58,37,60
563,69,1,564,6,3050,72,72,60
564,69,1,565,5,3055,52,29,50
565,69,1,566,7,3062,80,50,70
566,69,1,567,3,3065,56,37,30
567,69,1,568,8,3073,97,97,80
568,69,1,569,7,3080,70,44,70
569,69,1,570,8,3088,105,105,80
570,69,1,571,5,3093,46,29,50
571,69,1,572,7,3100,70,40,70
572,69,1,573,6,3106,92,56,60
573,69,1,574,5,3111,93,93,50
574,69,1,575,3,3114,39,22,30
575,69,1,576,2,3116,43,26,20
576,69,1,577,6,3122,76,41,60
577,69,1,578,4,3126,78,39,40
578,69,1,579,4,3130,74,74,40
579,69,1,580,4,3134,31,31,40
580,69,1,581,2,3136,24,12,20
581,69,1,582,5,3141,56,36,50
582,69,1,583,9,3150,108,51,90
583,69,1,584,9,3159,147,147,90
584,69,1,585,6,3165,60,38,60
585,69,1,586,9,3174,102,57,90
586,69,1,587,6,3180,86,56,60
587,69,1,588,9,3189,120,72,90
588,69,1,589,3,3192,78,52,30
589,69,1,590,2,3194,53,28,20
590,69,1,591,7,3201,88,58,70
591,69,1,592,8,3209,121,77,80
592,69,1,593,4,3213,86,86,40
593,69,1,594,6,3219,60,34,60
594,69,1,595,5,3224,75,75,50
595,69,1,596,4,3228,43,24,40
596,69,1,597,7,3235,92,51,70
597,69,1,598,5,3240,91,50,50
598,69,1,599,6,3246,99,53,60
599,69,1,600,2,3248,61,36,20
600,69,1,601,7,3255,101,56,70
601,69,1,602,7,3262,115,75,70
602,69,1,603,9,3271,143,84,90
603,69,1,604,4,3275,89,51,40
604,69,1,605,5,3280,77,40,50
605,69,1,606,2,3282,56,36,20
606,69,1,607,4,3286,70,42,40
607,69,1,608,9,3295,131,131,90
608,69,1,609,9,3304,101,62,90
609,69,1,610,9,3313,133,76,90
610,69,1,611,9,3322,151,97,90
611,69,1,612,2,3324,74,43,20
612,69,1,613,5,3329,68,41,50
613,69,1,614,2,3331,47,28,20
614,69,1,615,8,3339,83,83,80
615,69,1,616,3,3342,19,10,30
616,69,1,617,5,3347,50,25,50
617,69,1,618,9,3356,117,67,90
618,69,1,619,2,3358,67,67,20
619,69,1,620,4,3362,28,15,40
620,69,1,621,5,3367,64,37,50
621,69,1,622,7,3374,105,63,70
622,69,1,623,6,3380,94,94,60
623,69,1,624,2,3382,23,23,20
624,69,1,625,7,3389,75,44,70
625,69,1,626,6,3395,87,55,60
626,69,1,627,9,3404,108,72,90
627,69,1,628,9,3413,122,122,90
628,69,1,629,4,3417,38,22,40
629,69,1,630,4,3421,57,32,40
630,69,1,631,3,3424,59,32,30
631,69,1,632,2,3426,44,44,20
632,69,1,633,6,3432,54,54,60
633,69,1,634,9,3441,101,68,90
634,69,1,635,5,3446,70,46,50
635,69,1,636,2,3448,48,30,20
636,69,1,637,2,3450,35,35,20
637,69,1,638,4,3454,33,33,40
638,69,1,639,6,3460,53,31,60
639,69,1,640,5,3465,75,43,50
640,69,1,641,4,3469,74,45,40
641,69,1,642,7,3476,109,66,70
642,69,1,643,7,3483,109,71,70
643,69,1,644,8,3491,123,75,80
644,69,1,645,8,3499,139,80,80
645,69,1,646,5,3504,112,67,50
646,69,1,647,3,3507,68,68,30
647,69,1,648,8,3515,76,41,80
648,69,1,649,4,3519,78,43,40
649,69,1,650,2,3521,46,46,20
650,69,1,651,9,3530,89,89,90
651,69,1,652,4,3534,34,21,40
652,69,1,653,9,3543,98,66,90
653,69,1,654,3,3546,65,39,30
654,69,1,655,8,3554,92,50,80
655,69,1,656,2,3556,57,57,20
656,69,1,657,7,3563,72,43,70
657,69,1,658,4,3567,66,37,40
658,69,1,659,5,3572,83,50,50
659,69,1,660,6,3578,107,76,60
660,69,1,661,3,3581,50,22,30
661,69,1,662,7,3588,108,72,70
662,69,1,663,9,3597,127,77,90
663,69,1,664,5,3602,113,113,50
664,69,1,665,3,3605,30,20,30
665,69,1,666,3,3608,58,30,30
666,69,1,667,4,3612,62,62,40
667,69,1,668,5,3617,49,32,50
668,69,1,669,2,3619,44,20,20
669,69,1,670,3,3622,68,41,30
670,69,1,671,5,3627,75,52,50
671,69,1,672,7,3634,98,98,70
672,69,1,673,9,3643,95,62,90
673,69,1,674,5,3648,72,72,50
674,69,1,675,7,3655,64,41,70
675,69,1,676,6,3661,86,47,60
676,69,1,677,3,3664,62,62,30
677,69,1,678,6,3670,57,35,60
678,69,1,679,8,3678,92,51,80
679,69,1,680,3,3681,71,51,30
680,69,1,681,5,3686,54,29,50
681,69,1,682,3,3689,56,56,30
682,69,1,683,9,3698,71,45,90
683,69,1,684,8,3706,101,59,80
684,69,1,685,4,3710,85,48,40
685,69,1,686,9,3719,138,138,90
686,69,1,687,2,3721,17,10,20
687,69,1,688,4,3725,47,31,40
688,69,1,689,6,3731,84,56,60
689,69,1,690,3,3734,59,38,30
690,69,1,691,3,3737,50,23,30
691,69,1,692,7,3744,108,59,70
692,69,1,693,7,3751,111,66,70
693,69,1,694,9,3760,128,74,90
694,69,1,695,7,3767,118,118,70
695,69,1,696,4,3771,42,42,40
696,69,1,697,4,3775,34,19,40
697,69,1,698,6,3781,85,85,60
698,69,1,699,4,3785,47,26,40
699,69,1,700,3,3788,53,37,30
700,69,1,701,7,3795,72,72,70
701,69,1,702,5,3800,46,28,50
702,69,1,703,8,3808,90,90,80
703,69,1,704,3,3811,31,21,30
704,69,1,705,3,3814,42,42,30
705,69,1,706,9,3823,90,90,90
706,69,1,707,7,3830,71,47,70
707,69,1,708,4,3834,80,48,40
708,69,1,709,5,3839,76,38,50
709,69,1,710,5,3844,84,52,50
710,69,1,711,7,3851,90,61,70
711,69,1,712,3,3854,56,35,30
712,69,1,713,6,3860,79,47,60
713,69,1,714,9,3869,125,79,90
714,69,1,715,6,3875,108,63,60
715,69,1,716,5,3880,111,74,50
716,69,1,717,7,3887,94,55,70
717,69,1,718,6,3893,105,57,60
718,69,1,719,4,3897,83,55,40
719,69,1,720,4,3901,59,34,40
720,69,1,721,5,3906,77,77,50
721,69,1,722,9,3915,80,47,90
722,69,1,723,7,3922,95,49,70
723,69,1,724,7,3929,121,78,70
724,69,1,725,7,3936,135,76,70
725,69,1,726,8,3944,124,124,80
726,69,1,727,7,3951,68,41,70
727,69,1,728,7,3958,100,100,70
728,69,1,729,5,3963,43,30,50
729,69,1,730,8,3971,93,57,80
730,69,1,731,5,3976,84,48,50
731,69,1,732,6,3982,99,99,60
732,69,1,733,8,3990,84,49,80
733,69,1,734,5,3995,77,77,50
734,69,1,735,6,4001,57,38,60
735,69,1,736,9,4010,94,49,90
736,69,1,737,9,4019,122,122,90
737,69,1,738,2,4021,23,17,20
738,69,1,739,5,4026,59,35,50
739,69,1,740,8,4034,114,73,80
740,69,1,741,3,4037,67,42,30
741,69,1,742,4,4041,69,44,40
742,69,1,743,7,4048,93,59,70
743,69,1,744,3,4051,57,32,30
744,69,1,745,6,4057,81,46,60
745,69,1,746,4,4061,87,87,40
746,69,1,747,9,4070,75,45,90
747,69,1,748,2,4072,44,24,20
748,69,1,749,2,4074,45,31,20
749,69,1,750,5,4079,55,41,50
750,69,1,751,6,4085,74,54,60
751,69,1,752,6,4091,70,46,60
752,69,1,753,6,4097,98,98,60
753,69,1,754,2,4099,23,14,20
754,69,1,755,6,4105,70,70,60
755,69,1,756,4,4109,47,47,40
756,69,1,757,7,4116,64,32,70
757,69,1,758,3,4119,60,33,30
758,69,1,759,9,4128,119,65,90
759,69,1,760,4,4132,93,93,40
760,69,1,761,7,4139,55,29,70
761,69,1,762,8,4147,104,57,80
762,69,1,763,7,4154,113,69,70
763,69,1,764,7,4161,115,64,70
764,69,1,765,8,4169,133,76,80
765,69,1,766,8,4177,128,77,80
766,69,1,767,7,4184,128,80,70
767,69,1,768,2,4186,66,38,20
768,69,1,769,9,4195,107,71,90
769,69,1,770,4,4199,76,76,40
770,69,1,771,9,4208,85,85,90
771,69,1,772,7,4215,76,47,70
772,69,1,773,8,4223,109,66,80
773,69,1,774,4,4227,70,44,40
774,69,1,775,4,4231,55,35,40
775,69,1,776,5,4236,72,42,50
776,69,1,777,9,4245,116,66,90
777,69,1,778,5,4250,89,66,50
778,69,1,779,6,4256,79,45,60
779,69,1,780,5,4261,85,47,50
780,69,1,781,5,4266,100,69,50
781,69,1,782,3,4269,65,40,30
782,69,1,783,7,4276,101,66,70
783,69,1,784,4,4280,68,43,40
784,69,1,785,3,4283,62,34,30
785,69,1,786,2,4285,52,52,20
786,69,1,787,7,4292,72,39,70
787,69,1,788,8,4300,121,74,80
788,69,1,789,5,4305,91,67,50
789,69,1,790,9,4314,99,99,90
790,69,1,791,9,4323,90,51,90
791,69,1,792,2,4325,56,31,20
792,69,1,793,4,4329,65,39,40
793,69,1,794,6,4335,98,51,60
794,69,1,795,3,4338,79,50,30
795,69,1,796,6,4344,86,86,60
796,69,1,797,9,4353,93,51,90
797,69,1,798,2,4355,65,37,20
798,69,1,799,7,4362,99,99,70
799,69,1,800,9,4371,110,65,90
800,69,1,801,8,4379,120,120,80
801,69,1,802,4,4383,45,31,40
802,69,1,803,4,4387,51,51,40
803,69,1,804,4,4391,38,24,40
804,69,1,805,3,4394,45,21,30
805,69,1,806,5,4399,79,52,50
806,69,1,807,8,4407,103,63,80
807,69,1,808,8,4415,126,77,80
808,69,1,809,3,4418,81,50,30
809,69,1,810,5,4423,85,46,50
810,69,1,811,4,4427,83,43,40
811,69,1,812,8,4435,122,122,80
812,69,1,813,5,4440,49,49,50
813,69,1,814,4,4444,37,17,40
814,69,1,815,7,4451,83,59,70
815,69,1,816,8,4459,99,57,80
816,69,1,817,7,4466,103,103,70
817,69,1,818,9,4475,84,51,90
818,69,1,819,8,4483,111,111,80
819,69,1,820,4,4487,35,35,40
820,69,1,821,8,4495,86,57,80
821,69,1,822,9,4504,129,79,90
822,69,1,823,4,4508,86,53,40
823,69,1,824,2,4510,58,38,20
824,69,1,825,5,4515,73,41,50
825,69,1,826,4,4519,79,49,40
826,69,1,827,9,4528,122,122,90
827,69,1,828,5,4533,44,26,50
828,69,1,829,4,4537,64,64,40
829,69,1,830,5,4542,53,36,50
830,69,1,831,5,4547,63,42,50
831,69,1,832,4,4551,75,75,40
832,69,1,833,6,4557,55,55,60
833,69,1,834,3,4560,31,17,30
834,69,1,835,6,4566,78,48,60
835,69,1,836,9,4575,128,73,90
836,69,1,837,7,4582,125,78,70
837,69,1,838,6,4588,96,57,60
838,69,1,839,5,4593,72,45,50
839,69,1,840,5,4598,80,43,50
840,69,1,841,8,4606,101,69,80
841,69,1,842,7,4613,91,91,70
842,69,1,843,8,4621,81,46,80
843,69,1,844,8,4629,128,90,80
844,69,1,845,9,4638,129,78,90
845,69,1,846,9,4647,150,95,90
846,69,1,847,7,4654,138,75,70
847,69,1,848,4,4658,98,68,40
848,69,1,849,9,4667,106,76,90
849,69,1,850,7,4674,98,56,70
850,69,1,851,6,4680,118,69,60
851,69,1,852,8,4688,120,120,80
852,69,1,853,3,4691,34,19,30
853,69,1,854,2,4693,38,23,20
854,69,1,855,8,4701,107,62,80
855,69,1,856,4,4705,94,49,40
856,69,1,857,3,4708,72,41,30
857,69,1,858,6,4714,86,47,60
858,69,1,859,5,4719,87,52,50
859,69,1,860,7,4726,100,56,70
860,69,1,861,5,4731,99,64,50
861,69,1,862,7,4738,107,107,70
862,69,1,863,3,4741,36,18,30
863,69,1,864,2,4743,48,26,20
864,69,1,865,4,4747,74,44,40
865,69,1,866,2,4749,51,51,20
866,69,1,867,3,4752,33,20,30
867,69,1,868,4,4756,54,54,40
868,69,1,869,4,4760,40,27,40
869,69,1,870,9,4769,92,60,90
870,69,1,871,9,4778,111,74,90
871,69,1,872,4,4782,84,59,40
872,69,1,873,5,4787,81,49,50
873,69,1,874,2,4789,53,53,20
874,69,1,875,8,4797,70,38,80
875,69,1,876,5,4802,70,45,50
876,69,1,877,7,4809,87,54,70
877,69,1,878,8,4817,123,69,80
878,69,1,879,7,4824,121,74,70
879,69,1,880,5,4829,89,48,50
880,69,1,881,7,4836,116,68,70
881,69,1,882,6,4842,107,59,60
882,69,1,883,5,4847,99,60,50
883,69,1,884,2,4849,69,45,20
884,69,1,885,3,4852,57,31,30
885,69,1,886,6,4858,88,50,60
886,69,1,887,8,4866,122,122,80
887,69,1,888,7,4873,71,41,70
888,69,1,889,2,4875,43,43,20
889,69,1,890,2,4877,28,28,20
890,69,1,891,3,4880,32,20,30
891,69,1,892,8,4888,93,57,80
892,69,1,893,4,4892,80,40,40
893,69,1,894,3,4895,66,38,30
894,69,1,895,4,4899,69,37,40
895,69,1,896,6,4905,93,56,60
896,69,1,897,4,4909,70,42,40
897,69,1,898,4,4913,78,78,40
898,69,1,899,3,4916,30,20,30
899,69,1,900,4,4920,47,27,40
900,69,1,901,8,4928,88,88,80
901,69,1,902,6,4934,52,34,60
902,69,1,903,6,4940,80,43,60
903,69,1,904,8,4948,116,66,80
904,69,1,905,7,4955,117,68,70
905,69,1,906,2,4957,60,60,20
906,69,1,907,8,4965,80,42,80
907,69,1,908,7,4972,103,63,70
908,69,1,909,6,4978,105,65,60
909,69,1,910,7,4985,112,69,70
910,69,1,911,9,4994,138,82,90
911,69,2,1,6,6,77,44,60
912,69,2,2,9,15,104,104,90
913,69,2,3,7,22,70,42,70
914,69,2,4,5,27,75,47,50
915,69,2,5,2,29,48,22,20
916,69,2,6,3,32,56,33,30
917,69,2,7,7,39,97,54,70
918,69,2,8,8,47,120,65,80
919,69,2,9,7,54,118,118,70
920,69,2,10,5,59,49,30,50
921,69,2,11,5,64,67,37,50
922,69,2,12,7,71,95,95,70
923,69,2,13,5,76,52,52,50
924,69,2,14,6,82,72,72,60
925,69,2,15,7,89,75,47,70
926,69,2,16,4,93,79,50,40
927,69,2,17,9,102,123,123,90
928,69,2,18,5,107,64,40,50
929,69,2,19,4,111,54,34,40
930,69,2,20,2,113,39,39,20
931,69,2,21,8,121,90,90,80
932,69,2,22,3,124,34,24,30
933,69,2,23,8,132,90,90,80
934,69,2,24,9,141,95,95,90
935,69,2,25,7,148,65,40,70
936,69,2,26,7,155,112,56,70
937,69,2,27,6,161,113,63,60
938,69,2,28,6,167,120,120,60
939,69,2,29,3,170,34,34,30
940,69,2,30,8,178,83,83,80
941,69,2,31,2,180,17,17,20
942,69,2,32,2,182,19,19,20
943,69,2,33,2,184,21,10,20
944,69,2,34,3,187,43,25,30
945,69,2,35,7,194,88,88,70
946,69,2,36,7,201,77,41,70
947,69,2,37,5,206,71,71,50
948,69,2,38,7,213,69,69,70
949,69,2,39,5,218,44,23,50
950,69,2,40,3,221,36,36,30
951,69,2,41,3,224,21,12,30
952,69,2,42,9,233,104,58,90
953,69,2,43,9,242,134,76,90
954,69,2,44,6,248,135,135,60
955,69,2,45,7,255,77,50,70
956,69,2,46,9,264,116,60,90
957,69,2,47,8,272,123,73,80
958,69,2,48,2,274,67,43,20
959,69,2,49,6,280,85,54,60
960,69,2,50,7,287,110,110,70
961,69,2,51,5,292,53,32,50
962,69,2,52,4,296,63,41,40
963,69,2,53,7,303,98,61,70
964,69,2,54,8,311,114,65,80
965,69,2,55,9,320,123,123,90
966,69,2,56,2,322,20,11,20
967,69,2,57,9,331,104,56,90
968,69,2,58,2,333,67,67,20
969,69,2,59,3,336,28,17,30
970,69,2,60,9,345,104,51,90
971,69,2,61,2,347,70,44,20
972,69,2,62,6,353,100,58,60
973,69,2,63,7,360,119,67,70
974,69,2,64,7,367,130,130,70
975,69,2,65,6,373,52,28,60
976,69,2,66,6,379,89,89,60
977,69,2,67,4,383,35,19,40
978,69,2,68,6,389,76,43,60
979,69,2,69,6,395,87,87,60
980,69,2,70,9,404,107,58,90
981,69,2,71,7,411,119,119,70
982,69,2,72,9,420,84,49,90
983,69,2,73,8,428,104,60,80
984,69,2,74,2,430,61,43,20
985,69,2,75,5,435,74,34,50
986,69,2,76,6,441,108,63,60
987,69,2,77,8,449,116,70,80
988,69,2,78,9,458,134,71,90
989,69,2,79,8,466,147,89,80
990,69,2,80,5,471,100,60,50
991,69,2,81,6,477,107,66,60
992,69,2,82,7,484,116,116,70
993,69,2,83,3,487,30,17,30
994,69,2,84,8,495,87,87,80
995,69,2,85,9,504,76,48,90
996,69,2,86,8,512,124,78,80
997,69,2,87,5,517,75,49,50
998,69,2,88,4,521,51,34,40
999,69,2,89,4,525,66,46,40
1000,69,2,90,9,534,104,67,90
1001,69,2,91,9,543,130,72,90
1002,69,2,92,7,550,136,73,70
1003,69,2,93,5,555,133,87,50
1004,69,2,94,7,562,118,118,70
1005,69,2,95,5,567,40,24,50
1006,69,2,96,5,572,67,38,50
1007,69,2,97,6,578,79,79,60
1008,69,2,98,8,586,85,46,80
1009,69,2,99,2,588,61,25,20
1010,69,2,100,2,590,55,35,20
1011,69,2,101,4,594,66,66,40
1012,69,2,102,4,598,37,37,40
1013,69,2,103,4,602,42,21,40
1014,69,2,104,6,608,85,54,60
1015,69,2,105,9,617,126,76,90
1016,69,2,106,7,624,132,77,70
1017,69,2,107,6,630,115,59,60
1018,69,2,108,5,635,103,60,50
1019,69,2,109,6,641,107,61,60
1020,69,2,110,5,646,100,64,50
1021,69,2,111,4,650,74,74,40
1022,69,2,112,3,653,25,10,30
1023,69,2,113,9,662,110,110,90
1024,69,2,114,5,667,49,32,50
1025,69,2,115,2,669,39,19,20
1026,69,2,116,5,674,70,44,50
1027,69,2,117,3,677,58,32,30
1028,69,2,118,8,685,99,99,80
1029,69,2,119,9,694,92,47,90
1030,69,2,120,2,696,70,70,20
1031,69,2,121,8,704,73,73,80
1032,69,2,122,3,707,30,22,30
1033,69,2,123,9,716,105,64,90
1034,69,2,124,2,718,62,28,20
1035,69,2,125,6,724,108,60,60
1036,69,2,126,2,726,67,37,20
1037,69,2,127,4,730,60,37,40
1038,69,2,128,6,736,82,59,60
1039,69,2,129,3,739,55,55,30
1040,69,2,130,4,743,39,39,40
1041,69,2,131,3,746,25,13,30
1042,69,2,132,8,754,94,62,80
1043,69,2,133,9,763,124,67,90
1044,69,2,134,4,767,80,80,40
1045,69,2,135,4,771,40,27,40
1046,69,2,136,7,778,85,85,70
1047,69,2,137,2,780,14,8,20
1048,69,2,138,4,784,49,29,40
1049,69,2,139,2,786,38,18,20
1050,69,2,140,5,791,70,40,50
1051,69,2,141,9,800,115,71,90
1052,69,2,142,2,802,67,38,20
1053,69,2,143,6,808,86,86,60
1054,69,2,144,6,814,60,31,60
1055,69,2,145,7,821,92,51,70
1056,69,2,146,5,826,101,53,50
1057,69,2,147,9,835,139,89,90
1058,69,2,148,4,839,95,95,40
1059,69,2,149,6,845,54,32,60
1060,69,2,150,3,848,54,54,30
1061,69,2,151,4,852,49,49,40
1062,69,2,152,6,858,77,39,60
1063,69,2,153,6,864,106,106,60
1064,69,2,154,7,871,67,43,70
1065,69,2,155,3,874,56,32,30
1066,69,2,156,9,883,104,104,90
1067,69,2,157,9,892,98,98,90
1068,69,2,158,9,901,85,55,90
1069,69,2,159,8,909,105,63,80
1070,69,2,160,5,914,80,49,50
1071,69,2,161,3,917,67,41,30
1072,69,2,162,4,921,68,68,40
1073,69,2,163,5,926,42,26,50
1074,69,2,164,2,928,28,28,20
1075,69,2,165,6,934,49,49,60
1076,69,2,166,6,940,72,72,60
1077,69,2,167,4,944,39,22,40
1078,69,2,168,2,946,35,23,20
1079,69,2,169,6,952,73,51,60
1080,69,2,170,2,954,37,21,20
1081,69,2,171,4,958,59,37,40
1082,69,2,172,9,967,84,51,90
1083,69,2,173,7,974,103,103,70
1084,69,2,174,9,983,96,96,90
1085,69,2,175,7,990,79,47,70
1086,69,2,176,8,998,108,108,80
1087,69,2,177,3,1001,34,19,30
1088,69,2,178,6,1007,77,44,60
1089,69,2,179,8,1015,99,57,80
1090,69,2,180,9,1024,122,73,90
1091,69,2,181,7,1031,127,83,70
1092,69,2,182,2,1033,68,68,20
1093,69,2,183,6,1039,74,38,60
1094,69,2,184,8,1047,112,67,80
1095,69,2,185,5,1052,86,53,50
1096,69,2,186,4,1056,66,39,40
1097,69,2,187,5,1061,71,43,50
1098,69,2,188,4,1065,63,39,40
1099,69,2,189,5,1070,75,37,50
1100,69,2,190,4,1074,71,38,40
1101,69,2,191,8,1082,103,103,80
1102,69,2,192,7,1089,85,48,70
1103,69,2,193,9,1098,134,134,90
1104,69,2,194,3,1101,27,17,30
1105,69,2,195,8,1109,89,53,80
1106,69,2,196,4,1113,76,76,40
1107,69,2,197,3,1116,25,16,30
1108,69,2,198,5,1121,56,37,50
1109,69,2,199,8,1129,97,60,80
1110,69,2,200,3,1132,59,59,30
1111,69,2,201,4,1136,36,36,40
1112,69,2,202,8,1144,89,89,80
1113,69,2,203,2,1146,16,10,20
1114,69,2,204,9,1155,87,53,90
1115,69,2,205,7,1162,110,75,70
1116,69,2,206,5,1167,71,71,50
1117,69,2,207,7,1174,79,49,70
1118,69,2,208,3,1177,62,43,30
1119,69,2,209,8,1185,101,61,80
1120,69,2,210,7,1192,105,60,70
1121,69,2,211,6,1198,98,58,60
1122,69,2,212,4,1202,81,41,40
1123,69,2,213,6,1208,95,61,60
1124,69,2,214,2,1210,53,29,20
1125,69,2,215,7,1217,107,58,70
1126,69,2,216,8,1225,114,114,80
1127,69,2,217,4,1229,44,33,40
1128,69,2,218,2,1231,34,34,20
1129,69,2,219,4,1235,42,26,40
1130,69,2,220,3,1238,36,21,30
1131,69,2,221,8,1246,99,67,80
1132,69,2,222,4,1250,82,49,40
1133,69,2,223,7,1257,113,62,70
1134,69,2,224,8,1265,146,88,80
1135,69,2,225,9,1274,147,90,90
1136,69,2,226,6,1280,110,63,60
1137,69,2,227,9,1289,146,82,90
1138,69,2,228,9,1298,144,79,90
1139,69,2,229,9,1307,161,99,90
1140,69,2,230,2,1309,81,46,20
1141,69,2,231,3,1312,58,35,30
1142,69,2,232,6,1318,80,57,60
1143,69,2,233,4,1322,67,41,40
1144,69,2,234,4,1326,71,42,40
1145,69,2,235,3,1329,54,54,30
1146,69,2,236,5,1334,44,33,50
1147,69,2,237,7,1341,84,45,70
1148,69,2,238,2,1343,60,33,20
1149,69,2,239,6,1349,81,47,60
1150,69,2,240,3,1352,66,39,30
1151,69,2,241,6,1358,75,75,60
1152,69,2,242,4,1362,50,50,40
1153,69,2,243,7,1369,70,39,70
1154,69,2,244,2,1371,47,28,20
1155,69,2,245,9,1380,113,69,90
1156,69,2,246,8,1388,129,83,80
1157,69,2,247,9,1397,134,74,90
1158,69,2,248,7,1404,110,69,70
1159,69,2,249,8,1412,114,75,80
1160,69,2,250,8,1420,117,65,80
1161,69,2,251,2,1422,67,46,20
1162,69,2,252,8,1430,97,52,80
1163,69,2,253,9,1439,146,80,90
1164,69,2,254,6,1445,128,128,60
1165,69,2,255,3,1448,29,20,30
1166,69,2,256,8,1456,84,84,80
1167,69,2,257,8,1464,73,50,80
1168,69,2,258,3,1467,53,33,30
1169,69,2,259,3,1470,49,32,30
1170,69,2,260,3,1473,46,46,30
1171,69,2,261,5,1478,51,23,50
1172,69,2,262,3,1481,52,32,30
1173,69,2,263,9,1490,122,65,90
1174,69,2,264,3,1493,93,61,30
1175,69,2,265,6,1499,101,47,60
1176,69,2,266,4,1503,87,46,40
1177,69,2,267,4,1507,80,45,40
1178,69,2,268,4,1511,73,73,40
1179,69,2,269,8,1519,63,40,80
1180,69,2,270,4,1523,70,70,40
1181,69,2,271,9,1532,85,49,90
1182,69,2,272,7,1539,101,59,70
1183,69,2,273,9,1548,137,77,90
1184,69,2,274,6,1554,127,79,60
1185,69,2,275,3,1557,81,44,30
1186,69,2,276,3,1560,76,41,30
1187,69,2,277,4,1564,64,31,40
1188,69,2,278,4,1568,77,46,40
1189,69,2,279,5,1573,97,56,50
1190,69,2,280,7,1580,125,71,70
1191,69,2,281,4,1584,81,81,40
1192,69,2,282,8,1592,95,50,80
1193,69,2,283,8,1600,126,80,80
1194,69,2,284,9,1609,146,146,90
1195,69,2,285,7,1616,85,53,70
1196,69,2,286,8,1624,117,76,80
1197,69,2,287,2,1626,59,59,20
1198,69,2,288,4,1630,41,22,40
1199,69,2,289,3,1633,48,27,30
1200,69,2,290,7,1640,98,60,70
1201,69,2,291,7,1647,92,51,70
1202,69,2,292,5,1652,86,46,50
1203,69,2,293,9,1661,147,147,90
1204,69,2,294,5,1666,52,28,50
1205,69,2,295,3,1669,60,33,30
1206,69,2,296,4,1673,60,31,40
1207,69,2,297,4,1677,61,39,40
1208,69,2,298,2,1679,47,29,20
1209,69,2,299,7,1686,98,53,70
1210,69,2,300,3,1689,72,38,30
1211,69,2,301,2,1691,52,52,20
1212,69,2,302,6,1697,80,48,60
1213,69,2,303,7,1704,117,117,70
1214,69,2,304,6,1710,48,24,60
1215,69,2,305,2,1712,39,22,20
1216,69,2,306,4,1716,57,34,40
1217,69,2,307,6,1722,88,55,60
1218,69,2,308,9,1731,119,74,90
1219,69,2,309,6,1737,104,60,60
1220,69,2,310,6,1743,98,53,60
1221,69,2,311,6,1749,117,117,60
1222,69,2,312,5,1754,41,32,50
1223,69,2,313,3,1757,38,38,30
1224,69,2,314,5,1762,65,36,50
1225,69,2,315,6,1768,83,43,60
1226,69,2,316,9,1777,137,137,90
1227,69,2,317,2,1779,22,13,20
1228,69,2,318,9,1788,107,72,90
1229,69,2,319,7,1795,103,46,70
1230,69,2,320,3,1798,87,50,30
1231,69,2,321,4,1802,79,48,40
1232,69,2,322,9,1811,126,78,90
1233,69,2,323,9,1820,134,79,90
1234,69,2,324,8,1828,147,98,80
1235,69,2,325,3,1831,70,40,30
1236,69,2,326,9,1840,116,116,90
1237,69,2,327,3,1843,24,24,30
1238,69,2,328,3,1846,31,17,30
1239,69,2,329,8,1854,81,53,80
1240,69,2,330,3,1857,56,24,30
1241,69,2,331,5,1862,79,79,50
1242,69,2,332,6,1868,79,43,60
1243,69,2,333,2,1870,58,30,20
1244,69,2,334,8,1878,102,60,80
1245,69,2,335,2,1880,60,34,20
1246,69,2,336,2,1882,42,42,20
1247,69,2,337,3,1885,28,13,30
1248,69,2,338,7,1892,74,41,70
1249,69,2,339,5,1897,80,46,50
1250,69,2,340,5,1902,92,51,50
1251,69,2,341,8,1910,109,61,80
1252,69,2,342,7,1917,118,67,70
1253,69,2,343,4,1921,79,49,40
1254,69,2,344,2,1923,52,34,20
1255,69,2,345,6,1929,70,42,60
1256,69,2,346,4,1933,76,48,40
1257,69,2,347,8,1941,98,49,80
1258,69,2,348,7,1948,116,63,70
1259,69,2,349,6,1954,111,60,60
1260,69,2,350,6,1960,113,113,60
1261,69,2,351,9,1969,103,58,90
1262,69,2,352,2,1971,58,35,20
1263,69,2,353,3,1974,46,28,30
1264,69,2,354,4,1978,48,34,40
1265,69,2,355,9,1987,100,100,90
1266,69,2,356,7,1994,65,36,70
1267,69,2,357,4,1998,68,41,40
1268,69,2,358,9,2007,111,67,90
1269,69,2,359,6,2013,102,54,60
1270,69,2,360,8,2021,132,80,80
1271,69,2,361,9,2030,147,78,90
1272,69,2,362,5,2035,118,80,50
1273,69,2,363,5,2040,80,40,50
1274,69,2,364,8,2048,128,78,80
1275,69,2,365,6,2054,108,57,60
1276,69,2,366,6,2060,114,60,60
1277,69,2,367,9,2069,135,87,90
1278,69,2,368,6,2075,103,103,60
1279,69,2,369,3,2078,25,25,30
1280,69,2,370,2,2080,15,15,20
1281,69,2,371,9,2089,84,44,90
1282,69,2,372,2,2091,66,66,20
1283,69,2,373,3,2094,33,25,30
1284,69,2,374,2,2096,35,35,20
1285,69,2,375,9,2105,80,80,90
1286,69,2,376,2,2107,14,7,20
1287,69,2,377,3,2110,31,20,30
1288,69,2,378,2,2112,27,16,20
1289,69,2,379,8,2120,96,55,80
1290,69,2,380,3,2123,77,77,30
1291,69,2,381,5,2128,52,30,50
1292,69,2,382,8,2136,92,53,80
1293,69,2,383,8,2144,118,118,80
1294,69,2,384,7,2151,70,42,70
1295,69,2,385,4,2155,58,58,40
1296,69,2,386,4,2159,35,19,40
1297,69,2,387,9,2168,114,63,90
1298,69,2,388,7,2175,116,71,70
1299,69,2,389,5,2180,107,59,50
1300,69,2,390,6,2186,117,117,60
1301,69,2,391,6,2192,69,41,60
1302,69,2,392,7,2199,93,54,70
1303,69,2,393,5,2204,91,49,50
1304,69,2,394,3,2207,78,47,30
1305,69,2,395,9,2216,121,68,90
1306,69,2,396,9,2225,147,147,90
1307,69,2,397,2,2227,20,10,20
1308,69,2,398,5,2232,56,33,50
1309,69,2,399,4,2236,63,63,40
1310,69,2,400,3,2239,27,14,30
1311,69,2,401,7,2246,81,50,70
1312,69,2,402,3,2249,56,56,30
1313,69,2,403,5,2254,53,25,50
1314,69,2,404,5,2259,88,57,50
1315,69,2,405,4,2263,68,41,40
1316,69,2,406,8,2271,111,61,80
1317,69,2,407,9,2280,155,94,90
1318,69,2,408,3,2283,98,60,30
1319,69,2,409,7,2290,114,68,70
1320,69,2,410,7,2297,122,74,70
1321,69,2,411,4,2301,93,59,40
1322,69,2,412,2,2303,53,33,20
1323,69,2,413,7,2310,97,55,70
1324,69,2,414,6,2316,106,66,60
1325,69,2,415,6,2322,100,58,60
1326,69,2,416,6,2328,99,48,60
1327,69,2,417,2,2330,76,44,20
1328,69,2,418,5,2335,81,52,50
1329,69,2,419,7,2342,90,90,70
1330,69,2,420,6,2348,51,28,60
1331,69,2,421,2,2350,39,23,20
1332,69,2,422,6,2356,66,66,60
1333,69,2,423,7,2363,84,84,70
1334,69,2,424,8,2371,83,83,80
1335,69,2,425,3,2374,30,18,30
1336,69,2,426,8,2382,102,102,80
1337,69,2,427,8,2390,78,56,80
1338,69,2,428,8,2398,101,59,80
1339,69,2,429,8,2406,119,119,80
1340,69,2,430,9,2415,85,48,90
1341,69,2,431,6,2421,97,62,60
1342,69,2,432,5,2426,80,80,50
1343,69,2,433,8,2434,88,57,80
1344,69,2,434,6,2440,94,62,60
1345,69,2,435,7,2447,107,60,70
1346,69,2,436,5,2452,90,58,50
1347,69,2,437,6,2458,92,56,60
1348,69,2,438,3,2461,69,42,30
1349,69,2,439,8,2469,97,43,80
1350,69,2,440,7,2476,115,72,70
1351,69,2,441,8,2484,138,91,80
1352,69,2,442,8,2492,128,68,80
1353,69,2,443,2,2494,80,50,20
1354,69,2,444,3,2497,60,36,30
1355,69,2,445,5,2502,64,46,50
1356,69,2,446,6,2508,83,83,60
1357,69,2,447,9,2517,92,56,90
1358,69,2,448,2,2519,55,38,20
1359,69,2,449,6,2525,76,42,60
1360,69,2,450,4,2529,80,48,40
1361,69,2,451,5,2534,73,73,50
1362,69,2,452,2,2536,23,23,20
1363,69,2,453,7,2543,83,55,70
1364,69,2,454,4,2547,65,34,40
1365,69,2,455,4,2551,70,43,40
1366,69,2,456,9,2560,116,72,90
1367,69,2,457,8,2568,129,74,80
1368,69,2,458,3,2571,101,57,30
1369,69,2,459,2,2573,70,35,20
1370,69,2,460,6,2579,85,53,60
1371,69,2,461,5,2584,94,58,50
1372,69,2,462,2,2586,59,34,20
1373,69,2,463,8,2594,114,76,80
1374,69,2,464,9,2603,130,130,90
1375,69,2,465,5,2608,55,32,50
1376,69,2,466,5,2613,76,76,50
1377,69,2,467,6,2619,67,35,60
1378,69,2,468,2,2621,46,27,20
1379,69,2,469,4,2625,71,71,40
1380,69,2,470,2,2627,16,9,20
1381,69,2,471,9,2636,100,61,90
1382,69,2,472,5,2641,78,42,50
1383,69,2,473,4,2645,73,73,40
1384,69,2,474,8,2653,86,86,80
1385,69,2,475,6,2659,61,37,60
1386,69,2,476,3,2662,60,36,30
1387,69,2,477,4,2666,71,42,40
1388,69,2,478,8,2674,105,62,80
1389,69,2,479,4,2678,76,45,40
1390,69,2,480,4,2682,63,63,40
1391,69,2,481,9,2691,81,43,90
1392,69,2,482,6,2697,99,60,60
1393,69,2,483,9,2706,128,80,90
1394,69,2,484,6,2712,106,106,60
1395,69,2,485,3,2715,31,31,30
1396,69,2,486,5,2720,53,27,50
1397,69,2,487,3,2723,55,35,30
1398,69,2,488,4,2727,71,71,40
1399,69,2,489,7,2734,71,42,70
1400,69,2,490,4,2738,71,71,40
1401,69,2,491,5,2743,51,38,50
1402,69,2,492,3,2746,42,23,30
1403,69,2,493,2,2748,37,23,20
1404,69,2,494,8,2756,85,85,80
1405,69,2,495,7,2763,68,44,70
1406,69,2,496,8,2771,111,64,80
1407,69,2,497,6,2777,111,111,60
1408,69,2,498,8,2785,69,42,80
1409,69,2,499,5,2790,84,50,50
1410,69,2,500,9,2799,120,120,90
1411,69,2,501,8,2807,81,49,80
1412,69,2,502,6,2813,103,66,60
1413,69,2,503,5,2818,100,58,50
1414,69,2,504,2,2820,56,30,20
1415,69,2,505,9,2829,110,61,90
1416,69,2,506,2,2831,80,42,20
1417,69,2,507,8,2839,129,129,80
1418,69,2,508,8,2847,92,56,80
1419,69,2,509,8,2855,103,66,80
1420,69,2,510,2,2857,56,37,20
1421,69,2,511,2,2859,42,27,20
1422,69,2,512,7,2866,85,51,70
1423,69,2,513,3,2869,66,35,30
1424,69,2,514,6,2875,97,55,60
1425,69,2,515,5,2880,89,89,50
1426,69,2,516,9,2889,96,63,90
1427,69,2,517,2,2891,46,29,20
1428,69,2,518,3,2894,40,24,30
1429,69,2,519,8,2902,98,98,80
1430,69,2,520,8,2910,81,47,80
1431,69,2,521,8,2918,109,109,80
1432,69,2,522,4,2922,45,45,40
1433,69,2,523,6,2928,60,38,60
1434,69,2,524,7,2935,93,65,70
1435,69,2,525,3,2938,56,36,30
1436,69,2,526,6,2944,68,68,60
1437,69,2,527,3,2947,31,16,30
1438,69,2,528,6,2953,86,52,60
1439,69,2,529,8,2961,103,68,80
1440,69,2,530,3,2964,66,39,30
1441,69,2,531,8,2972,118,74,80
1442,69,2,532,5,2977,89,48,50
1443,69,2,533,5,2982,103,65,50
1444,69,2,534,3,2985,62,62,30
1445,69,2,535,2,2987,24,12,20
1446,69,2,536,8,2995,93,54,80
1447,69,2,537,8,3003,117,68,80
1448,69,2,538,3,3006,74,50,30
1449,69,2,539,8,3014,101,101,80
1450,69,2,540,9,3023,77,41,90
1451,69,2,541,6,3029,86,46,60
1452,69,2,542,4,3033,76,44,40
1453,69,2,543,2,3035,48,31,20
1454,69,2,544,4,3039,69,44,40
1455,69,2,545,6,3045,88,54,60
1456,69,2,546,3,3048,59,30,30
1457,69,2,547,4,3052,63,40,40
1458,69,2,548,5,3057,81,46,50
1459,69,2,549,5,3062,95,58,50
1460,69,2,550,4,3066,74,45,40
1461,69,2,551,2,3068,54,33,20
1462,69,2,552,6,3074,76,42,60
1463,69,2,553,5,3079,76,76,50
1464,69,2,554,5,3084,45,25,50
1465,69,2,555,5,3089,61,61,50
1466,69,2,556,5,3094,41,19,50
1467,69,2,557,6,3100,88,52,60
1468,69,2,558,6,3106,95,51,60
1469,69,2,559,5,3111,98,98,50
1470,69,2,560,5,3116,50,28,50
1471,69,2,561,7,3123,95,61,70
1472,69,2,562,5,3128,87,55,50
1473,69,2,563,9,3137,118,77,90
1474,69,2,564,4,3141,89,56,40
1475,69,2,565,5,3146,77,42,50
1476,69,2,566,2,3148,63,36,20
1477,69,2,567,6,3154,85,54,60
1478,69,2,568,4,3158,67,38,40
1479,69,2,569,4,3162,73,45,40
1480,69,2,570,2,3164,42,42,20
1481,69,2,571,5,3169,51,30,50
1482,69,2,572,5,3174,66,36,50
1483,69,2,573,7,3181,102,65,70
1484,69,2,574,9,3190,135,90,90
1485,69,2,575,3,3193,66,42,30
1486,69,2,576,2,3195,48,27,20
1487,69,2,577,3,3198,48,23,30
1488,69,2,578,4,3202,64,33,40
1489,69,2,579,5,3207,85,50,50
1490,69,2,580,4,3211,75,75,40
1491,69,2,581,8,3219,71,46,80
1492,69,2,582,5,3224,75,52,50
1493,69,2,583,6,3230,90,54,60
1494,69,2,584,8,3238,128,74,80
1495,69,2,585,7,3245,134,74,70
1496,69,2,586,9,3254,157,97,90
1497,69,2,587,8,3262,130,68,80
1498,69,2,588,2,3264,77,44,20
1499,69,2,589,6,3270,91,91,60
1500,69,2,590,3,3273,28,13,30
1501,69,2,591,8,3281,94,55,80
1502,69,2,592,4,3285,87,87,40
1503,69,2,593,9,3294,83,54,90
1504,69,2,594,7,3301,90,51,70
1505,69,2,595,8,3309,111,111,80
1506,69,2,596,5,3314,65,43,50
1507,69,2,597,8,3322,102,49,80
1508,69,2,598,3,3325,81,47,30
1509,69,2,599,8,3333,115,115,80
1510,69,2,600,3,3336,34,26,30
1511,69,2,601,6,3342,82,52,60
1512,69,2,602,6,3348,86,50,60
1513,69,2,603,4,3352,64,32,40
1514,69,2,604,9,3361,130,79,90
1515,69,2,605,2,3363,76,36,20
1516,69,2,606,8,3371,133,75,80
1517,69,2,607,7,3378,129,85,70
1518,69,2,608,2,3380,61,38,20
1519,69,2,609,4,3384,64,37,40
1520,69,2,610,2,3386,48,27,20
1521,69,2,611,9,3395,107,68,90
1522,69,2,612,3,3398,66,66,30
1523,69,2,613,7,3405,75,44,70
1524,69,2,614,9,3414,120,83,90
1525,69,2,615,8,3422,126,70,80
1526,69,2,616,6,3428,125,76,60
1527,69,2,617,9,3437,149,83,90
1528,69,2,618,7,3444,137,91,70
1529,69,2,619,3,3447,78,45,30
1530,69,2,620,2,3449,53,26,20
1531,69,2,621,2,3451,55,32,20
1532,69,2,622,4,3455,52,31,40
1533,69,2,623,8,3463,90,51,80
1534,69,2,624,3,3466,67,39,30
1535,69,2,625,6,3472,90,59,60
1536,69,2,626,9,3481,127,127,90
1537,69,2,627,7,3488,68,68,70
1538,69,2,628,7,3495,68,35,70
1539,69,2,629,8,3503,112,70,80
1540,69,2,630,9,3512,135,82,90
1541,69,2,631,6,3518,123,68,60
1542,69,2,632,9,3527,145,88,90
1543,69,2,633,2,3529,75,46,20
1544,69,2,634,4,3533,76,44,40
1545,69,2,635,7,3540,113,70,70
1546,69,2,636,5,3545,87,55,50
1547,69,2,637,4,3549,87,87,40
1548,69,2,638,7,3556,81,81,70
1549,69,2,639,7,3563,77,46,70
1550,69,2,640,2,3565,47,22,20
1551,69,2,641,8,3573,89,54,80
1552,69,2,642,9,3582,132,71,90
1553,69,2,643,5,3587,125,125,50
1554,69,2,644,3,3590,20,20,30
1555,69,2,645,9,3599,89,53,90
1556,69,2,646,8,3607,95,60,80
1557,69,2,647,4,3611,84,48,40
1558,69,2,648,2,3613,52,29,20
1559,69,2,649,3,3616,55,55,30
1560,69,2,650,8,3624,79,38,80
1561,69,2,651,9,3633,142,142,90
1562,69,2,652,4,3637,40,40,40
1563,69,2,653,7,3644,72,45,70
1564,69,2,654,6,3650,104,70,60
1565,69,2,655,8,3658,103,103,80
1566,69,2,656,9,3667,85,43,90
1567,69,2,657,2,3669,70,41,20
1568,69,2,658,8,3677,114,114,80
1569,69,2,659,6,3683,63,27,60
1570,69,2,660,2,3685,49,20,20
1571,69,2,661,4,3689,73,73,40
1572,69,2,662,8,3697,79,50,80
1573,69,2,663,9,3706,107,61,90
1574,69,2,664,3,3709,81,37,30
1575,69,2,665,2,3711,64,46,20
1576,69,2,666,7,3718,94,52,70
1577,69,2,667,7,3725,111,74,70
1578,69,2,668,5,3730,87,50,50
1579,69,2,669,2,3732,56,35,20
1580,69,2,670,9,3741,115,64,90
1581,69,2,671,3,3744,81,48,30
1582,69,2,672,7,3751,107,107,70
1583,69,2,673,6,3757,39,20,60
1584,69,2,674,2,3759,33,16,20
1585,69,2,675,2,3761,41,30,20
1586,69,2,676,3,3764,41,26,30
1587,69,2,677,9,3773,103,60,90
1588,69,2,678,6,3779,93,52,60
1589,69,2,679,7,3786,107,65,70
1590,69,2,680,7,3793,106,47,70
1591,69,2,681,7,3800,119,68,70
1592,69,2,682,2,3802,69,43,20
1593,69,2,683,2,3804,40,27,20
1594,69,2,684,5,3809,52,28,50
1595,69,2,685,7,3816,101,55,70
1596,69,2,686,7,3823,124,69,70
1597,69,2,687,5,3828,111,111,50
1598,69,2,688,3,3831,27,12,30
1599,69,2,689,3,3834,34,34,30
1600,69,2,690,2,3836,21,10,20
1601,69,2,691,3,3839,38,24,30
1602,69,2,692,3,3842,49,29,30
1603,69,2,693,4,3846,67,37,40
1604,69,2,694,4,3850,69,46,40
1605,69,2,695,7,3857,93,47,70
1606,69,2,696,6,3863,115,69,60
1607,69,2,697,3,3866,72,45,30
1608,69,2,698,9,3875,110,66,90
1609,69,2,699,9,3884,145,83,90
1610,69,2,700,9,3893,148,148,90
1611,69,2,701,7,3900,69,45,70
1612,69,2,702,7,3907,85,49,70
1613,69,2,703,5,3912,87,57,50
1614,69,2,704,2,3914,49,31,20
1615,69,2,705,2,3916,39,25,20
1616,69,2,706,2,3918,38,24,20
1617,69,2,707,6,3924,72,72,60
1618,69,2,708,2,3926,27,16,20
1619,69,2,709,4,3930,51,30,40
1620,69,2,710,2,3932,36,22,20
1621,69,2,711,7,3939,107,62,70
1622,69,2,712,2,3941,61,34,20
1623,69,2,713,4,3945,83,57,40
1624,69,2,714,6,3951,87,50,60
1625,69,2,715,3,3954,58,58,30
1626,69,2,716,2,3956,15,10,20
1627,69,2,717,5,3961,65,41,50
1628,69,2,718,4,3965,63,63,40
1629,69,2,719,7,3972,77,77,70
1630,69,2,720,6,3978,50,50,60
1631,69,2,721,6,3984,65,36,60
1632,69,2,722,4,3988,72,72,40
1633,69,2,723,7,3995,73,40,70
1634,69,2,724,6,4001,107,71,60
1635,69,2,725,5,4006,90,90,50
1636,69,2,726,3,4009,27,14,30
1637,69,2,727,9,4018,113,64,90
1638,69,2,728,5,4023,94,63,50
1639,69,2,729,9,4032,121,70,90
1640,69,2,730,5,4037,106,52,50
1641,69,2,731,9,4046,156,104,90
1642,69,2,732,2,4048,75,44,20
1643,69,2,733,7,4055,108,59,70
1644,69,2,734,4,4059,82,47,40
1645,69,2,735,7,4066,110,63,70
1646,69,2,736,2,4068,65,38,20
1647,69,2,737,8,4076,106,58,80
1648,69,2,738,3,4079,77,42,30
1649,69,2,739,8,4087,112,72,80
1650,69,2,740,2,4089,59,30,20
1651,69,2,741,4,4093,69,37,40
1652,69,2,742,6,4099,106,73,60
1653,69,2,743,6,4105,111,69,60
1654,69,2,744,5,4110,89,47,50
1655,69,2,745,9,4119,147,93,90
1656,69,2,746,8,4127,141,85,80
1657,69,2,747,6,4133,116,63,60
1658,69,2,748,8,4141,126,79,80
1659,69,2,749,7,4148,101,101,70
1660,69,2,750,3,4151,33,20,30
1661,69,2,751,3,4154,45,45,30
1662,69,2,752,2,4156,17,17,20
1663,69,2,753,4,4160,37,18,40
1664,69,2,754,8,4168,98,59,80
1665,69,2,755,8,4176,116,65,80
1666,69,2,756,7,4183,124,124,70
1667,69,2,757,3,4186,20,10,30
1668,69,2,758,2,4188,30,19,20
1669,69,2,759,3,4191,36,36,30
1670,69,2,760,4,4195,35,20,40
1671,69,2,761,6,4201,68,45,60
1672,69,2,762,2,4203,45,21,20
1673,69,2,763,5,4208,79,48,50
1674,69,2,764,3,4211,65,36,30
1675,69,2,765,9,4220,129,81,90
1676,69,2,766,9,4229,133,75,90
1677,69,2,767,6,4235,118,76,60
1678,69,2,768,7,4242,103,55,70
1679,69,2,769,3,4245,79,47,30
1680,69,2,770,8,4253,104,65,80
1681,69,2,771,9,4262,137,137,90
1682,69,2,772,7,4269,74,74,70
1683,69,2,773,9,4278,86,46,90
1684,69,2,774,5,4283,103,54,50
1685,69,2,775,7,4290,118,66,70
1686,69,2,776,5,4295,109,66,50
1687,69,2,777,3,4298,70,39,30
1688,69,2,778,8,4306,101,61,80
1689,69,2,779,3,4309,68,42,30
1690,69,2,780,6,4315,90,50,60
1691,69,2,781,8,4323,117,63,80
1692,69,2,782,6,4329,108,108,60
1693,69,2,783,8,4337,72,72,80
1694,69,2,784,8,4345,72,44,80
1695,69,2,785,5,4350,85,54,50
1696,69,2,786,4,4354,76,47,40
1697,69,2,787,7,4361,109,68,70
1698,69,2,788,7,4368,110,110,70
1699,69,2,789,4,4372,41,41,40
1700,69,2,790,5,4377,50,27,50
1701,69,2,791,7,4384,79,53,70
1702,69,2,792,9,4393,121,73,90
1703,69,2,793,7,4400,113,56,70
1704,69,2,794,5,4405,105,68,50
1705,69,2,795,4,4409,77,49,40
1706,69,2,796,9,4418,118,67,90
1707,69,2,797,2,4420,69,38,20
1708,69,2,798,9,4429,137,95,90
1709,69,2,799,5,4434,92,55,50
1710,69,2,800,8,4442,124,73,80
1711,69,2,801,2,4444,75,75,20
1712,69,2,802,7,4451,75,50,70
1713,69,2,803,5,4456,73,40,50
1714,69,2,804,2,4458,51,30,20
1715,69,2,805,4,4462,73,73,40
1716,69,2,806,2,4464,26,26,20
1717,69,2,807,6,4470,49,28,60
1718,69,2,808,5,4475,86,86,50
1719,69,2,809,4,4479,41,23,40
1720,69,2,810,7,4486,99,63,70
1721,69,2,811,4,4490,74,74,40
1722,69,2,812,5,4495,44,44,50
1723,69,2,813,8,4503,88,59,80
1724,69,2,814,3,4506,51,33,30
1725,69,2,815,2,4508,33,20,20
1726,69,2,816,2,4510,29,12,20
1727,69,2,817,7,4517,113,113,70
1728,69,2,818,5,4522,48,30,50
1729,69,2,819,4,4526,64,44,40
1730,69,2,820,3,4529,57,31,30
1731,69,2,821,6,4535,78,46,60
1732,69,2,822,4,4539,74,74,40
1733,69,2,823,3,4542,29,12,30
1734,69,2,824,7,4549,101,57,70
1735,69,2,825,8,4557,117,78,80
1736,69,2,826,5,4562,97,52,50
1737,69,2,827,7,4569,113,69,70
1738,69,2,828,3,4572,64,42,30
1739,69,2,829,6,4578,91,91,60
1740,69,2,830,2,4580,20,12,20
1741,69,2,831,3,4583,24,15,30
1742,69,2,832,9,4592,103,70,90
1743,69,2,833,2,4594,58,58,20
1744,69,2,834,5,4599,50,32,50
1745,69,2,835,9,4608,103,65,90
1746,69,2,836,8,4616,107,69,80
1747,69,2,837,3,4619,63,36,30
1748,69,2,838,4,4623,62,41,40
1749,69,2,839,9,4632,111,111,90
1750,69,2,840,2,4634,24,14,20
1751,69,2,841,9,4643,123,73,90
1752,69,2,842,8,4651,139,139,80
1753,69,2,843,7,4658,59,40,70
1754,69,2,844,3,4661,41,24,30
1755,69,2,845,2,4663,39,21,20
1756,69,2,846,5,4668,64,35,50
1757,69,2,847,2,4670,46,30,20
1758,69,2,848,4,4674,62,62,40
1759,69,2,849,8,4682,78,38,80
1760,69,2,850,7,4689,108,108,70
1761,69,2,851,7,4696,67,35,70
1762,69,2,852,5,4701,88,56,50
1763,69,2,853,8,4709,116,74,80
1764,69,2,854,3,4712,70,70,30
1765,69,2,855,2,4714,24,24,20
1766,69,2,856,3,4717,19,19,30
1767,69,2,857,9,4726,107,71,90
1768,69,2,858,7,4733,93,54,70
1769,69,2,859,2,4735,58,37,20
1770,69,2,860,7,4742,100,58,70
1771,69,2,861,8,4750,126,126,80
1772,69,2,862,3,4753,33,17,30
1773,69,2,863,8,4761,123,74,80
1774,69,2,864,6,4767,93,53,60
1775,69,2,865,2,4769,63,37,20
1776,69,2,866,8,4777,126,126,80
1777,69,2,867,5,4782,54,54,50
1778,69,2,868,5,4787,47,18,50
1779,69,2,869,9,4796,117,79,90
1780,69,2,870,2,4798,52,31,20
1781,69,2,871,3,4801,61,61,30
1782,69,2,872,3,4804,22,10,30
1783,69,2,873,4,4808,50,27,40
1784,69,2,874,4,4812,69,43,40
1785,69,2,875,8,4820,105,69,80
1786,69,2,876,8,4828,120,79,80
1787,69,2,877,2,4830,58,31,20
1788,69,2,878,2,4832,43,21,20
1789,69,2,879,2,4834,38,23,20
1790,69,2,880,7,4841,99,61,70
1791,69,2,881,4,4845,83,55,40
1792,69,2,882,6,4851,91,64,60
1793,69,2,883,8,4859,98,98,80
1794,69,2,884,4,4863,48,48,40
1795,69,2,885,5,4868,47,25,50
1796,69,2,886,7,4875,73,44,70
1797,69,2,887,2,4877,49,31,20
1798,69,2,888,7,4884,94,54,70
1799,69,2,889,6,4890,75,45,60
1800,69,2,890,5,4895,84,46,50
1801,69,2,891,4,4899,68,43,40
1802,69,2,892,8,4907,113,60,80
1803,69,2,893,3,4910,89,89,30
1804,69,2,894,4,4914,30,30,40
1805,69,2,895,4,4918,39,39,40
1806,69,2,896,6,4924,61,36,60
1807,69,2,897,9,4933,124,71,90
1808,69,2,898,3,4936,80,50,30
1809,69,2,899,4,4940,65,39,40
1810,69,2,900,4,4944,79,49,40
1811,69,2,901,2,4946,53,32,20
1812,69,2,902,6,4952,88,50,60
1813,69,2,903,8,4960,97,58,80
1814,69,2,904,6,4966,95,61,60
1815,69,2,905,8,4974,91,53,80
1816,69,2,906,5,4979,89,51,50
1817,69,2,907,4,4983,82,45,40
1818,69,2,908,6,4989,92,48,60
1819,69,2,909,7,4996,125,125,70
1820,69,2,910,2,4998,14,10,20
1821,69,3,1,6,6,60,40,60
1822,69,3,2,8,14,104,53,80
1823,69,3,3,8,22,131,80,80
1824,69,3,4,6,28,115,66,60
1825,69,3,5,8,36,117,67,80
1826,69,3,6,3,39,90,57,30
1827,69,3,7,6,45,93,55,60
1828,69,3,8,3,48,71,50,30
1829,69,3,9,8,56,103,56,80
1830,69,3,10,8,64,145,80,80
1831,69,3,11,7,71,127,127,70
1832,69,3,12,9,80,97,97,90
1833,69,3,13,2,82,17,7,20
1834,69,3,14,8,90,88,52,80
1835,69,3,15,2,92,58,34,20
1836,69,3,16,7,99,88,45,70
1837,69,3,17,9,108,140,88,90
1838,69,3,18,9,117,152,87,90
1839,69,3,19,7,124,142,83,70
1840,69,3,20,9,133,159,80,90
1841,69,3,21,7,140,148,91,70
1842,69,3,22,7,147,124,124,70
1843,69,3,23,3,150,24,13,30
1844,69,3,24,5,155,61,35,50
1845,69,3,25,4,159,73,44,40
1846,69,3,26,7,166,92,58,70
1847,69,3,27,2,168,57,39,20
1848,69,3,28,6,174,77,77,60
1849,69,3,29,8,182,84,46,80
1850,69,3,30,2,184,53,33,20
1851,69,3,31,6,190,79,42,60
1852,69,3,32,5,195,99,46,50
1853,69,3,33,6,201,114,73,60
1854,69,3,34,9,210,128,75,90
1855,69,3,35,8,218,125,84,80
1856,69,3,36,3,221,76,42,30
1857,69,3,37,2,223,47,26,20
1858,69,3,38,7,230,88,50,70
1859,69,3,39,6,236,103,103,60
1860,69,3,40,8,244,95,53,80
1861,69,3,41,5,249,82,52,50
1862,69,3,42,9,258,97,97,90
1863,69,3,43,4,262,41,21,40
1864,69,3,44,5,267,69,41,50
1865,69,3,45,7,274,110,64,70
1866,69,3,46,9,283,124,74,90
1867,69,3,47,2,285,67,38,20
1868,69,3,48,8,293,115,74,80
1869,69,3,49,5,298,100,50,50
1870,69,3,50,3,301,79,51,30
1871,69,3,51,5,306,69,38,50
1872,69,3,52,3,309,70,39,30
1873,69,3,53,2,311,58,36,20
1874,69,3,54,7,318,86,54,70
1875,69,3,55,5,323,92,53,50
1876,69,3,56,4,327,88,59,40
1877,69,3,57,2,329,51,31,20
1878,69,3,58,4,333,58,35,40
1879,69,3,59,3,336,55,33,30
1880,69,3,60,4,340,60,60,40
1881,69,3,61,8,348,72,45,80
1882,69,3,62,7,355,102,61,70
1883,69,3,63,6,361,102,61,60
1884,69,3,64,2,363,65,40,20
1885,69,3,65,8,371,101,62,80
1886,69,3,66,4,375,80,47,40
1887,69,3,67,2,377,63,33,20
1888,69,3,68,9,386,121,63,90
1889,69,3,69,7,393,143,90,70
1890,69,3,70,9,402,138,78,90
1891,69,3,71,4,406,114,68,40
1892,69,3,72,5,411,94,58,50
1893,69,3,73,4,415,75,43,40
1894,69,3,74,2,417,51,29,20
1895,69,3,75,3,420,50,34,30
1896,69,3,76,8,428,93,49,80
1897,69,3,77,7,435,116,66,70
1898,69,3,78,6,441,117,68,60
1899,69,3,79,5,446,93,93,50
1900,69,3,80,4,450,44,26,40
1901,69,3,81,6,456,83,45,60
1902,69,3,82,6,462,92,63,60
1903,69,3,83,8,470,99,49,80
1904,69,3,84,3,473,88,88,30
1905,69,3,85,6,479,66,66,60
1906,69,3,86,4,483,30,18,40
1907,69,3,87,9,492,102,63,90
1908,69,3,88,2,494,53,36,20
1909,69,3,89,5,499,66,35,50
1910,69,3,90,3,502,55,27,30
1911,69,3,91,4,506,59,34,40
1912,69,3,92,5,511,81,81,50
1913,69,3,93,3,514,36,26,30
1914,69,3,94,9,523,106,68,90
1915,69,3,95,6,529,116,116,60
1916,69,3,96,2,531,23,23,20
1917,69,3,97,5,536,40,24,50
1918,69,3,98,3,539,47,24,30
1919,69,3,99,6,545,78,78,60
1920,69,3,100,7,552,77,59,70
1921,69,3,101,5,557,67,42,50
1922,69,3,102,4,561,71,46,40
1923,69,3,103,8,569,101,63,80
1924,69,3,104,8,577,98,52,80
1925,69,3,105,7,584,130,87,70
1926,69,3,106,3,587,75,44,30
1927,69,3,107,4,591,74,44,40
1928,69,3,108,4,595,69,42,40
1929,69,3,109,8,603,102,56,80
1930,69,3,110,8,611,125,125,80
1931,69,3,111,2,613,21,12,20
1932,69,3,112,3,616,52,29,30
1933,69,3,113,5,621,68,34,50
1934,69,3,114,7,628,98,54,70
1935,69,3,115,3,631,62,38,30
1936,69,3,116,2,633,42,27,20
1937,69,3,117,9,642,87,46,90
1938,69,3,118,8,650,113,61,80
1939,69,3,119,2,652,69,69,20
1940,69,3,120,6,658,58,32,60
1941,69,3,121,3,661,61,61,30
1942,69,3,122,7,668,70,43,70
1943,69,3,123,9,677,129,77,90
1944,69,3,124,2,679,63,36,20
1945,69,3,125,8,687,103,58,80
1946,69,3,126,8,695,131,131,80
1947,69,3,127,8,703,79,50,80
1948,69,3,128,2,705,48,28,20
1949,69,3,129,7,712,89,55,70
1950,69,3,130,6,718,97,55,60
1951,69,3,131,6,724,103,66,60
1952,69,3,132,2,726,57,30,20
1953,69,3,133,5,731,73,40,50
1954,69,3,134,3,734,55,28,30
1955,69,3,135,4,738,63,37,40
1956,69,3,136,9,747,120,75,90
1957,69,3,137,4,751,83,83,40
1958,69,3,138,5,756,48,26,50
1959,69,3,139,7,763,92,60,70
1960,69,3,140,9,772,121,73,90
1961,69,3,141,7,779,101,61,70
1962,69,3,142,9,788,132,81,90
1963,69,3,143,4,792,77,46,40
1964,69,3,144,4,796,78,42,40
1965,69,3,145,4,800,80,48,40
1966,69,3,146,9,809,130,80,90
1967,69,3,147,3,812,85,55,30
1968,69,3,148,9,821,126,78,90
1969,69,3,149,6,827,111,75,60
1970,69,3,150,6,833,93,60,60
1971,69,3,151,4,837,68,68,40
1972,69,3,152,5,842,51,31,50
1973,69,3,153,5,847,69,39,50
1974,69,3,154,4,851,76,76,40
1975,69,3,155,7,858,71,43,70
1976,69,3,156,9,867,132,83,90
1977,69,3,157,6,873,114,114,60
1978,69,3,158,2,875,26,16,20
1979,69,3,159,6,881,70,34,60
1980,69,3,160,2,883,56,37,20
1981,69,3,161,6,889,81,42,60
1982,69,3,162,6,895,90,54,60
1983,69,3,163,4,899,81,41,40
1984,69,3,164,8,907,120,67,80
1985,69,3,165,5,912,104,68,50
1986,69,3,166,4,916,83,83,40
1987,69,3,167,2,918,12,7,20
1988,69,3,168,9,927,80,49,90
1989,69,3,169,8,935,117,117,80
1990,69,3,170,2,937,16,16,20
1991,69,3,171,8,945,74,44,80
1992,69,3,172,7,952,94,54,70
1993,69,3,173,8,960,131,75,80
1994,69,3,174,5,965,101,55,50
1995,69,3,175,6,971,108,65,60
1996,69,3,176,4,975,96,57,40
1997,69,3,177,8,983,112,112,80
1998,69,3,178,5,988,54,23,50
1999,69,3,179,2,990,53,28,20
2000,69,3,180,8,998,105,67,80
2001,69,3,181,5,1003,85,48,50
2002,69,3,182,4,1007,66,39,40
2003,69,3,183,6,1013,91,48,60
2004,69,3,184,3,1016,70,45,30
2005,69,3,185,2,1018,43,27,20
2006,69,3,186,9,1027,111,68,90
2007,69,3,187,5,1032,94,55,50
2008,69,3,188,8,1040,113,113,80
2009,69,3,189,9,1049,101,57,90
2010,69,3,190,5,1054,103,103,50
2011,69,3,191,7,1061,70,44,70
2012,69,3,192,7,1068,105,105,70
2013,69,3,193,5,1073,56,56,50
2014,69,3,194,8,1081,82,45,80
2015,69,3,195,6,1087,116,116,60
2016,69,3,196,8,1095,77,42,80
2017,69,3,197,8,1103,115,56,80
2018,69,3,198,9,1112,143,84,90
2019,69,3,199,2,1114,81,81,20
2020,69,3,200,6,1120,78,47,60
2021,69,3,201,5,1125,86,48,50
2022,69,3,202,7,1132,118,73,70
2023,69,3,203,8,1140,110,69,80
2024,69,3,204,9,1149,124,72,90
2025,69,3,205,8,1157,120,73,80
2026,69,3,206,6,1163,106,67,60
2027,69,3,207,7,1170,108,64,70
2028,69,3,208,5,1175,107,71,50
2029,69,3,209,7,1182,126,78,70
2030,69,3,210,6,1188,109,68,60
2031,69,3,211,2,1190,62,36,20
2032,69,3,212,9,1199,108,64,90
2033,69,3,213,7,1206,115,68,70
2034,69,3,214,9,1215,139,139,90
2035,69,3,215,6,1221,88,50,60
2036,69,3,216,8,1229,105,65,80
2037,69,3,217,3,1232,73,73,30
2038,69,3,218,8,1240,88,49,80
2039,69,3,219,9,1249,125,79,90
2040,69,3,220,6,1255,100,65,60
2041,69,3,221,2,1257,50,34,20
2042,69,3,222,7,1264,74,45,70
2043,69,3,223,3,1267,61,35,30
2044,69,3,224,3,1270,55,30,30
2045,69,3,225,2,1272,44,31,20
2046,69,3,226,2,1274,34,21,20
2047,69,3,227,3,1277,44,44,30
2048,69,3,228,7,1284,75,47,70
2049,69,3,229,7,1291,91,50,70
2050,69,3,230,6,1297,94,59,60
2051,69,3,231,8,1305,115,68,80
2052,69,3,232,8,1313,112,112,80
2053,69,3,233,5,1318,53,29,50
2054,69,3,234,4,1322,62,35,40
2055,69,3,235,3,1325,56,38,30
2056,69,3,236,9,1334,101,62,90
2057,69,3,237,9,1343,133,83,90
2058,69,3,238,7,1350,111,71,70
2059,69,3,239,6,1356,108,55,60
2060,69,3,240,2,1358,74,74,20
2061,69,3,241,8,1366,77,41,80
2062,69,3,242,2,1368,60,31,20
2063,69,3,243,6,1374,92,46,60
2064,69,3,244,4,1378,82,49,40
2065,69,3,245,3,1381,62,42,30
2066,69,3,246,6,1387,92,92,60
2067,69,3,247,9,1396,74,33,90
2068,69,3,248,5,1401,92,54,50
2069,69,3,249,8,1409,136,85,80
2070,69,3,250,8,1417,155,94,80
2071,69,3,251,5,1422,98,59,50
2072,69,3,252,7,1429,103,103,70
2073,69,3,253,8,1437,82,55,80
2074,69,3,254,7,1444,98,63,70
2075,69,3,255,3,1447,60,29,30
2076,69,3,256,9,1456,123,85,90
2077,69,3,257,3,1459,62,62,30
2078,69,3,258,4,1463,41,25,40
2079,69,3,259,6,1469,75,48,60
2080,69,3,260,9,1478,106,106,90
2081,69,3,261,8,1486,77,39,80
2082,69,3,262,9,1495,121,80,90
2083,69,3,263,3,1498,67,44,30
2084,69,3,264,3,1501,39,25,30
2085,69,3,265,2,1503,40,23,20
2086,69,3,266,6,1509,68,40,60
2087,69,3,267,2,1511,46,23,20
2088,69,3,268,2,1513,37,20,20
2089,69,3,269,4,1517,52,52,40
2090,69,3,270,3,1520,28,19,30
2091,69,3,271,3,1523,51,31,30
2092,69,3,272,7,1530,89,47,70
2093,69,3,273,7,1537,111,65,70
2094,69,3,274,8,1545,135,76,80
2095,69,3,275,5,1550,109,63,50
2096,69,3,276,5,1555,104,65,50
2097,69,3,277,9,1564,139,84,90
2098,69,3,278,5,1569,111,66,50
2099,69,3,279,4,1573,72,41,40
2100,69,3,280,6,1579,102,55,60
2101,69,3,281,7,1586,121,121,70
2102,69,3,282,5,1591,50,25,50
2103,69,3,283,3,1594,47,25,30
2104,69,3,284,3,1597,50,50,30
2105,69,3,285,9,1606,81,56,90
2106,69,3,286,5,1611,64,43,50
2107,69,3,287,4,1615,48,25,40
2108,69,3,288,9,1624,137,83,90
2109,69,3,289,7,1631,123,123,70
2110,69,3,290,8,1639,74,44,80
2111,69,3,291,2,1641,48,28,20
2112,69,3,292,6,1647,84,84,60
2113,69,3,293,7,1654,81,55,70
2114,69,3,294,4,1658,76,41,40
2115,69,3,295,8,1666,109,60,80
2116,69,3,296,8,1674,128,81,80
2117,69,3,297,4,1678,92,92,40
2118,69,3,298,4,1682,37,24,40
2119,69,3,299,8,1690,105,57,80
2120,69,3,300,9,1699,137,82,90
2121,69,3,301,6,1705,102,61,60
2122,69,3,302,6,1711,111,111,60
2123,69,3,303,4,1715,45,21,40
2124,69,3,304,7,1722,94,60,70
2125,69,3,305,9,1731,132,77,90
2126,69,3,306,2,1733,81,42,20
2127,69,3,307,6,1739,103,103,60
2128,69,3,308,4,1743,41,41,40
2129,69,3,309,9,1752,78,42,90
2130,69,3,310,5,1757,73,73,50
2131,69,3,311,3,1760,30,13,30
2132,69,3,312,4,1764,64,36,40
2133,69,3,313,9,1773,117,77,90
2134,69,3,314,3,1776,66,36,30
2135,69,3,315,9,1785,127,75,90
2136,69,3,316,9,1794,157,94,90
2137,69,3,317,3,1797,96,56,30
2138,69,3,318,3,1800,60,60,30
2139,69,3,319,8,1808,88,53,80
2140,69,3,320,5,1813,78,78,50
2141,69,3,321,8,1821,72,43,80
2142,69,3,322,9,1830,123,75,90
2143,69,3,323,3,1833,78,56,30
2144,69,3,324,5,1838,69,47,50
2145,69,3,325,8,1846,104,69,80
2146,69,3,326,2,1848,65,35,20
2147,69,3,327,8,1856,125,74,80
2148,69,3,328,3,1859,78,45,30
2149,69,3,329,4,1863,70,38,40
2150,69,3,330,9,1872,129,76,90
2151,69,3,331,5,1877,100,65,50
2152,69,3,332,8,1885,114,70,80
2153,69,3,333,3,1888,72,46,30
2154,69,3,334,3,1891,65,44,30
2155,69,3,335,9,1900,113,78,90
2156,69,3,336,8,1908,119,71,80
2157,69,3,337,2,1910,68,39,20
2158,69,3,338,4,1914,80,46,40
2159,69,3,339,9,1923,115,76,90
2160,69,3,340,9,1932,135,83,90
2161,69,3,341,6,1938,104,59,60
2162,69,3,342,5,1943,101,55,50
2163,69,3,343,6,1949,99,57,60
2164,69,3,344,2,1951,55,29,20
2165,69,3,345,5,1956,73,73,50
2166,69,3,346,7,1963,73,44,70
2167,69,3,347,8,1971,111,57,80
2168,69,3,348,2,1973,69,36,20
2169,69,3,349,5,1978,84,54,50
2170,69,3,350,9,1987,105,105,90
2171,69,3,351,8,1995,85,85,80
2172,69,3,352,7,2002,68,37,70
2173,69,3,353,9,2011,120,68,90
2174,69,3,354,4,2015,82,40,40
2175,69,3,355,2,2017,65,38,20
2176,69,3,356,4,2021,67,42,40
2177,69,3,357,2,2023,42,29,20
2178,69,3,358,6,2029,66,42,60
2179,69,3,359,9,2038,113,64,90
2180,69,3,360,8,2046,129,81,80
2181,69,3,361,7,2053,112,71,70
2182,69,3,362,5,2058,95,62,50
2183,69,3,363,9,2067,111,71,90
2184,69,3,364,3,2070,60,60,30
2185,69,3,365,3,2073,20,12,30
2186,69,3,366,6,2079,71,51,60
2187,69,3,367,9,2088,110,60,90
2188,69,3,368,6,2094,102,59,60
2189,69,3,369,8,2102,125,72,80
2190,69,3,370,4,2106,93,93,40
2191,69,3,371,3,2109,31,16,30
2192,69,3,372,5,2114,58,32,50
2193,69,3,373,2,2116,51,36,20
2194,69,3,374,5,2121,65,39,50
2195,69,3,375,4,2125,62,37,40
2196,69,3,376,4,2129,72,40,40
2197,69,3,377,7,2136,80,50,70
2198,69,3,378,9,2145,109,109,90
2199,69,3,379,3,2148,29,16,30
2200,69,3,380,5,2153,75,36,50
2201,69,3,381,9,2162,122,68,90
2202,69,3,382,7,2169,105,60,70
2203,69,3,383,5,2174,91,53,50
2204,69,3,384,2,2176,55,35,20
2205,69,3,385,2,2178,43,21,20
2206,69,3,386,2,2180,43,23,20
2207,69,3,387,7,2187,96,96,70
2208,69,3,388,2,2189,25,15,20
2209,69,3,389,4,2193,46,28,40
2210,69,3,390,5,2198,71,41,50
2211,69,3,391,4,2202,79,40,40
2212,69,3,392,4,2206,82,82,40
2213,69,3,393,9,2215,93,66,90
2214,69,3,394,5,2220,75,75,50
2215,69,3,395,2,2222,21,12,20
2216,69,3,396,8,2230,92,62,80
2217,69,3,397,7,2237,101,59,70
2218,69,3,398,4,2241,91,53,40
2219,69,3,399,7,2248,95,49,70
2220,69,3,400,8,2256,120,69,80
2221,69,3,401,5,2261,102,62,50
2222,69,3,402,3,2264,68,33,30
2223,69,3,403,9,2273,137,89,90
2224,69,3,404,7,2280,108,108,70
2225,69,3,405,6,2286,65,40,60
2226,69,3,406,8,2294,107,62,80
2227,69,3,407,2,2296,79,79,20
2228,69,3,408,8,2304,84,44,80
2229,69,3,409,2,2306,51,24,20
2230,69,3,410,9,2315,114,68,90
2231,69,3,411,6,2321,97,51,60
2232,69,3,412,2,2323,59,34,20
2233,69,3,413,3,2326,59,27,30
2234,69,3,414,3,2329,71,71,30
2235,69,3,415,9,2338,70,50,90
2236,69,3,416,4,2342,58,35,40
2237,69,3,417,8,2350,118,71,80
2238,69,3,418,7,2357,130,78,70
2239,69,3,419,6,2363,114,68,60
2240,69,3,420,2,2365,69,69,20
2241,69,3,421,3,2368,28,28,30
2242,69,3,422,4,2372,33,33,40
2243,69,3,423,5,2377,55,55,50
2244,69,3,424,3,2380,37,21,30
2245,69,3,425,5,2385,63,37,50
2246,69,3,426,8,2393,113,55,80
2247,69,3,427,3,2396,90,53,30
2248,69,3,428,2,2398,56,22,20
2249,69,3,429,7,2405,95,57,70
2250,69,3,430,8,2413,120,76,80
2251,69,3,431,9,2422,138,81,90
2252,69,3,432,3,2425,84,49,30
2253,69,3,433,9,2434,125,67,90
2254,69,3,434,8,2442,138,93,80
2255,69,3,435,5,2447,86,50,50
2256,69,3,436,4,2451,81,47,40
2257,69,3,437,9,2460,155,87,90
2258,69,3,438,3,2463,100,59,30
2259,69,3,439,3,2466,70,46,30
2260,69,3,440,6,2472,84,49,60
2261,69,3,441,2,2474,55,37,20
2262,69,3,442,6,2480,75,45,60
2263,69,3,443,8,2488,95,95,80
2264,69,3,444,7,2495,67,47,70
2265,69,3,445,7,2502,72,45,70
2266,69,3,446,6,2508,90,50,60
2267,69,3,447,2,2510,60,60,20
2268,69,3,448,2,2512,23,11,20
2269,69,3,449,2,2514,30,11,20
2270,69,3,450,6,2520,69,69,60
2271,69,3,451,4,2524,31,22,40
2272,69,3,452,6,2530,76,51,60
2273,69,3,453,9,2539,116,73,90
2274,69,3,454,5,2544,101,58,50
2275,69,3,455,2,2546,72,49,20
2276,69,3,456,5,2551,67,67,50
2277,69,3,457,9,2560,87,48,90
2278,69,3,458,5,2565,90,56,50
2279,69,3,459,3,2568,61,39,30
2280,69,3,460,9,2577,103,55,90
2281,69,3,461,5,2582,100,100,50
2282,69,3,462,8,2590,81,55,80
2283,69,3,463,6,2596,109,109,60
2284,69,3,464,7,2603,77,77,70
2285,69,3,465,9,2612,86,86,90
2286,69,3,466,2,2614,25,17,20
2287,69,3,467,4,2618,43,43,40
2288,69,3,468,8,2626,70,70,80
2289,69,3,469,4,2630,42,28,40
2290,69,3,470,6,2636,82,46,60
2291,69,3,471,4,2640,82,54,40
2292,69,3,472,7,2647,109,70,70
2293,69,3,473,4,2651,88,53,40
2294,69,3,474,8,2659,94,56,80
2295,69,3,475,3,2662,68,37,30
2296,69,3,476,7,2669,92,54,70
2297,69,3,477,7,2676,112,72,70
2298,69,3,478,8,2684,123,70,80
2299,69,3,479,6,2690,119,66,60
2300,69,3,480,2,2692,75,53,20
2301,69,3,481,2,2694,37,23,20
2302,69,3,482,6,2700,86,47,60
2303,69,3,483,7,2707,112,69,70
2304,69,3,484,6,2713,94,65,60
2305,69,3,485,2,2715,55,31,20
2306,69,3,486,2,2717,49,31,20
2307,69,3,487,3,2720,46,28,30
2308,69,3,488,6,2726,64,39,60
2309,69,3,489,7,2733,103,62,70
2310,69,3,490,3,2736,69,69,30
2311,69,3,491,9,2745,95,52,90
2312,69,3,492,4,2749,83,51,40
2313,69,3,493,9,2758,108,108,90
2314,69,3,494,2,2760,23,11,20
2315,69,3,495,3,2763,38,38,30
2316,69,3,496,5,2768,47,47,50
2317,69,3,497,4,2772,38,24,40
2318,69,3,498,8,2780,102,65,80
2319,69,3,499,3,2783,71,43,30
2320,69,3,500,6,2789,87,56,60
2321,69,3,501,6,2795,92,58,60
2322,69,3,502,6,2801,88,55,60
2323,69,3,503,2,2803,51,51,20
2324,69,3,504,3,2806,23,15,30
2325,69,3,505,4,2810,47,31,40
2326,69,3,506,9,2819,94,94,90
2327,69,3,507,6,2825,62,35,60
2328,69,3,508,5,2830,77,77,50
2329,69,3,509,6,2836,51,51,60
2330,69,3,510,4,2840,32,21,40
2331,69,3,511,5,2845,63,35,50
2332,69,3,512,9,2854,150,87,90
2333,69,3,513,7,2861,135,78,70
2334,69,3,514,4,2865,100,58,40
2335,69,3,515,8,2873,121,71,80
2336,69,3,516,6,2879,103,54,60
2337,69,3,517,2,2881,61,40,20
2338,69,3,518,5,2886,63,63,50
2339,69,3,519,8,2894,86,55,80
2340,69,3,520,4,2898,71,36,40
2341,69,3,521,2,2900,61,36,20
2342,69,3,522,9,2909,121,76,90
2343,69,3,523,8,2917,129,77,80
2344,69,3,524,7,2924,111,73,70
2345,69,3,525,9,2933,115,115,90
2346,69,3,526,9,2942,82,47,90
2347,69,3,527,7,2949,114,68,70
2348,69,3,528,4,2953,85,56,40
2349,69,3,529,6,2959,85,52,60
2350,69,3,530,4,2963,70,41,40
2351,69,3,531,8,2971,97,61,80
2352,69,3,532,5,2976,87,48,50
2353,69,3,533,2,2978,53,24,20
2354,69,3,534,9,2987,108,63,90
2355,69,3,535,2,2989,67,67,20
2356,69,3,536,5,2994,47,30,50
2357,69,3,537,3,2997,47,47,30
2358,69,3,538,9,3006,95,60,90
2359,69,3,539,5,3011,86,47,50
2360,69,3,540,2,3013,56,38,20
2361,69,3,541,6,3019,66,66,60
2362,69,3,542,3,3022,30,11,30
2363,69,3,543,8,3030,93,55,80
2364,69,3,544,3,3033,80,48,30
2365,69,3,545,3,3036,58,43,30
2366,69,3,546,8,3044,86,56,80
2367,69,3,547,7,3051,89,54,70
2368,69,3,548,9,3060,120,89,90
2369,69,3,549,2,3062,55,35,20
2370,69,3,550,5,3067,67,50,50
2371,69,3,551,7,3074,83,48,70
2372,69,3,552,7,3081,106,63,70
2373,69,3,553,7,3088,114,114,70
2374,69,3,554,6,3094,60,33,60
2375,69,3,555,8,3102,112,62,80
2376,69,3,556,3,3105,82,39,30
2377,69,3,557,6,3111,90,48,60
2378,69,3,558,7,3118,109,54,70
2379,69,3,559,6,3124,113,66,60
2380,69,3,560,2,3126,66,39,20
2381,69,3,561,4,3130,71,39,40
2382,69,3,562,4,3134,61,61,40
2383,69,3,563,2,3136,26,11,20
2384,69,3,564,8,3144,92,92,80
2385,69,3,565,9,3153,77,45,90
2386,69,3,566,6,3159,82,48,60
2387,69,3,567,4,3163,71,41,40
2388,69,3,568,8,3171,121,121,80
2389,69,3,569,7,3178,80,80,70
2390,69,3,570,3,3181,31,18,30
2391,69,3,571,9,3190,100,60,90
2392,69,3,572,4,3194,74,40,40
2393,69,3,573,5,3199,83,83,50
2394,69,3,574,7,3206,63,40,70
2395,69,3,575,9,3215,103,65,90
2396,69,3,576,8,3223,109,68,80
2397,69,3,577,2,3225,58,29,20
2398,69,3,578,3,3228,65,34,30
2399,69,3,579,3,3231,63,63,30
2400,69,3,580,5,3236,48,32,50
2401,69,3,581,4,3240,49,33,40
2402,69,3,582,8,3248,82,44,80
2403,69,3,583,2,3250,53,37,20
2404,69,3,584,8,3258,87,42,80
2405,69,3,585,4,3262,76,38,40
2406,69,3,586,8,3270,125,74,80
2407,69,3,587,4,3274,91,54,40
2408,69,3,588,9,3283,120,78,90
2409,69,3,589,6,3289,106,63,60
2410,69,3,590,8,3297,110,63,80
2411,69,3,591,4,3301,75,75,40
2412,69,3,592,2,3303,17,9,20
2413,69,3,593,4,3307,44,44,40
2414,69,3,594,6,3313,62,36,60
2415,69,3,595,7,3320,117,77,70
2416,69,3,596,8,3328,120,81,80
2417,69,3,597,9,3337,135,78,90
2418,69,3,598,2,3339,79,47,20
2419,69,3,599,4,3343,60,32,40
2420,69,3,600,9,3352,129,65,90
2421,69,3,601,6,3358,126,66,60
2422,69,3,602,9,3367,152,100,90
2423,69,3,603,4,3371,84,40,40
2424,69,3,604,7,3378,115,74,70
2425,69,3,605,8,3386,127,81,80
2426,69,3,606,3,3389,77,43,30
2427,69,3,607,5,3394,70,41,50
2428,69,3,608,9,3403,118,59,90
2429,69,3,609,7,3410,121,66,70
2430,69,3,610,9,3419,136,136,90
2431,69,3,611,7,3426,79,43,70
2432,69,3,612,8,3434,111,70,80
2433,69,3,613,7,3441,118,118,70
2434,69,3,614,2,3443,26,22,20
2435,69,3,615,7,3450,71,41,70
2436,69,3,616,2,3452,43,20,20
2437,69,3,617,2,3454,41,41,20
2438,69,3,618,7,3461,63,34,70
2439,69,3,619,3,3464,53,36,30
2440,69,3,620,4,3468,61,33,40
2441,69,3,621,3,3471,50,50,30
2442,69,3,622,4,3475,38,22,40
2443,69,3,623,9,3484,112,74,90
2444,69,3,624,8,3492,115,68,80
2445,69,3,625,9,3501,123,68,90
2446,69,3,626,4,3505,103,54,40
2447,69,3,627,4,3509,77,47,40
2448,69,3,628,6,3515,79,45,60
2449,69,3,629,8,3523,113,67,80
2450,69,3,630,8,3531,128,78,80
2451,69,3,631,9,3540,141,87,90
2452,69,3,632,2,3542,69,46,20
2453,69,3,633,9,3551,99,56,90
2454,69,3,634,9,3560,123,68,90
2455,69,3,635,7,3567,136,136,70
2456,69,3,636,6,3573,70,43,60
2457,69,3,637,9,3582,145,88,90
2458,69,3,638,9,3591,137,77,90
2459,69,3,639,2,3593,79,79,20
2460,69,3,640,6,3599,56,34,60
2461,69,3,641,7,3606,86,51,70
2462,69,3,642,6,3612,86,53,60
2463,69,3,643,4,3616,81,44,40
2464,69,3,644,9,3625,122,66,90
2465,69,3,645,2,3627,77,77,20
2466,69,3,646,3,3630,29,29,30
2467,69,3,647,6,3636,70,45,60
2468,69,3,648,5,3641,69,38,50
2469,69,3,649,2,3643,52,31,20
2470,69,3,650,2,3645,36,22,20
2471,69,3,651,6,3651,63,33,60
2472,69,3,652,9,3660,131,81,90
2473,69,3,653,9,3669,138,138,90
2474,69,3,654,9,3678,103,65,90
2475,69,3,655,3,3681,70,38,30
2476,69,3,656,6,3687,100,64,60
2477,69,3,657,8,3695,106,67,80
2478,69,3,658,7,3702,101,57,70
2479,69,3,659,7,3709,120,58,70
2480,69,3,660,7,3716,131,73,70
2481,69,3,661,6,3722,122,70,60
2482,69,3,662,6,3728,114,70,60
2483,69,3,663,7,3735,111,68,70
2484,69,3,664,7,3742,100,60,70
2485,69,3,665,3,3745,70,39,30
2486,69,3,666,6,3751,104,68,60
2487,69,3,667,3,3754,67,40,30
2488,69,3,668,5,3759,75,47,50
2489,69,3,669,4,3763,68,36,40
2490,69,3,670,2,3765,45,28,20
2491,69,3,671,6,3771,77,77,60
2492,69,3,672,3,3774,28,15,30
2493,69,3,673,7,3781,100,57,70
2494,69,3,674,3,3784,70,43,30
2495,69,3,675,4,3788,63,37,40
2496,69,3,676,9,3797,138,138,90
2497,69,3,677,3,3800,26,26,30
2498,69,3,678,4,3804,50,50,40
2499,69,3,679,9,3813,94,54,90
2500,69,3,680,8,3821,113,113,80
2501,69,3,681,7,3828,51,51,70
2502,69,3,682,6,3834,65,32,60
2503,69,3,683,4,3838,85,56,40
2504,69,3,684,6,3844,105,56,60
2505,69,3,685,4,3848,91,50,40
2506,69,3,686,7,3855,111,59,70
2507,69,3,687,2,3857,74,40,20
2508,69,3,688,8,3865,121,82,80
2509,69,3,689,5,3870,88,48,50
2510,69,3,690,3,3873,72,72,30
2511,69,3,691,3,3876,36,19,30
2512,69,3,692,6,3882,77,77,60
2513,69,3,693,3,3885,24,17,30
2514,69,3,694,4,3889,45,24,40
2515,69,3,695,7,3896,83,48,70
2516,69,3,696,7,3903,92,92,70
2517,69,3,697,9,3912,81,51,90
2518,69,3,698,9,3921,125,125,90
2519,69,3,699,2,3923,23,11,20
2520,69,3,700,9,3932,102,102,90
2521,69,3,701,9,3941,96,52,90
2522,69,3,702,2,3943,61,32,20
2523,69,3,703,9,3952,111,63,90
2524,69,3,704,9,3961,137,81,90
2525,69,3,705,6,3967,124,124,60
2526,69,3,706,7,3974,48,24,70
2527,69,3,707,4,3978,66,36,40
2528,69,3,708,7,3985,112,62,70
2529,69,3,709,2,3987,65,42,20
2530,69,3,710,6,3993,81,47,60
2531,69,3,711,4,3997,68,38,40
2532,69,3,712,6,4003,103,52,60
2533,69,3,713,3,4006,82,82,30
2534,69,3,714,7,4013,72,41,70
2535,69,3,715,3,4016,67,39,30
2536,69,3,716,3,4019,57,36,30
2537,69,3,717,4,4023,56,56,40
2538,69,3,718,3,4026,24,13,30
2539,69,3,719,6,4032,63,43,60
2540,69,3,720,5,4037,71,48,50
2541,69,3,721,6,4043,94,61,60
2542,69,3,722,3,4046,53,35,30
2543,69,3,723,6,4052,74,43,60
2544,69,3,724,6,4058,94,63,60
2545,69,3,725,4,4062,78,48,40
2546,69,3,726,4,4066,67,36,40
2547,69,3,727,8,4074,107,107,80
2548,69,3,728,4,4078,31,14,40
2549,69,3,729,6,4084,66,40,60
2550,69,3,730,2,4086,50,33,20
2551,69,3,731,9,4095,96,58,90
2552,69,3,732,6,4101,104,57,60
2553,69,3,733,4,4105,94,54,40
2554,69,3,734,6,4111,115,76,60
2555,69,3,735,3,4114,63,37,30
2556,69,3,736,2,4116,43,29,20
2557,69,3,737,4,4120,55,27,40
2558,69,3,738,5,4125,80,80,50
2559,69,3,739,9,4134,95,56,90
2560,69,3,740,4,4138,79,52,40
2561,69,3,741,5,4143,69,34,50
2562,69,3,742,9,4152,113,70,90
2563,69,3,743,8,4160,114,63,80
2564,69,3,744,3,4163,75,52,30
2565,69,3,745,8,4171,96,56,80
2566,69,3,746,2,4173,67,41,20
2567,69,3,747,9,4182,119,64,90
2568,69,3,748,4,4186,85,52,40
2569,69,3,749,6,4192,96,58,60
2570,69,3,750,7,4199,95,48,70
2571,69,3,751,5,4204,99,63,50
2572,69,3,752,9,4213,122,65,90
2573,69,3,753,2,4215,72,47,20
2574,69,3,754,3,4218,56,56,30
2575,69,3,755,7,4225,69,44,70
2576,69,3,756,3,4228,51,30,30
2577,69,3,757,9,4237,111,111,90
2578,69,3,758,8,4245,79,79,80
2579,69,3,759,3,4248,26,15,30
2580,69,3,760,4,4252,56,56,40
2581,69,3,761,3,4255,26,16,30
2582,69,3,762,5,4260,53,53,50
2583,69,3,763,8,4268,69,47,80
2584,69,3,764,3,4271,53,25,30
2585,69,3,765,9,4280,126,74,90
2586,69,3,766,8,4288,138,78,80
2587,69,3,767,8,4296,155,155,80
2588,69,3,768,4,4300,41,25,40
2589,69,3,769,8,4308,88,53,80
2590,69,3,770,5,4313,88,88,50
2591,69,3,771,8,4321,76,51,80
2592,69,3,772,6,4327,87,57,60
2593,69,3,773,3,4330,60,60,30
2594,69,3,774,9,4339,101,70,90
2595,69,3,775,8,4347,102,68,80
2596,69,3,776,6,4353,101,56,60
2597,69,3,777,6,4359,112,112,60
2598,69,3,778,9,4368,103,103,90
2599,69,3,779,7,4375,66,40,70
2600,69,3,780,7,4382,98,57,70
2601,69,3,781,8,4390,121,81,80
2602,69,3,782,8,4398,116,116,80
2603,69,3,783,5,4403,39,39,50
2604,69,3,784,8,4411,94,62,80
2605,69,3,785,9,4420,120,68,90
2606,69,3,786,6,4426,100,52,60
2607,69,3,787,7,4433,123,123,70
2608,69,3,788,9,4442,85,47,90
2609,69,3,789,5,4447,99,56,50
2610,69,3,790,6,4453,120,120,60
2611,69,3,791,7,4460,89,89,70
2612,69,3,792,3,4463,33,20,30
2613,69,3,793,7,4470,83,45,70
2614,69,3,794,5,4475,84,51,50
2615,69,3,795,3,4478,62,35,30
2616,69,3,796,7,4485,104,60,70
2617,69,3,797,8,4493,117,64,80
2618,69,3,798,7,4500,118,77,70
2619,69,3,799,7,4507,116,65,70
2620,69,3,800,6,4513,118,75,60
2621,69,3,801,9,4522,121,72,90
2622,69,3,802,6,4528,102,63,60
2623,69,3,803,2,4530,53,32,20
2624,69,3,804,7,4537,96,62,70
2625,69,3,805,4,4541,82,82,40
2626,69,3,806,8,4549,86,45,80
2627,69,3,807,9,4558,135,135,90
2628,69,3,808,6,4564,70,40,60
2629,69,3,809,2,4566,48,48,20
2630,69,3,810,2,4568,20,10,20
2631,69,3,811,9,4577,98,58,90
2632,69,3,812,6,4583,91,51,60
2633,69,3,813,5,4588,89,59,50
2634,69,3,814,5,4593,90,58,50
2635,69,3,815,8,4601,111,69,80
2636,69,3,816,6,4607,103,103,60
2637,69,3,817,2,4609,23,18,20
2638,69,3,818,7,4616,72,39,70
2639,69,3,819,9,4625,114,114,90
2640,69,3,820,8,4633,70,41,80
2641,69,3,821,9,4642,121,81,90
2642,69,3,822,6,4648,94,52,60
2643,69,3,823,5,4653,93,57,50
2644,69,3,824,9,4662,115,65,90
2645,69,3,825,7,4669,139,139,70
2646,69,3,826,4,4673,38,20,40
2647,69,3,827,8,4681,84,47,80
2648,69,3,828,6,4687,96,96,60
2649,69,3,829,2,4689,23,10,20
2650,69,3,830,9,4698,105,59,90
2651,69,3,831,4,4702,73,45,40
2652,69,3,832,4,4706,69,36,40
2653,69,3,833,6,4712,95,59,60
2654,69,3,834,8,4720,113,66,80
2655,69,3,835,7,4727,114,67,70
2656,69,3,836,9,4736,129,129,90
2657,69,3,837,7,4743,86,52,70
2658,69,3,838,9,4752,137,85,90
2659,69,3,839,5,4757,100,63,50
2660,69,3,840,2,4759,51,24,20
2661,69,3,841,7,4766,89,89,70
2662,69,3,842,5,4771,52,35,50
2663,69,3,843,3,4774,46,46,30
2664,69,3,844,4,4778,39,39,40
2665,69,3,845,3,4781,39,26,30
2666,69,3,846,5,4786,76,52,50
2667,69,3,847,5,4791,78,39,50
2668,69,3,848,2,4793,70,44,20
2669,69,3,849,9,4802,126,80,90
2670,69,3,850,2,4804,68,49,20
2671,69,3,851,5,4809,67,42,50
2672,69,3,852,9,4818,115,74,90
2673,69,3,853,8,4826,115,67,80
2674,69,3,854,4,4830,87,54,40
2675,69,3,855,2,4832,44,20,20
2676,69,3,856,5,4837,69,38,50
2677,69,3,857,9,4846,117,73,90
2678,69,3,858,7,4853,113,64,70
2679,69,3,859,9,4862,136,91,90
2680,69,3,860,8,4870,130,76,80
2681,69,3,861,4,4874,108,108,40
2682,69,3,862,4,4878,34,26,40
2683,69,3,863,9,4887,102,62,90
2684,69,3,864,7,4894,113,72,70
2685,69,3,865,2,4896,64,47,20
2686,69,3,866,4,4900,62,34,40
2687,69,3,867,9,4909,122,73,90
2688,69,3,868,2,4911,74,43,20
2689,69,3,869,5,4916,90,58,50
2690,69,3,870,2,4918,57,57,20
2691,69,3,871,9,4927,87,55,90
2692,69,3,872,6,4933,99,71,60
2693,69,3,873,3,4936,57,34,30
2694,69,3,874,8,4944,99,51,80
2695,69,3,875,3,4947,78,78,30
2696,69,3,876,8,4955,82,49,80
2697,69,3,877,3,4958,69,41,30
2698,69,3,878,8,4966,108,108,80
2699,69,3,879,8,4974,78,78,80
2700,69,3,880,7,4981,70,43,70
2701,69,3,881,7,4988,102,102,70
2702,69,3,882,7,4995,75,38,70
