,Scenario,Trial,Inspection,Interval,Time,Accumulation,Defects,Rate
0,254,1,1,3,3,28,11,30
1,254,1,2,6,9,66,66,60
2,254,1,3,2,11,14,5,20
3,254,1,4,8,19,83,34,80
4,254,1,5,6,25,115,115,60
5,254,1,6,5,30,54,54,50
6,254,1,7,8,38,73,73,80
7,254,1,8,9,47,73,73,90
8,254,1,9,6,53,69,69,60
9,254,1,10,2,55,23,23,20
10,254,1,11,6,61,67,67,60
11,254,1,12,7,68,89,89,70
12,254,1,13,5,73,49,18,50
13,254,1,14,2,75,50,50,20
14,254,1,15,9,84,92,92,90
15,254,1,16,3,87,32,32,30
16,254,1,17,3,90,27,27,30
17,254,1,18,9,99,89,89,90
18,254,1,19,3,102,32,32,30
19,254,1,20,2,104,15,15,20
20,254,1,21,5,109,46,46,50
21,254,1,22,4,113,43,15,40
22,254,1,23,9,122,114,37,90
23,254,1,24,6,128,139,139,60
24,254,1,25,6,134,46,46,60
25,254,1,26,3,137,31,5,30
26,254,1,27,8,145,111,36,80
27,254,1,28,5,150,121,121,50
28,254,1,29,7,157,73,73,70
29,254,1,30,9,166,104,40,90
30,254,1,31,8,174,140,140,80
31,254,1,32,8,182,78,78,80
32,254,1,33,3,185,28,28,30
33,254,1,34,5,190,38,38,50
34,254,1,35,4,194,37,19,40
35,254,1,36,9,203,109,109,90
36,254,1,37,4,207,42,14,40
37,254,1,38,9,216,116,116,90
38,254,1,39,4,220,43,17,40
39,254,1,40,9,229,107,39,90
40,254,1,41,4,233,109,40,40
41,254,1,42,6,239,128,128,60
42,254,1,43,2,241,23,6,20
43,254,1,44,7,248,89,89,70
44,254,1,45,4,252,32,32,40
45,254,1,46,8,260,87,87,80
46,254,1,47,5,265,41,13,50
47,254,1,48,6,271,97,97,60
48,254,1,49,3,274,42,42,30
49,254,1,50,4,278,39,14,40
50,254,1,51,4,282,61,23,40
51,254,1,52,2,284,58,21,20
52,254,1,53,9,293,136,136,90
53,254,1,54,4,297,40,16,40
54,254,1,55,5,302,65,21,50
55,254,1,56,7,309,110,42,70
56,254,1,57,2,311,88,88,20
57,254,1,58,4,315,37,37,40
58,254,1,59,3,318,38,14,30
59,254,1,60,2,320,39,39,20
60,254,1,61,9,329,87,87,90
61,254,1,62,5,334,42,15,50
62,254,1,63,3,337,50,50,30
63,254,1,64,4,341,48,18,40
64,254,1,65,7,348,94,22,70
65,254,1,66,3,351,102,102,30
66,254,1,67,9,360,85,31,90
67,254,1,68,6,366,111,111,60
68,254,1,69,3,369,31,31,30
69,254,1,70,8,377,78,78,80
70,254,1,71,9,386,77,77,90
71,254,1,72,2,388,21,21,20
72,254,1,73,7,395,76,76,70
73,254,1,74,4,399,43,43,40
74,254,1,75,9,408,94,94,90
75,254,1,76,2,410,22,22,20
76,254,1,77,9,419,101,101,90
77,254,1,78,2,421,23,23,20
78,254,1,79,8,429,93,23,80
79,254,1,80,2,431,88,29,20
80,254,1,81,8,439,137,137,80
81,254,1,82,5,444,59,59,50
82,254,1,83,8,452,90,90,80
83,254,1,84,4,456,38,38,40
84,254,1,85,8,464,79,79,80
85,254,1,86,9,473,84,84,90
86,254,1,87,6,479,66,66,60
87,254,1,88,6,485,68,68,60
88,254,1,89,2,487,20,10,20
89,254,1,90,2,489,39,18,20
90,254,1,91,5,494,77,77,50
91,254,1,92,7,501,73,15,70
92,254,1,93,8,509,132,132,80
93,254,1,94,9,518,89,29,90
94,254,1,95,7,525,120,120,70
95,254,1,96,6,531,65,65,60
96,254,1,97,9,540,108,108,90
97,254,1,98,2,542,20,20,20
98,254,1,99,3,545,29,9,30
99,254,1,100,8,553,92,92,80
100,254,1,101,9,562,88,35,90
101,254,1,102,5,567,105,36,50
102,254,1,103,7,574,149,63,70
103,254,1,104,4,578,122,122,40
104,254,1,105,7,585,57,57,70
105,254,1,106,7,592,80,80,70
106,254,1,107,7,599,85,25,70
107,254,1,108,4,603,99,30,40
108,254,1,109,8,611,151,151,80
109,254,1,110,3,614,32,32,30
110,254,1,111,8,622,71,24,80
111,254,1,112,8,630,132,132,80
112,254,1,113,9,639,84,84,90
113,254,1,114,5,644,49,49,50
114,254,1,115,2,646,16,4,20
115,254,1,116,9,655,104,39,90
116,254,1,117,2,657,80,80,20
117,254,1,118,7,664,64,64,70
118,254,1,119,6,670,48,48,60
119,254,1,120,7,677,57,19,70
120,254,1,121,9,686,126,126,90
121,254,1,122,6,692,50,21,60
122,254,1,123,8,700,93,93,80
123,254,1,124,6,706,62,62,60
124,254,1,125,4,710,42,42,40
125,254,1,126,6,716,62,62,60
126,254,1,127,5,721,42,42,50
127,254,1,128,5,726,57,12,50
128,254,1,129,8,734,119,119,80
129,254,1,130,6,740,57,57,60
130,254,1,131,3,743,22,22,30
131,254,1,132,6,749,64,64,60
132,254,1,133,6,755,69,24,60
133,254,1,134,8,763,135,50,80
134,254,1,135,3,766,110,37,30
135,254,1,136,7,773,146,146,70
136,254,1,137,6,779,49,49,60
137,254,1,138,7,786,64,64,70
138,254,1,139,9,795,76,76,90
139,254,1,140,6,801,60,60,60
140,254,1,141,5,806,47,47,50
141,254,1,142,3,809,22,22,30
142,254,1,143,4,813,48,11,40
143,254,1,144,4,817,77,77,40
144,254,1,145,7,824,61,61,70
145,254,1,146,8,832,63,16,80
146,254,1,147,6,838,109,45,60
147,254,1,148,4,842,106,106,40
148,254,1,149,6,848,68,68,60
149,254,1,150,2,850,20,20,20
150,254,1,151,9,859,86,86,90
151,254,1,152,9,868,71,71,90
152,254,1,153,2,870,30,10,20
153,254,1,154,4,874,58,58,40
154,254,1,155,8,882,82,82,80
155,254,1,156,2,884,21,7,20
156,254,1,157,9,893,91,91,90
157,254,1,158,3,896,39,12,30
158,254,1,159,5,901,75,22,50
159,254,1,160,8,909,125,125,80
160,254,1,161,8,917,84,27,80
161,254,1,162,9,926,143,143,90
162,254,1,163,5,931,57,57,50
163,254,1,164,3,934,32,32,30
164,254,1,165,7,941,58,58,70
165,254,1,166,3,944,38,38,30
166,254,1,167,6,950,60,60,60
167,254,1,168,7,957,82,82,70
168,254,1,169,7,964,71,71,70
169,254,1,170,4,968,41,11,40
170,254,1,171,5,973,93,93,50
171,254,1,172,6,979,67,23,60
172,254,1,173,4,983,78,78,40
173,254,1,174,3,986,30,9,30
174,254,1,175,8,994,111,46,80
175,254,1,176,2,996,80,80,20
176,254,1,177,4,1000,36,36,40
177,254,1,178,5,1005,58,18,50
178,254,1,179,8,1013,124,51,80
179,254,1,180,8,1021,149,149,80
180,254,1,181,6,1027,59,59,60
181,254,1,182,3,1030,25,8,30
182,254,1,183,3,1033,50,16,30
183,254,1,184,5,1038,83,26,50
184,254,1,185,4,1042,104,104,40
185,254,1,186,7,1049,71,29,70
186,254,1,187,5,1054,88,88,50
187,254,1,188,7,1061,66,23,70
188,254,1,189,7,1068,117,117,70
189,254,1,190,7,1075,64,21,70
190,254,1,191,5,1080,94,94,50
191,254,1,192,4,1084,54,18,40
192,254,1,193,7,1091,115,115,70
193,254,1,194,6,1097,49,49,60
194,254,1,195,5,1102,57,57,50
195,254,1,196,4,1106,36,7,40
196,254,1,197,7,1113,98,36,70
197,254,1,198,6,1119,121,121,60
198,254,1,199,8,1127,66,66,80
199,254,1,200,6,1133,67,23,60
200,254,1,201,8,1141,134,134,80
201,254,1,202,8,1149,71,23,80
202,254,1,203,9,1158,133,51,90
203,254,1,204,5,1163,140,61,50
204,254,1,205,7,1170,137,54,70
205,254,1,206,5,1175,128,128,50
206,254,1,207,8,1183,77,77,80
207,254,1,208,7,1190,90,33,70
208,254,1,209,3,1193,94,94,30
209,254,1,210,2,1195,29,29,20
210,254,1,211,9,1204,72,72,90
211,254,1,212,5,1209,39,39,50
212,254,1,213,5,1214,40,13,50
213,254,1,214,3,1217,48,48,30
214,254,1,215,6,1223,52,52,60
215,254,1,216,2,1225,16,16,20
216,254,1,217,3,1228,26,26,30
217,254,1,218,6,1234,65,27,60
218,254,1,219,5,1239,79,28,50
219,254,1,220,8,1247,109,109,80
220,254,1,221,7,1254,69,69,70
221,254,1,222,6,1260,64,64,60
222,254,1,223,7,1267,53,53,70
223,254,1,224,5,1272,41,41,50
224,254,1,225,9,1281,91,31,90
225,254,1,226,6,1287,124,124,60
226,254,1,227,9,1296,96,36,90
227,254,1,228,5,1301,121,121,50
228,254,1,229,4,1305,43,14,40
229,254,1,230,5,1310,71,71,50
230,254,1,231,5,1315,58,19,50
231,254,1,232,7,1322,96,96,70
232,254,1,233,4,1326,45,45,40
233,254,1,234,9,1335,88,88,90
234,254,1,235,9,1344,87,30,90
235,254,1,236,2,1346,77,77,20
236,254,1,237,3,1349,20,10,30
237,254,1,238,2,1351,31,31,20
238,254,1,239,2,1353,23,23,20
239,254,1,240,8,1361,73,73,80
240,254,1,241,9,1370,93,93,90
241,254,1,242,5,1375,37,37,50
242,254,1,243,7,1382,74,74,70
243,254,1,244,4,1386,40,40,40
244,254,1,245,5,1391,50,19,50
245,254,1,246,3,1394,51,51,30
246,254,1,247,9,1403,98,98,90
247,254,1,248,7,1410,89,89,70
248,254,1,249,2,1412,26,26,20
249,254,1,250,2,1414,25,25,20
250,254,1,251,7,1421,68,68,70
251,254,1,252,5,1426,47,47,50
252,254,1,253,8,1434,84,84,80
253,254,1,254,9,1443,94,94,90
254,254,1,255,8,1451,83,83,80
255,254,1,256,2,1453,30,30,20
256,254,1,257,4,1457,46,17,40
257,254,1,258,3,1460,56,56,30
258,254,1,259,9,1469,94,94,90
259,254,1,260,7,1476,78,78,70
260,254,1,261,2,1478,20,5,20
261,254,1,262,2,1480,27,16,20
262,254,1,263,2,1482,24,24,20
263,254,1,264,8,1490,77,23,80
264,254,1,265,9,1499,150,55,90
265,254,1,266,8,1507,172,56,80
266,254,1,267,2,1509,135,135,20
267,254,1,268,2,1511,24,24,20
268,254,1,269,9,1520,98,36,90
269,254,1,270,4,1524,106,106,40
270,254,1,271,2,1526,19,5,20
271,254,1,272,7,1533,76,76,70
272,254,1,273,2,1535,17,17,20
273,254,1,274,7,1542,66,66,70
274,254,1,275,6,1548,55,17,60
275,254,1,276,9,1557,137,137,90
276,254,1,277,5,1562,46,46,50
277,254,1,278,7,1569,67,67,70
278,254,1,279,2,1571,20,5,20
279,254,1,280,6,1577,65,65,60
280,254,1,281,7,1584,77,77,70
281,254,1,282,4,1588,36,15,40
282,254,1,283,3,1591,55,55,30
283,254,1,284,9,1600,95,95,90
284,254,1,285,3,1603,18,18,30
285,254,1,286,6,1609,58,58,60
286,254,1,287,7,1616,63,63,70
287,254,1,288,2,1618,27,27,20
288,254,1,289,9,1627,92,92,90
289,254,1,290,9,1636,119,119,90
290,254,1,291,5,1641,53,53,50
291,254,1,292,6,1647,51,51,60
292,254,1,293,3,1650,23,23,30
293,254,1,294,3,1653,30,30,30
294,254,1,295,9,1662,91,91,90
295,254,1,296,4,1666,42,42,40
296,254,1,297,3,1669,36,36,30
297,254,1,298,2,1671,15,3,20
298,254,1,299,3,1674,41,41,30
299,254,1,300,6,1680,66,21,60
300,254,1,301,4,1684,84,84,40
301,254,1,302,6,1690,62,62,60
302,254,1,303,9,1699,111,111,90
303,254,1,304,3,1702,27,27,30
304,254,1,305,7,1709,61,61,70
305,254,1,306,6,1715,74,74,60
306,254,1,307,2,1717,20,20,20
307,254,1,308,6,1723,74,29,60
308,254,1,309,6,1729,109,109,60
309,254,1,310,5,1734,58,58,50
310,254,1,311,3,1737,23,23,30
311,254,1,312,4,1741,51,51,40
312,254,1,313,9,1750,101,101,90
313,254,1,314,6,1756,58,58,60
314,254,1,315,6,1762,58,58,60
315,254,1,316,6,1768,71,71,60
316,254,1,317,9,1777,103,30,90
317,254,1,318,4,1781,113,113,40
318,254,1,319,5,1786,56,22,50
319,254,1,320,4,1790,68,68,40
320,254,1,321,8,1798,71,71,80
321,254,1,322,3,1801,32,32,30
322,254,1,323,2,1803,21,21,20
323,254,1,324,3,1806,25,9,30
324,254,1,325,7,1813,90,90,70
325,254,1,326,8,1821,85,85,80
326,254,1,327,9,1830,81,32,90
327,254,1,328,9,1839,137,137,90
328,254,1,329,4,1843,44,44,40
329,254,1,330,6,1849,60,60,60
330,254,1,331,5,1854,47,47,50
331,254,1,332,5,1859,35,35,50
332,254,1,333,3,1862,41,41,30
333,254,1,334,7,1869,80,80,70
334,254,1,335,3,1872,32,32,30
335,254,1,336,2,1874,17,6,20
336,254,1,337,5,1879,55,55,50
337,254,1,338,8,1887,88,88,80
338,254,1,339,3,1890,32,32,30
339,254,1,340,6,1896,58,58,60
340,254,1,341,5,1901,52,52,50
341,254,1,342,4,1905,55,55,40
342,254,1,343,4,1909,44,44,40
343,254,1,344,2,1911,17,17,20
344,254,1,345,6,1917,62,16,60
345,254,1,346,7,1924,115,115,70
346,254,1,347,9,1933,88,88,90
347,254,1,348,5,1938,58,58,50
348,254,1,349,3,1941,36,36,30
349,254,1,350,4,1945,31,31,40
350,254,1,351,2,1947,15,6,20
351,254,1,352,9,1956,90,90,90
352,254,1,353,9,1965,91,91,90
353,254,1,354,6,1971,66,66,60
354,254,1,355,3,1974,23,23,30
355,254,1,356,8,1982,91,32,80
356,254,1,357,8,1990,142,48,80
357,254,1,358,2,1992,109,40,20
358,254,1,359,2,1994,81,27,20
359,254,1,360,7,2001,107,107,70
360,254,1,361,5,2006,48,48,50
361,254,1,362,7,2013,76,76,70
362,254,1,363,2,2015,22,22,20
363,254,1,364,7,2022,62,62,70
364,254,1,365,9,2031,82,82,90
365,254,1,366,6,2037,51,51,60
366,254,1,367,2,2039,20,20,20
367,254,1,368,6,2045,58,58,60
368,254,1,369,2,2047,16,9,20
369,254,1,370,2,2049,29,29,20
370,254,1,371,8,2057,79,79,80
371,254,1,372,2,2059,17,4,20
372,254,1,373,8,2067,95,95,80
373,254,1,374,5,2072,53,53,50
374,254,1,375,6,2078,71,26,60
375,254,1,376,2,2080,61,61,20
376,254,1,377,2,2082,14,7,20
377,254,1,378,8,2090,93,93,80
378,254,1,379,5,2095,50,50,50
379,254,1,380,5,2100,61,15,50
380,254,1,381,2,2102,75,29,20
381,254,1,382,6,2108,108,46,60
382,254,1,383,2,2110,84,84,20
383,254,1,384,5,2115,55,18,50
384,254,1,385,7,2122,112,112,70
385,254,1,386,3,2125,25,25,30
386,254,1,387,8,2133,90,90,80
387,254,1,388,4,2137,51,51,40
388,254,1,389,2,2139,14,3,20
389,254,1,390,8,2147,79,24,80
390,254,1,391,8,2155,125,39,80
391,254,1,392,8,2163,157,157,80
392,254,1,393,6,2169,67,67,60
393,254,1,394,9,2178,93,93,90
394,254,1,395,4,2182,50,16,40
395,254,1,396,2,2184,47,47,20
396,254,1,397,4,2188,37,37,40
397,254,1,398,5,2193,40,40,50
398,254,1,399,8,2201,84,32,80
399,254,1,400,4,2205,101,101,40
400,254,1,401,6,2211,65,65,60
401,254,1,402,5,2216,49,49,50
402,254,1,403,8,2224,62,62,80
403,254,1,404,2,2226,13,3,20
404,254,1,405,2,2228,26,26,20
405,254,1,406,9,2237,102,24,90
406,254,1,407,4,2241,124,47,40
407,254,1,408,2,2243,110,110,20
408,254,1,409,4,2247,38,38,40
409,254,1,410,9,2256,86,86,90
410,254,1,411,2,2258,16,16,20
411,254,1,412,5,2263,62,17,50
412,254,1,413,9,2272,126,126,90
413,254,1,414,8,2280,76,27,80
414,254,1,415,4,2284,82,82,40
415,254,1,416,5,2289,50,50,50
416,254,1,417,5,2294,56,56,50
417,254,1,418,4,2298,40,40,40
418,254,1,419,5,2303,36,36,50
419,254,1,420,9,2312,83,83,90
420,254,1,421,5,2317,62,62,50
421,254,1,422,7,2324,70,70,70
422,254,1,423,9,2333,89,89,90
423,254,1,424,2,2335,18,18,20
424,254,1,425,2,2337,22,22,20
425,254,1,426,2,2339,27,10,20
426,254,1,427,4,2343,70,70,40
427,254,1,428,7,2350,79,79,70
428,254,1,429,6,2356,59,59,60
429,254,1,430,4,2360,40,40,40
430,254,1,431,7,2367,64,20,70
431,254,1,432,5,2372,111,111,50
432,254,1,433,8,2380,94,94,80
433,254,1,434,6,2386,61,22,60
434,254,1,435,9,2395,117,117,90
435,254,1,436,7,2402,59,59,70
436,254,1,437,9,2411,88,88,90
437,254,1,438,9,2420,92,29,90
438,254,1,439,5,2425,106,39,50
439,254,1,440,8,2433,146,146,80
440,254,1,441,6,2439,65,65,60
441,254,1,442,9,2448,77,77,90
442,254,1,443,3,2451,22,22,30
443,254,1,444,3,2454,35,35,30
444,254,1,445,6,2460,63,17,60
445,254,1,446,7,2467,111,111,70
446,254,1,447,4,2471,58,20,40
447,254,1,448,4,2475,88,88,40
448,254,1,449,3,2478,30,30,30
449,254,1,450,9,2487,85,85,90
450,254,1,451,7,2494,64,64,70
451,254,1,452,2,2496,22,6,20
452,254,1,453,7,2503,85,85,70
453,254,1,454,4,2507,43,43,40
454,254,1,455,8,2515,100,32,80
455,254,1,456,2,2517,93,93,20
456,254,1,457,2,2519,18,18,20
457,254,1,458,2,2521,23,23,20
458,254,1,459,6,2527,54,19,60
459,254,1,460,7,2534,90,90,70
460,254,1,461,6,2540,51,51,60
461,254,1,462,9,2549,89,89,90
462,254,1,463,5,2554,44,44,50
463,254,1,464,2,2556,21,21,20
464,254,1,465,4,2560,36,36,40
465,254,1,466,8,2568,76,76,80
466,254,1,467,7,2575,61,61,70
467,254,1,468,8,2583,88,88,80
468,254,1,469,3,2586,25,25,30
469,254,1,470,7,2593,56,18,70
470,254,1,471,8,2601,125,125,80
471,254,1,472,5,2606,59,59,50
472,254,1,473,7,2613,68,68,70
473,254,1,474,6,2619,50,23,60
474,254,1,475,7,2626,108,108,70
475,254,1,476,7,2633,73,28,70
476,254,1,477,3,2636,86,86,30
477,254,1,478,9,2645,85,85,90
478,254,1,479,2,2647,16,16,20
479,254,1,480,8,2655,71,71,80
480,254,1,481,4,2659,28,10,40
481,254,1,482,9,2668,108,108,90
482,254,1,483,3,2671,23,1,30
483,254,1,484,7,2678,87,87,70
484,254,1,485,7,2685,78,23,70
485,254,1,486,3,2688,86,24,30
486,254,1,487,6,2694,119,119,60
487,254,1,488,2,2696,24,24,20
488,254,1,489,2,2698,21,21,20
489,254,1,490,5,2703,50,50,50
490,254,1,491,3,2706,30,30,30
491,254,1,492,6,2712,65,65,60
492,254,1,493,3,2715,19,19,30
493,254,1,494,5,2720,58,58,50
494,254,1,495,3,2723,49,49,30
495,254,1,496,7,2730,76,22,70
496,254,1,497,4,2734,92,92,40
497,254,1,498,8,2742,90,90,80
498,254,1,499,3,2745,34,34,30
499,254,1,500,9,2754,94,36,90
500,254,1,501,4,2758,87,87,40
501,254,1,502,5,2763,46,19,50
502,254,1,503,9,2772,91,91,90
503,254,1,504,9,2781,98,37,90
504,254,1,505,6,2787,107,35,60
505,254,1,506,8,2795,140,140,80
506,254,1,507,2,2797,17,17,20
507,254,1,508,6,2803,64,21,60
508,254,1,509,6,2809,115,115,60
509,254,1,510,9,2818,73,73,90
510,254,1,511,9,2827,88,88,90
511,254,1,512,4,2831,38,14,40
512,254,1,513,5,2836,77,77,50
513,254,1,514,7,2843,69,69,70
514,254,1,515,4,2847,41,41,40
515,254,1,516,8,2855,89,89,80
516,254,1,517,6,2861,61,23,60
517,254,1,518,2,2863,59,59,20
518,254,1,519,9,2872,106,106,90
519,254,1,520,9,2881,83,30,90
520,254,1,521,8,2889,133,133,80
521,254,1,522,3,2892,27,27,30
522,254,1,523,5,2897,52,52,50
523,254,1,524,9,2906,93,31,90
524,254,1,525,9,2915,150,150,90
525,254,1,526,7,2922,81,25,70
526,254,1,527,4,2926,100,27,40
527,254,1,528,3,2929,102,102,30
528,254,1,529,7,2936,63,63,70
529,254,1,530,2,2938,17,17,20
530,254,1,531,9,2947,92,32,90
531,254,1,532,5,2952,125,42,50
532,254,1,533,5,2957,140,140,50
533,254,1,534,9,2966,78,27,90
534,254,1,535,7,2973,124,124,70
535,254,1,536,6,2979,69,23,60
536,254,1,537,2,2981,71,71,20
537,254,1,538,2,2983,24,24,20
538,254,1,539,2,2985,32,32,20
539,254,1,540,9,2994,72,72,90
540,254,1,541,7,3001,71,71,70
541,254,1,542,4,3005,30,30,40
542,254,1,543,3,3008,24,24,30
543,254,1,544,5,3013,53,53,50
544,254,1,545,7,3020,62,62,70
545,254,1,546,6,3026,57,57,60
546,254,1,547,2,3028,15,15,20
547,254,1,548,5,3033,43,12,50
548,254,1,549,2,3035,46,16,20
549,254,1,550,2,3037,48,48,20
550,254,1,551,2,3039,19,19,20
551,254,1,552,5,3044,42,42,50
552,254,1,553,2,3046,22,22,20
553,254,1,554,3,3049,28,7,30
554,254,1,555,6,3055,75,26,60
555,254,1,556,4,3059,91,91,40
556,254,1,557,2,3061,16,16,20
557,254,1,558,4,3065,41,10,40
558,254,1,559,3,3068,55,55,30
559,254,1,560,2,3070,17,6,20
560,254,1,561,8,3078,85,85,80
561,254,1,562,4,3082,42,17,40
562,254,1,563,8,3090,105,105,80
563,254,1,564,3,3093,25,25,30
564,254,1,565,7,3100,72,25,70
565,254,1,566,5,3105,103,43,50
566,254,1,567,2,3107,83,24,20
567,254,1,568,2,3109,75,75,20
568,254,1,569,5,3114,38,13,50
569,254,1,570,7,3121,84,33,70
570,254,1,571,8,3129,142,142,80
571,254,1,572,4,3133,46,46,40
572,254,1,573,2,3135,24,24,20
573,254,1,574,2,3137,19,19,20
574,254,1,575,4,3141,39,39,40
575,254,1,576,5,3146,52,52,50
576,254,1,577,3,3149,21,21,30
577,254,1,578,6,3155,55,18,60
578,254,1,579,4,3159,74,18,40
579,254,1,580,4,3163,101,101,40
580,254,1,581,3,3166,27,12,30
581,254,1,582,7,3173,87,87,70
582,254,1,583,5,3178,51,51,50
583,254,1,584,7,3185,82,82,70
584,254,1,585,7,3192,66,66,70
585,254,1,586,7,3199,71,71,70
586,254,1,587,7,3206,62,62,70
587,254,1,588,9,3215,95,36,90
588,254,1,589,5,3220,111,111,50
589,254,1,590,9,3229,86,86,90
590,254,1,591,8,3237,66,66,80
591,254,1,592,8,3245,74,74,80
592,254,1,593,8,3253,81,81,80
593,254,1,594,6,3259,61,61,60
594,254,1,595,2,3261,16,16,20
595,254,1,596,4,3265,41,41,40
596,254,1,597,2,3267,22,9,20
597,254,1,598,6,3273,87,87,60
598,254,1,599,9,3282,96,96,90
599,254,1,600,8,3290,72,20,80
600,254,1,601,2,3292,69,69,20
601,254,1,602,7,3299,68,27,70
602,254,1,603,2,3301,62,62,20
603,254,1,604,2,3303,24,7,20
604,254,1,605,8,3311,107,107,80
605,254,1,606,6,3317,49,49,60
606,254,1,607,5,3322,49,49,50
607,254,1,608,6,3328,71,71,60
608,254,1,609,5,3333,58,58,50
609,254,1,610,6,3339,48,48,60
610,254,1,611,6,3345,58,13,60
611,254,1,612,7,3352,116,116,70
612,254,1,613,4,3356,48,48,40
613,254,1,614,3,3359,27,4,30
614,254,1,615,4,3363,54,54,40
615,254,1,616,6,3369,50,18,60
616,254,1,617,2,3371,49,49,20
617,254,1,618,8,3379,74,20,80
618,254,1,619,2,3381,79,79,20
619,254,1,620,8,3389,67,67,80
620,254,1,621,3,3392,26,7,30
621,254,1,622,3,3395,42,13,30
622,254,1,623,3,3398,54,54,30
623,254,1,624,4,3402,33,33,40
624,254,1,625,3,3405,23,6,30
625,254,1,626,6,3411,81,28,60
626,254,1,627,8,3419,159,159,80
627,254,1,628,2,3421,19,19,20
628,254,1,629,7,3428,72,72,70
629,254,1,630,6,3434,56,56,60
630,254,1,631,7,3441,67,67,70
631,254,1,632,6,3447,59,24,60
632,254,1,633,3,3450,73,24,30
633,254,1,634,3,3453,82,82,30
634,254,1,635,8,3461,76,28,80
635,254,1,636,2,3463,63,63,20
636,254,1,637,4,3467,37,37,40
637,254,1,638,4,3471,33,33,40
638,254,1,639,5,3476,46,13,50
639,254,1,640,5,3481,84,28,50
640,254,1,641,5,3486,92,92,50
641,254,1,642,2,3488,24,24,20
642,254,1,643,6,3494,60,60,60
643,254,1,644,9,3503,89,89,90
644,254,1,645,8,3511,100,100,80
645,254,1,646,5,3516,70,70,50
646,254,1,647,9,3525,76,76,90
647,254,1,648,8,3533,88,28,80
648,254,1,649,9,3542,153,153,90
649,254,1,650,8,3550,80,80,80
650,254,1,651,8,3558,85,85,80
651,254,1,652,3,3561,34,34,30
652,254,1,653,8,3569,76,76,80
653,254,1,654,2,3571,24,24,20
654,254,1,655,8,3579,74,30,80
655,254,1,656,9,3588,134,134,90
656,254,1,657,9,3597,96,96,90
657,254,1,658,8,3605,87,87,80
658,254,1,659,7,3612,74,74,70
659,254,1,660,4,3616,27,27,40
660,254,1,661,7,3623,71,29,70
661,254,1,662,6,3629,89,89,60
662,254,1,663,2,3631,23,23,20
663,254,1,664,5,3636,45,45,50
664,254,1,665,6,3642,65,65,60
665,254,1,666,6,3648,62,62,60
666,254,1,667,7,3655,67,15,70
667,254,1,668,5,3660,110,110,50
668,254,1,669,3,3663,38,38,30
669,254,1,670,4,3667,38,38,40
670,254,1,671,7,3674,67,23,70
671,254,1,672,9,3683,135,135,90
672,254,1,673,6,3689,59,26,60
673,254,1,674,9,3698,120,120,90
674,254,1,675,5,3703,48,48,50
675,254,1,676,4,3707,54,15,40
676,254,1,677,4,3711,85,85,40
677,254,1,678,7,3718,70,24,70
678,254,1,679,6,3724,115,45,60
679,254,1,680,7,3731,148,148,70
680,254,1,681,8,3739,68,68,80
681,254,1,682,7,3746,63,63,70
682,254,1,683,8,3754,74,74,80
683,254,1,684,8,3762,92,92,80
684,254,1,685,2,3764,28,28,20
685,254,1,686,3,3767,27,27,30
686,254,1,687,8,3775,71,71,80
687,254,1,688,9,3784,77,77,90
688,254,1,689,2,3786,15,15,20
689,254,1,690,4,3790,28,28,40
690,254,1,691,2,3792,24,8,20
691,254,1,692,5,3797,75,75,50
692,254,1,693,7,3804,87,87,70
693,254,1,694,7,3811,68,68,70
694,254,1,695,8,3819,90,90,80
695,254,1,696,6,3825,68,68,60
696,254,1,697,6,3831,64,64,60
697,254,1,698,9,3840,91,91,90
698,254,1,699,6,3846,62,62,60
699,254,1,700,8,3854,98,98,80
700,254,1,701,9,3863,85,85,90
701,254,1,702,8,3871,76,76,80
702,254,1,703,2,3873,22,2,20
703,254,1,704,4,3877,63,17,40
704,254,1,705,7,3884,121,121,70
705,254,1,706,5,3889,48,48,50
706,254,1,707,8,3897,87,87,80
707,254,1,708,8,3905,72,72,80
708,254,1,709,8,3913,71,22,80
709,254,1,710,9,3922,129,129,90
710,254,1,711,3,3925,32,32,30
711,254,1,712,4,3929,43,43,40
712,254,1,713,7,3936,67,67,70
713,254,1,714,4,3940,40,40,40
714,254,1,715,9,3949,80,37,90
715,254,1,716,5,3954,88,88,50
716,254,1,717,5,3959,48,14,50
717,254,1,718,6,3965,96,96,60
718,254,1,719,8,3973,85,85,80
719,254,1,720,7,3980,67,67,70
720,254,1,721,8,3988,79,27,80
721,254,1,722,9,3997,139,139,90
722,254,1,723,4,4001,42,42,40
723,254,1,724,4,4005,42,42,40
724,254,1,725,7,4012,61,61,70
725,254,1,726,7,4019,74,27,70
726,254,1,727,3,4022,75,24,30
727,254,1,728,6,4028,108,108,60
728,254,1,729,3,4031,22,22,30
729,254,1,730,2,4033,22,22,20
730,254,1,731,6,4039,59,17,60
731,254,1,732,3,4042,71,71,30
732,254,1,733,9,4051,87,27,90
733,254,1,734,8,4059,129,129,80
734,254,1,735,7,4066,81,81,70
735,254,1,736,3,4069,28,10,30
736,254,1,737,9,4078,113,113,90
737,254,1,738,2,4080,25,25,20
738,254,1,739,8,4088,70,70,80
739,254,1,740,8,4096,72,72,80
740,254,1,741,9,4105,104,36,90
741,254,1,742,4,4109,109,39,40
742,254,1,743,5,4114,134,44,50
743,254,1,744,6,4120,143,143,60
744,254,1,745,8,4128,87,87,80
745,254,1,746,9,4137,101,28,90
746,254,1,747,4,4141,100,34,40
747,254,1,748,9,4150,150,150,90
748,254,1,749,9,4159,90,90,90
749,254,1,750,3,4162,27,27,30
750,254,1,751,8,4170,92,92,80
751,254,1,752,8,4178,78,78,80
752,254,1,753,3,4181,29,10,30
753,254,1,754,8,4189,95,95,80
754,254,1,755,4,4193,36,36,40
755,254,1,756,4,4197,41,14,40
756,254,1,757,9,4206,113,39,90
757,254,1,758,4,4210,123,29,40
758,254,1,759,8,4218,175,63,80
759,254,1,760,7,4225,180,180,70
760,254,1,761,3,4228,24,24,30
761,254,1,762,8,4236,74,74,80
762,254,1,763,8,4244,71,71,80
763,254,1,764,3,4247,27,4,30
764,254,1,765,4,4251,66,17,40
765,254,1,766,6,4257,104,104,60
766,254,1,767,2,4259,20,20,20
767,254,1,768,5,4264,39,39,50
768,254,1,769,2,4266,26,8,20
769,254,1,770,3,4269,58,58,30
770,254,1,771,4,4273,40,14,40
771,254,1,772,4,4277,76,76,40
772,254,1,773,6,4283,83,22,60
773,254,1,774,3,4286,86,86,30
774,254,1,775,2,4288,19,19,20
775,254,1,776,7,4295,57,21,70
776,254,1,777,3,4298,68,68,30
777,254,1,778,5,4303,55,55,50
778,254,1,779,5,4308,53,53,50
779,254,1,780,2,4310,19,19,20
780,254,1,781,7,4317,79,79,70
781,254,1,782,3,4320,32,32,30
782,254,1,783,5,4325,54,54,50
783,254,1,784,4,4329,37,37,40
784,254,1,785,9,4338,91,29,90
785,254,1,786,9,4347,152,61,90
786,254,1,787,7,4354,169,64,70
787,254,1,788,8,4362,186,186,80
788,254,1,789,9,4371,84,84,90
789,254,1,790,6,4377,52,14,60
790,254,1,791,4,4381,78,78,40
791,254,1,792,6,4387,77,77,60
792,254,1,793,5,4392,52,52,50
793,254,1,794,5,4397,50,50,50
794,254,1,795,7,4404,66,66,70
795,254,1,796,3,4407,29,12,30
796,254,1,797,2,4409,35,35,20
797,254,1,798,3,4412,23,23,30
798,254,1,799,4,4416,40,40,40
799,254,1,800,9,4425,92,92,90
800,254,1,801,5,4430,62,26,50
801,254,1,802,3,4433,65,65,30
802,254,1,803,9,4442,97,97,90
803,254,1,804,2,4444,22,7,20
804,254,1,805,5,4449,72,72,50
805,254,1,806,9,4458,89,26,90
806,254,1,807,4,4462,102,102,40
807,254,1,808,2,4464,17,17,20
808,254,1,809,9,4473,113,113,90
809,254,1,810,4,4477,52,52,40
810,254,1,811,8,4485,81,81,80
811,254,1,812,4,4489,42,16,40
812,254,1,813,5,4494,71,71,50
813,254,1,814,3,4497,28,6,30
814,254,1,815,6,4503,97,28,60
815,254,1,816,4,4507,107,107,40
816,254,1,817,3,4510,35,10,30
817,254,1,818,8,4518,104,104,80
818,254,1,819,4,4522,37,17,40
819,254,1,820,2,4524,46,46,20
820,254,1,821,9,4533,87,87,90
821,254,1,822,5,4538,42,42,50
822,254,1,823,4,4542,46,13,40
823,254,1,824,5,4547,76,76,50
824,254,1,825,7,4554,77,77,70
825,254,1,826,4,4558,37,37,40
826,254,1,827,2,4560,27,27,20
827,254,1,828,3,4563,22,8,30
828,254,1,829,6,4569,71,71,60
829,254,1,830,9,4578,94,94,90
830,254,1,831,6,4584,69,69,60
831,254,1,832,2,4586,22,22,20
832,254,1,833,9,4595,98,98,90
833,254,1,834,2,4597,19,19,20
834,254,1,835,2,4599,23,8,20
835,254,1,836,2,4601,38,38,20
836,254,1,837,7,4608,72,72,70
837,254,1,838,9,4617,84,84,90
838,254,1,839,9,4626,85,32,90
839,254,1,840,8,4634,127,127,80
840,254,1,841,9,4643,89,89,90
841,254,1,842,6,4649,55,55,60
842,254,1,843,4,4653,44,44,40
843,254,1,844,3,4656,26,5,30
844,254,1,845,9,4665,106,106,90
845,254,1,846,3,4668,38,38,30
846,254,1,847,2,4670,14,14,20
847,254,1,848,2,4672,10,10,20
848,254,1,849,9,4681,93,35,90
849,254,1,850,2,4683,70,70,20
850,254,1,851,3,4686,31,31,30
851,254,1,852,7,4693,83,83,70
852,254,1,853,7,4700,56,21,70
853,254,1,854,6,4706,91,91,60
854,254,1,855,5,4711,63,63,50
855,254,1,856,6,4717,61,20,60
856,254,1,857,8,4725,130,130,80
857,254,1,858,5,4730,49,49,50
858,254,1,859,2,4732,16,4,20
859,254,1,860,4,4736,47,47,40
860,254,1,861,4,4740,42,42,40
861,254,1,862,7,4747,74,27,70
862,254,1,863,9,4756,139,139,90
863,254,1,864,3,4759,25,25,30
864,254,1,865,6,4765,54,54,60
865,254,1,866,3,4768,28,28,30
866,254,1,867,8,4776,77,30,80
867,254,1,868,4,4780,95,95,40
868,254,1,869,3,4783,29,29,30
869,254,1,870,9,4792,86,86,90
870,254,1,871,6,4798,60,60,60
871,254,1,872,5,4803,43,43,50
872,254,1,873,4,4807,38,16,40
873,254,1,874,9,4816,120,120,90
874,254,1,875,3,4819,29,29,30
875,254,1,876,5,4824,51,51,50
876,254,1,877,9,4833,94,34,90
877,254,1,878,6,4839,126,126,60
878,254,1,879,8,4847,79,25,80
879,254,1,880,2,4849,74,29,20
880,254,1,881,2,4851,68,68,20
881,254,1,882,3,4854,27,27,30
882,254,1,883,8,4862,72,72,80
883,254,1,884,8,4870,96,96,80
884,254,1,885,3,4873,31,31,30
885,254,1,886,2,4875,29,12,20
886,254,1,887,7,4882,77,77,70
887,254,1,888,4,4886,55,55,40
888,254,1,889,3,4889,29,15,30
889,254,1,890,2,4891,38,13,20
890,254,1,891,4,4895,73,27,40
891,254,1,892,9,4904,159,159,90
892,254,1,893,9,4913,89,89,90
893,254,1,894,7,4920,69,26,70
894,254,1,895,3,4923,72,21,30
895,254,1,896,2,4925,67,67,20
896,254,1,897,4,4929,42,17,40
897,254,1,898,6,4935,78,25,60
898,254,1,899,7,4942,126,126,70
899,254,1,900,7,4949,75,29,70
900,254,1,901,5,4954,100,100,50
901,254,1,902,4,4958,33,33,40
902,254,1,903,2,4960,21,21,20
903,254,1,904,8,4968,76,76,80
904,254,1,905,2,4970,21,21,20
905,254,1,906,2,4972,11,3,20
906,254,1,907,7,4979,68,68,70
907,254,1,908,2,4981,16,16,20
908,254,1,909,7,4988,59,22,70
909,254,1,910,7,4995,96,96,70
910,254,2,1,8,8,82,82,80
911,254,2,2,8,16,81,25,80
912,254,2,3,7,23,123,123,70
913,254,2,4,7,30,89,89,70
914,254,2,5,9,39,85,85,90
915,254,2,6,2,41,15,4,20
916,254,2,7,6,47,72,72,60
917,254,2,8,7,54,73,25,70
918,254,2,9,4,58,98,98,40
919,254,2,10,6,64,47,47,60
920,254,2,11,4,68,33,10,40
921,254,2,12,3,71,51,51,30
922,254,2,13,2,73,16,16,20
923,254,2,14,8,81,84,84,80
924,254,2,15,6,87,53,53,60
925,254,2,16,5,92,41,41,50
926,254,2,17,2,94,23,23,20
927,254,2,18,3,97,25,11,30
928,254,2,19,4,101,67,23,40
929,254,2,20,7,108,117,117,70
930,254,2,21,7,115,67,25,70
931,254,2,22,8,123,139,139,80
932,254,2,23,7,130,56,56,70
933,254,2,24,5,135,61,27,50
934,254,2,25,3,138,57,57,30
935,254,2,26,5,143,48,19,50
936,254,2,27,9,152,116,36,90
937,254,2,28,3,155,114,114,30
938,254,2,29,4,159,36,36,40
939,254,2,30,2,161,22,5,20
940,254,2,31,9,170,110,33,90
941,254,2,32,8,178,151,151,80
942,254,2,33,7,185,62,62,70
943,254,2,34,5,190,39,39,50
944,254,2,35,2,192,18,18,20
945,254,2,36,9,201,97,35,90
946,254,2,37,2,203,79,29,20
947,254,2,38,8,211,129,41,80
948,254,2,39,8,219,158,158,80
949,254,2,40,7,226,68,31,70
950,254,2,41,8,234,118,118,80
951,254,2,42,4,238,43,43,40
952,254,2,43,6,244,57,57,60
953,254,2,44,4,248,42,42,40
954,254,2,45,3,251,34,34,30
955,254,2,46,5,256,51,21,50
956,254,2,47,4,260,63,19,40
957,254,2,48,3,263,75,75,30
958,254,2,49,9,272,102,37,90
959,254,2,50,4,276,99,99,40
960,254,2,51,6,282,58,20,60
961,254,2,52,2,284,59,59,20
962,254,2,53,3,287,25,25,30
963,254,2,54,6,293,54,14,60
964,254,2,55,5,298,94,35,50
965,254,2,56,3,301,87,87,30
966,254,2,57,6,307,42,16,60
967,254,2,58,2,309,43,15,20
968,254,2,59,7,316,96,96,70
969,254,2,60,3,319,37,37,30
970,254,2,61,9,328,90,90,90
971,254,2,62,6,334,66,66,60
972,254,2,63,4,338,48,48,40
973,254,2,64,5,343,52,52,50
974,254,2,65,3,346,24,11,30
975,254,2,66,2,348,32,32,20
976,254,2,67,5,353,57,18,50
977,254,2,68,3,356,75,22,30
978,254,2,69,5,361,94,94,50
979,254,2,70,6,367,63,63,60
980,254,2,71,9,376,90,90,90
981,254,2,72,3,379,43,43,30
982,254,2,73,4,383,51,17,40
983,254,2,74,4,387,83,83,40
984,254,2,75,9,396,96,34,90
985,254,2,76,4,400,100,30,40
986,254,2,77,9,409,165,165,90
987,254,2,78,6,415,56,17,60
988,254,2,79,7,422,100,36,70
989,254,2,80,5,427,121,121,50
990,254,2,81,5,432,45,45,50
991,254,2,82,7,439,59,59,70
992,254,2,83,5,444,51,20,50
993,254,2,84,6,450,87,87,60
994,254,2,85,5,455,50,16,50
995,254,2,86,2,457,54,54,20
996,254,2,87,6,463,55,55,60
997,254,2,88,6,469,58,22,60
998,254,2,89,3,472,63,16,30
999,254,2,90,7,479,120,42,70
1000,254,2,91,7,486,133,133,70
1001,254,2,92,3,489,25,25,30
1002,254,2,93,2,491,17,17,20
1003,254,2,94,7,498,71,71,70
1004,254,2,95,3,501,29,29,30
1005,254,2,96,2,503,19,19,20
1006,254,2,97,6,509,75,75,60
1007,254,2,98,7,516,66,66,70
1008,254,2,99,3,519,24,24,30
1009,254,2,100,3,522,25,25,30
1010,254,2,101,6,528,54,23,60
1011,254,2,102,5,533,92,92,50
1012,254,2,103,4,537,30,30,40
1013,254,2,104,4,541,35,8,40
1014,254,2,105,5,546,83,83,50
1015,254,2,106,2,548,25,25,20
1016,254,2,107,8,556,81,32,80
1017,254,2,108,8,564,133,133,80
1018,254,2,109,4,568,47,47,40
1019,254,2,110,9,577,79,27,90
1020,254,2,111,2,579,72,32,20
1021,254,2,112,3,582,80,27,30
1022,254,2,113,2,584,73,73,20
1023,254,2,114,9,593,88,31,90
1024,254,2,115,3,596,87,87,30
1025,254,2,116,9,605,87,33,90
1026,254,2,117,3,608,87,87,30
1027,254,2,118,5,613,52,52,50
1028,254,2,119,8,621,86,86,80
1029,254,2,120,3,624,27,27,30
1030,254,2,121,4,628,27,27,40
1031,254,2,122,4,632,36,36,40
1032,254,2,123,5,637,50,18,50
1033,254,2,124,8,645,92,92,80
1034,254,2,125,7,652,66,66,70
1035,254,2,126,3,655,31,31,30
1036,254,2,127,8,663,70,70,80
1037,254,2,128,7,670,54,12,70
1038,254,2,129,2,672,64,64,20
1039,254,2,130,6,678,53,53,60
1040,254,2,131,7,685,81,81,70
1041,254,2,132,3,688,35,35,30
1042,254,2,133,5,693,44,44,50
1043,254,2,134,8,701,86,86,80
1044,254,2,135,2,703,20,20,20
1045,254,2,136,7,710,63,63,70
1046,254,2,137,6,716,48,15,60
1047,254,2,138,8,724,107,107,80
1048,254,2,139,3,727,30,30,30
1049,254,2,140,7,734,67,22,70
1050,254,2,141,4,738,88,34,40
1051,254,2,142,8,746,127,127,80
1052,254,2,143,3,749,36,36,30
1053,254,2,144,6,755,82,82,60
1054,254,2,145,2,757,17,17,20
1055,254,2,146,5,762,50,50,50
1056,254,2,147,5,767,46,19,50
1057,254,2,148,2,769,47,47,20
1058,254,2,149,2,771,17,17,20
1059,254,2,150,3,774,37,14,30
1060,254,2,151,7,781,107,107,70
1061,254,2,152,7,788,79,27,70
1062,254,2,153,2,790,62,62,20
1063,254,2,154,6,796,52,52,60
1064,254,2,155,7,803,59,21,70
1065,254,2,156,2,805,53,19,20
1066,254,2,157,8,813,110,35,80
1067,254,2,158,3,816,91,91,30
1068,254,2,159,6,822,72,72,60
1069,254,2,160,8,830,74,26,80
1070,254,2,161,8,838,132,132,80
1071,254,2,162,4,842,39,12,40
1072,254,2,163,5,847,81,81,50
1073,254,2,164,3,850,29,29,30
1074,254,2,165,4,854,29,29,40
1075,254,2,166,8,862,72,25,80
1076,254,2,167,8,870,120,120,80
1077,254,2,168,3,873,36,14,30
1078,254,2,169,6,879,96,96,60
1079,254,2,170,2,881,21,21,20
1080,254,2,171,8,889,77,25,80
1081,254,2,172,6,895,118,118,60
1082,254,2,173,6,901,50,50,60
1083,254,2,174,8,909,77,77,80
1084,254,2,175,2,911,20,20,20
1085,254,2,176,3,914,35,13,30
1086,254,2,177,4,918,65,65,40
1087,254,2,178,6,924,70,70,60
1088,254,2,179,7,931,69,23,70
1089,254,2,180,9,940,119,34,90
1090,254,2,181,6,946,149,48,60
1091,254,2,182,7,953,164,58,70
1092,254,2,183,4,957,150,150,40
1093,254,2,184,7,964,67,67,70
1094,254,2,185,4,968,40,40,40
1095,254,2,186,2,970,18,18,20
1096,254,2,187,7,977,75,75,70
1097,254,2,188,7,984,62,62,70
1098,254,2,189,4,988,43,43,40
1099,254,2,190,4,992,47,47,40
1100,254,2,191,2,994,21,21,20
1101,254,2,192,4,998,45,45,40
1102,254,2,193,3,1001,36,13,30
1103,254,2,194,8,1009,108,108,80
1104,254,2,195,6,1015,63,19,60
1105,254,2,196,9,1024,135,40,90
1106,254,2,197,9,1033,208,80,90
1107,254,2,198,5,1038,183,183,50
1108,254,2,199,5,1043,47,19,50
1109,254,2,200,6,1049,92,92,60
1110,254,2,201,2,1051,23,23,20
1111,254,2,202,4,1055,32,32,40
1112,254,2,203,3,1058,25,25,30
1113,254,2,204,4,1062,42,42,40
1114,254,2,205,2,1064,26,26,20
1115,254,2,206,8,1072,86,86,80
1116,254,2,207,8,1080,93,93,80
1117,254,2,208,2,1082,12,12,20
1118,254,2,209,7,1089,80,80,70
1119,254,2,210,3,1092,40,40,30
1120,254,2,211,3,1095,22,22,30
1121,254,2,212,7,1102,60,60,70
1122,254,2,213,5,1107,41,41,50
1123,254,2,214,7,1114,69,69,70
1124,254,2,215,2,1116,19,19,20
1125,254,2,216,3,1119,33,33,30
1126,254,2,217,8,1127,82,28,80
1127,254,2,218,5,1132,122,122,50
1128,254,2,219,8,1140,86,86,80
1129,254,2,220,9,1149,86,86,90
1130,254,2,221,5,1154,52,52,50
1131,254,2,222,8,1162,81,81,80
1132,254,2,223,4,1166,39,39,40
1133,254,2,224,7,1173,78,78,70
1134,254,2,225,3,1176,31,14,30
1135,254,2,226,7,1183,80,80,70
1136,254,2,227,7,1190,71,71,70
1137,254,2,228,2,1192,12,12,20
1138,254,2,229,7,1199,90,90,70
1139,254,2,230,8,1207,90,90,80
1140,254,2,231,3,1210,35,35,30
1141,254,2,232,3,1213,25,25,30
1142,254,2,233,8,1221,88,88,80
1143,254,2,234,6,1227,63,63,60
1144,254,2,235,8,1235,70,70,80
1145,254,2,236,8,1243,78,31,80
1146,254,2,237,4,1247,90,90,40
1147,254,2,238,2,1249,28,28,20
1148,254,2,239,5,1254,56,56,50
1149,254,2,240,9,1263,94,94,90
1150,254,2,241,6,1269,59,59,60
1151,254,2,242,3,1272,25,25,30
1152,254,2,243,9,1281,105,105,90
1153,254,2,244,9,1290,80,80,90
1154,254,2,245,6,1296,57,57,60
1155,254,2,246,2,1298,25,25,20
1156,254,2,247,6,1304,60,18,60
1157,254,2,248,4,1308,88,88,40
1158,254,2,249,7,1315,70,70,70
1159,254,2,250,7,1322,75,30,70
1160,254,2,251,8,1330,103,103,80
1161,254,2,252,7,1337,79,79,70
1162,254,2,253,4,1341,46,46,40
1163,254,2,254,7,1348,95,37,70
1164,254,2,255,5,1353,106,35,50
1165,254,2,256,8,1361,174,57,80
1166,254,2,257,2,1363,145,44,20
1167,254,2,258,8,1371,186,69,80
1168,254,2,259,4,1375,151,151,40
1169,254,2,260,8,1383,85,85,80
1170,254,2,261,2,1385,20,20,20
1171,254,2,262,6,1391,64,26,60
1172,254,2,263,6,1397,93,93,60
1173,254,2,264,7,1404,67,26,70
1174,254,2,265,6,1410,94,94,60
1175,254,2,266,8,1418,77,26,80
1176,254,2,267,6,1424,106,35,60
1177,254,2,268,3,1427,114,29,30
1178,254,2,269,3,1430,123,42,30
1179,254,2,270,8,1438,168,168,80
1180,254,2,271,8,1446,80,80,80
1181,254,2,272,5,1451,58,58,50
1182,254,2,273,3,1454,32,32,30
1183,254,2,274,7,1461,74,74,70
1184,254,2,275,9,1470,93,93,90
1185,254,2,276,8,1478,77,23,80
1186,254,2,277,7,1485,118,118,70
1187,254,2,278,7,1492,64,64,70
1188,254,2,279,6,1498,61,61,60
1189,254,2,280,2,1500,22,22,20
1190,254,2,281,6,1506,63,63,60
1191,254,2,282,6,1512,58,58,60
1192,254,2,283,3,1515,27,27,30
1193,254,2,284,2,1517,24,24,20
1194,254,2,285,5,1522,59,21,50
1195,254,2,286,2,1524,57,57,20
1196,254,2,287,4,1528,35,35,40
1197,254,2,288,4,1532,42,13,40
1198,254,2,289,5,1537,65,65,50
1199,254,2,290,4,1541,32,13,40
1200,254,2,291,3,1544,58,58,30
1201,254,2,292,5,1549,57,57,50
1202,254,2,293,2,1551,17,17,20
1203,254,2,294,9,1560,95,95,90
1204,254,2,295,4,1564,38,38,40
1205,254,2,296,4,1568,38,12,40
1206,254,2,297,9,1577,123,123,90
1207,254,2,298,5,1582,46,20,50
1208,254,2,299,7,1589,105,105,70
1209,254,2,300,4,1593,44,44,40
1210,254,2,301,9,1602,94,94,90
1211,254,2,302,5,1607,50,50,50
1212,254,2,303,9,1616,93,93,90
1213,254,2,304,8,1624,86,29,80
1214,254,2,305,7,1631,120,120,70
1215,254,2,306,8,1639,76,76,80
1216,254,2,307,4,1643,27,27,40
1217,254,2,308,7,1650,60,24,70
1218,254,2,309,6,1656,111,41,60
1219,254,2,310,3,1659,101,101,30
1220,254,2,311,4,1663,33,33,40
1221,254,2,312,2,1665,18,18,20
1222,254,2,313,6,1671,65,65,60
1223,254,2,314,8,1679,78,78,80
1224,254,2,315,6,1685,67,25,60
1225,254,2,316,5,1690,91,91,50
1226,254,2,317,8,1698,74,28,80
1227,254,2,318,7,1705,104,104,70
1228,254,2,319,4,1709,44,44,40
1229,254,2,320,8,1717,93,93,80
1230,254,2,321,4,1721,36,36,40
1231,254,2,322,8,1729,81,26,80
1232,254,2,323,3,1732,85,85,30
1233,254,2,324,7,1739,60,60,70
1234,254,2,325,2,1741,22,22,20
1235,254,2,326,7,1748,58,20,70
1236,254,2,327,6,1754,92,28,60
1237,254,2,328,5,1759,110,110,50
1238,254,2,329,7,1766,59,18,70
1239,254,2,330,6,1772,93,93,60
1240,254,2,331,8,1780,61,61,80
1241,254,2,332,7,1787,62,62,70
1242,254,2,333,3,1790,33,33,30
1243,254,2,334,4,1794,41,41,40
1244,254,2,335,3,1797,30,11,30
1245,254,2,336,5,1802,56,56,50
1246,254,2,337,2,1804,15,5,20
1247,254,2,338,4,1808,45,45,40
1248,254,2,339,3,1811,31,31,30
1249,254,2,340,6,1817,61,61,60
1250,254,2,341,8,1825,78,31,80
1251,254,2,342,9,1834,141,42,90
1252,254,2,343,9,1843,197,70,90
1253,254,2,344,9,1852,214,214,90
1254,254,2,345,6,1858,50,17,60
1255,254,2,346,6,1864,94,94,60
1256,254,2,347,3,1867,25,10,30
1257,254,2,348,7,1874,81,81,70
1258,254,2,349,6,1880,65,65,60
1259,254,2,350,3,1883,32,12,30
1260,254,2,351,8,1891,109,109,80
1261,254,2,352,7,1898,73,73,70
1262,254,2,353,9,1907,88,88,90
1263,254,2,354,2,1909,19,19,20
1264,254,2,355,5,1914,51,51,50
1265,254,2,356,3,1917,29,10,30
1266,254,2,357,4,1921,65,21,40
1267,254,2,358,8,1929,136,136,80
1268,254,2,359,7,1936,80,80,70
1269,254,2,360,4,1940,38,12,40
1270,254,2,361,9,1949,111,111,90
1271,254,2,362,3,1952,29,10,30
1272,254,2,363,7,1959,78,78,70
1273,254,2,364,4,1963,39,39,40
1274,254,2,365,5,1968,41,41,50
1275,254,2,366,5,1973,52,18,50
1276,254,2,367,2,1975,47,47,20
1277,254,2,368,6,1981,52,21,60
1278,254,2,369,2,1983,53,21,20
1279,254,2,370,4,1987,76,25,40
1280,254,2,371,6,1993,124,124,60
1281,254,2,372,5,1998,49,49,50
1282,254,2,373,8,2006,71,71,80
1283,254,2,374,8,2014,73,73,80
1284,254,2,375,5,2019,55,55,50
1285,254,2,376,4,2023,38,16,40
1286,254,2,377,6,2029,80,80,60
1287,254,2,378,3,2032,28,6,30
1288,254,2,379,5,2037,72,27,50
1289,254,2,380,3,2040,78,78,30
1290,254,2,381,8,2048,81,81,80
1291,254,2,382,2,2050,20,20,20
1292,254,2,383,6,2056,79,79,60
1293,254,2,384,4,2060,27,13,40
1294,254,2,385,5,2065,59,59,50
1295,254,2,386,8,2073,71,23,80
1296,254,2,387,9,2082,151,151,90
1297,254,2,388,9,2091,95,95,90
1298,254,2,389,3,2094,35,35,30
1299,254,2,390,5,2099,65,65,50
1300,254,2,391,9,2108,79,79,90
1301,254,2,392,6,2114,44,21,60
1302,254,2,393,5,2119,66,26,50
1303,254,2,394,4,2123,65,65,40
1304,254,2,395,7,2130,60,23,70
1305,254,2,396,8,2138,114,114,80
1306,254,2,397,5,2143,56,20,50
1307,254,2,398,5,2148,84,33,50
1308,254,2,399,2,2150,69,69,20
1309,254,2,400,8,2158,80,27,80
1310,254,2,401,6,2164,115,115,60
1311,254,2,402,6,2170,49,49,60
1312,254,2,403,2,2172,18,18,20
1313,254,2,404,5,2177,51,51,50
1314,254,2,405,8,2185,71,71,80
1315,254,2,406,4,2189,42,12,40
1316,254,2,407,2,2191,48,48,20
1317,254,2,408,2,2193,33,11,20
1318,254,2,409,4,2197,61,16,40
1319,254,2,410,3,2200,77,77,30
1320,254,2,411,6,2206,52,52,60
1321,254,2,412,8,2214,76,76,80
1322,254,2,413,6,2220,69,22,60
1323,254,2,414,3,2223,72,72,30
1324,254,2,415,8,2231,73,25,80
1325,254,2,416,6,2237,113,113,60
1326,254,2,417,9,2246,84,84,90
1327,254,2,418,4,2250,37,37,40
1328,254,2,419,6,2256,53,18,60
1329,254,2,420,8,2264,115,115,80
1330,254,2,421,7,2271,63,63,70
1331,254,2,422,7,2278,78,36,70
1332,254,2,423,8,2286,121,121,80
1333,254,2,424,2,2288,19,19,20
1334,254,2,425,8,2296,87,87,80
1335,254,2,426,4,2300,39,9,40
1336,254,2,427,5,2305,74,74,50
1337,254,2,428,7,2312,73,73,70
1338,254,2,429,4,2316,42,42,40
1339,254,2,430,7,2323,74,74,70
1340,254,2,431,9,2332,94,94,90
1341,254,2,432,5,2337,45,20,50
1342,254,2,433,8,2345,101,101,80
1343,254,2,434,7,2352,66,66,70
1344,254,2,435,3,2355,24,5,30
1345,254,2,436,4,2359,66,66,40
1346,254,2,437,7,2366,71,71,70
1347,254,2,438,8,2374,106,106,80
1348,254,2,439,9,2383,87,37,90
1349,254,2,440,9,2392,160,160,90
1350,254,2,441,9,2401,99,99,90
1351,254,2,442,6,2407,52,52,60
1352,254,2,443,4,2411,36,36,40
1353,254,2,444,2,2413,15,15,20
1354,254,2,445,4,2417,42,16,40
1355,254,2,446,7,2424,99,37,70
1356,254,2,447,8,2432,147,147,80
1357,254,2,448,9,2441,74,74,90
1358,254,2,449,4,2445,48,19,40
1359,254,2,450,9,2454,132,132,90
1360,254,2,451,3,2457,38,38,30
1361,254,2,452,9,2466,105,105,90
1362,254,2,453,3,2469,32,32,30
1363,254,2,454,5,2474,43,43,50
1364,254,2,455,6,2480,74,74,60
1365,254,2,456,8,2488,82,82,80
1366,254,2,457,5,2493,53,53,50
1367,254,2,458,5,2498,62,62,50
1368,254,2,459,9,2507,68,21,90
1369,254,2,460,5,2512,109,36,50
1370,254,2,461,5,2517,133,133,50
1371,254,2,462,6,2523,44,13,60
1372,254,2,463,3,2526,54,54,30
1373,254,2,464,8,2534,103,103,80
1374,254,2,465,4,2538,37,37,40
1375,254,2,466,6,2544,68,25,60
1376,254,2,467,2,2546,55,55,20
1377,254,2,468,8,2554,65,65,80
1378,254,2,469,7,2561,73,73,70
1379,254,2,470,9,2570,79,79,90
1380,254,2,471,2,2572,22,22,20
1381,254,2,472,2,2574,22,9,20
1382,254,2,473,2,2576,31,31,20
1383,254,2,474,7,2583,68,27,70
1384,254,2,475,3,2586,67,67,30
1385,254,2,476,4,2590,37,37,40
1386,254,2,477,3,2593,21,21,30
1387,254,2,478,7,2600,68,24,70
1388,254,2,479,9,2609,127,127,90
1389,254,2,480,8,2617,76,76,80
1390,254,2,481,6,2623,54,19,60
1391,254,2,482,4,2627,76,76,40
1392,254,2,483,4,2631,31,31,40
1393,254,2,484,9,2640,97,97,90
1394,254,2,485,8,2648,71,71,80
1395,254,2,486,6,2654,48,20,60
1396,254,2,487,9,2663,131,131,90
1397,254,2,488,7,2670,66,18,70
1398,254,2,489,8,2678,128,128,80
1399,254,2,490,3,2681,33,33,30
1400,254,2,491,5,2686,54,24,50
1401,254,2,492,3,2689,62,18,30
1402,254,2,493,6,2695,110,110,60
1403,254,2,494,5,2700,54,54,50
1404,254,2,495,8,2708,67,26,80
1405,254,2,496,2,2710,64,64,20
1406,254,2,497,8,2718,65,65,80
1407,254,2,498,8,2726,79,79,80
1408,254,2,499,4,2730,33,12,40
1409,254,2,500,8,2738,103,103,80
1410,254,2,501,9,2747,79,23,90
1411,254,2,502,4,2751,104,37,40
1412,254,2,503,6,2757,139,139,60
1413,254,2,504,2,2759,16,3,20
1414,254,2,505,9,2768,84,34,90
1415,254,2,506,7,2775,120,120,70
1416,254,2,507,2,2777,16,16,20
1417,254,2,508,2,2779,20,20,20
1418,254,2,509,2,2781,18,18,20
1419,254,2,510,4,2785,34,34,40
1420,254,2,511,9,2794,99,27,90
1421,254,2,512,5,2799,117,117,50
1422,254,2,513,4,2803,52,52,40
1423,254,2,514,7,2810,78,78,70
1424,254,2,515,7,2817,76,76,70
1425,254,2,516,8,2825,82,82,80
1426,254,2,517,2,2827,33,33,20
1427,254,2,518,3,2830,33,33,30
1428,254,2,519,4,2834,36,36,40
1429,254,2,520,5,2839,52,52,50
1430,254,2,521,8,2847,82,82,80
1431,254,2,522,8,2855,73,25,80
1432,254,2,523,7,2862,123,123,70
1433,254,2,524,8,2870,84,84,80
1434,254,2,525,7,2877,59,59,70
1435,254,2,526,2,2879,16,16,20
1436,254,2,527,6,2885,66,24,60
1437,254,2,528,2,2887,68,68,20
1438,254,2,529,5,2892,48,48,50
1439,254,2,530,4,2896,36,36,40
1440,254,2,531,6,2902,48,48,60
1441,254,2,532,7,2909,73,73,70
1442,254,2,533,4,2913,37,37,40
1443,254,2,534,3,2916,30,30,30
1444,254,2,535,8,2924,77,77,80
1445,254,2,536,8,2932,84,84,80
1446,254,2,537,2,2934,21,4,20
1447,254,2,538,4,2938,51,20,40
1448,254,2,539,7,2945,113,113,70
1449,254,2,540,8,2953,60,60,80
1450,254,2,541,6,2959,66,66,60
1451,254,2,542,8,2967,88,88,80
1452,254,2,543,6,2973,50,50,60
1453,254,2,544,2,2975,18,18,20
1454,254,2,545,4,2979,44,44,40
1455,254,2,546,7,2986,79,30,70
1456,254,2,547,5,2991,93,25,50
1457,254,2,548,6,2997,140,140,60
1458,254,2,549,6,3003,64,64,60
1459,254,2,550,4,3007,39,39,40
1460,254,2,551,7,3014,86,86,70
1461,254,2,552,8,3022,86,33,80
1462,254,2,553,6,3028,118,118,60
1463,254,2,554,2,3030,25,5,20
1464,254,2,555,8,3038,102,102,80
1465,254,2,556,7,3045,80,80,70
1466,254,2,557,4,3049,46,46,40
1467,254,2,558,5,3054,50,17,50
1468,254,2,559,5,3059,76,76,50
1469,254,2,560,2,3061,16,16,20
1470,254,2,561,5,3066,47,47,50
1471,254,2,562,7,3073,72,24,70
1472,254,2,563,2,3075,70,30,20
1473,254,2,564,3,3078,58,58,30
1474,254,2,565,8,3086,71,71,80
1475,254,2,566,3,3089,26,26,30
1476,254,2,567,5,3094,63,63,50
1477,254,2,568,9,3103,98,38,90
1478,254,2,569,2,3105,78,29,20
1479,254,2,570,7,3112,119,119,70
1480,254,2,571,4,3116,29,29,40
1481,254,2,572,8,3124,85,85,80
1482,254,2,573,3,3127,29,29,30
1483,254,2,574,6,3133,58,20,60
1484,254,2,575,8,3141,121,38,80
1485,254,2,576,3,3144,122,122,30
1486,254,2,577,5,3149,42,42,50
1487,254,2,578,5,3154,49,21,50
1488,254,2,579,4,3158,80,29,40
1489,254,2,580,6,3164,111,43,60
1490,254,2,581,7,3171,139,139,70
1491,254,2,582,8,3179,84,84,80
1492,254,2,583,6,3185,51,51,60
1493,254,2,584,4,3189,29,29,40
1494,254,2,585,8,3197,78,78,80
1495,254,2,586,5,3202,46,46,50
1496,254,2,587,7,3209,74,74,70
1497,254,2,588,6,3215,42,42,60
1498,254,2,589,2,3217,18,18,20
1499,254,2,590,4,3221,35,35,40
1500,254,2,591,7,3228,79,36,70
1501,254,2,592,6,3234,118,118,60
1502,254,2,593,3,3237,18,18,30
1503,254,2,594,8,3245,88,30,80
1504,254,2,595,3,3248,88,34,30
1505,254,2,596,7,3255,148,60,70
1506,254,2,597,3,3258,110,35,30
1507,254,2,598,2,3260,101,101,20
1508,254,2,599,5,3265,45,12,50
1509,254,2,600,7,3272,105,105,70
1510,254,2,601,9,3281,81,81,90
1511,254,2,602,9,3290,87,32,90
1512,254,2,603,7,3297,113,113,70
1513,254,2,604,4,3301,32,12,40
1514,254,2,605,8,3309,99,99,80
1515,254,2,606,7,3316,75,75,70
1516,254,2,607,8,3324,83,83,80
1517,254,2,608,9,3333,107,30,90
1518,254,2,609,8,3341,172,172,80
1519,254,2,610,2,3343,21,21,20
1520,254,2,611,8,3351,94,94,80
1521,254,2,612,9,3360,93,93,90
1522,254,2,613,8,3368,88,88,80
1523,254,2,614,2,3370,23,23,20
1524,254,2,615,2,3372,22,22,20
1525,254,2,616,8,3380,82,82,80
1526,254,2,617,4,3384,42,12,40
1527,254,2,618,7,3391,98,98,70
1528,254,2,619,2,3393,20,20,20
1529,254,2,620,5,3398,50,19,50
1530,254,2,621,9,3407,139,139,90
1531,254,2,622,8,3415,78,26,80
1532,254,2,623,9,3424,129,129,90
1533,254,2,624,2,3426,19,19,20
1534,254,2,625,7,3433,89,31,70
1535,254,2,626,3,3436,91,91,30
1536,254,2,627,5,3441,54,54,50
1537,254,2,628,8,3449,84,84,80
1538,254,2,629,7,3456,79,79,70
1539,254,2,630,5,3461,49,16,50
1540,254,2,631,6,3467,78,78,60
1541,254,2,632,7,3474,75,75,70
1542,254,2,633,5,3479,37,37,50
1543,254,2,634,4,3483,38,13,40
1544,254,2,635,9,3492,119,119,90
1545,254,2,636,9,3501,88,36,90
1546,254,2,637,4,3505,94,33,40
1547,254,2,638,2,3507,76,76,20
1548,254,2,639,8,3515,86,23,80
1549,254,2,640,6,3521,126,126,60
1550,254,2,641,4,3525,38,38,40
1551,254,2,642,9,3534,77,77,90
1552,254,2,643,9,3543,95,95,90
1553,254,2,644,8,3551,70,70,80
1554,254,2,645,3,3554,31,31,30
1555,254,2,646,6,3560,65,27,60
1556,254,2,647,6,3566,101,101,60
1557,254,2,648,8,3574,77,77,80
1558,254,2,649,7,3581,73,73,70
1559,254,2,650,8,3589,80,35,80
1560,254,2,651,9,3598,140,42,90
1561,254,2,652,3,3601,126,40,30
1562,254,2,653,2,3603,108,108,20
1563,254,2,654,5,3608,37,37,50
1564,254,2,655,9,3617,87,37,90
1565,254,2,656,6,3623,118,44,60
1566,254,2,657,7,3630,124,124,70
1567,254,2,658,2,3632,16,16,20
1568,254,2,659,9,3641,84,84,90
1569,254,2,660,7,3648,67,23,70
1570,254,2,661,3,3651,77,20,30
1571,254,2,662,8,3659,141,48,80
1572,254,2,663,9,3668,181,181,90
1573,254,2,664,5,3673,48,48,50
1574,254,2,665,4,3677,43,16,40
1575,254,2,666,7,3684,97,97,70
1576,254,2,667,6,3690,64,64,60
1577,254,2,668,6,3696,58,58,60
1578,254,2,669,9,3705,88,88,90
1579,254,2,670,7,3712,66,66,70
1580,254,2,671,9,3721,109,109,90
1581,254,2,672,2,3723,19,19,20
1582,254,2,673,5,3728,52,52,50
1583,254,2,674,7,3735,79,79,70
1584,254,2,675,6,3741,60,60,60
1585,254,2,676,8,3749,71,20,80
1586,254,2,677,5,3754,94,94,50
1587,254,2,678,2,3756,14,14,20
1588,254,2,679,3,3759,32,32,30
1589,254,2,680,8,3767,75,75,80
1590,254,2,681,6,3773,45,45,60
1591,254,2,682,6,3779,60,60,60
1592,254,2,683,6,3785,74,74,60
1593,254,2,684,7,3792,67,67,70
1594,254,2,685,7,3799,81,81,70
1595,254,2,686,7,3806,53,53,70
1596,254,2,687,3,3809,31,9,30
1597,254,2,688,4,3813,70,70,40
1598,254,2,689,6,3819,75,75,60
1599,254,2,690,7,3826,84,84,70
1600,254,2,691,4,3830,35,14,40
1601,254,2,692,5,3835,83,29,50
1602,254,2,693,7,3842,121,121,70
1603,254,2,694,2,3844,18,18,20
1604,254,2,695,9,3853,89,38,90
1605,254,2,696,7,3860,121,121,70
1606,254,2,697,4,3864,40,10,40
1607,254,2,698,3,3867,54,54,30
1608,254,2,699,8,3875,78,78,80
1609,254,2,700,2,3877,14,14,20
1610,254,2,701,2,3879,27,11,20
1611,254,2,702,8,3887,90,31,80
1612,254,2,703,4,3891,96,96,40
1613,254,2,704,4,3895,38,38,40
1614,254,2,705,7,3902,77,77,70
1615,254,2,706,7,3909,71,25,70
1616,254,2,707,8,3917,143,143,80
1617,254,2,708,8,3925,73,73,80
1618,254,2,709,3,3928,23,7,30
1619,254,2,710,4,3932,58,58,40
1620,254,2,711,8,3940,100,100,80
1621,254,2,712,7,3947,76,76,70
1622,254,2,713,6,3953,72,72,60
1623,254,2,714,6,3959,49,49,60
1624,254,2,715,7,3966,61,61,70
1625,254,2,716,8,3974,77,29,80
1626,254,2,717,9,3983,134,134,90
1627,254,2,718,8,3991,55,55,80
1628,254,2,719,2,3993,16,6,20
1629,254,2,720,7,4000,76,24,70
1630,254,2,721,8,4008,130,130,80
1631,254,2,722,9,4017,76,30,90
1632,254,2,723,8,4025,107,107,80
1633,254,2,724,5,4030,53,53,50
1634,254,2,725,9,4039,82,82,90
1635,254,2,726,2,4041,16,16,20
1636,254,2,727,8,4049,67,26,80
1637,254,2,728,5,4054,90,90,50
1638,254,2,729,7,4061,59,20,70
1639,254,2,730,8,4069,121,39,80
1640,254,2,731,8,4077,175,175,80
1641,254,2,732,2,4079,9,9,20
1642,254,2,733,4,4083,37,37,40
1643,254,2,734,6,4089,69,69,60
1644,254,2,735,5,4094,52,52,50
1645,254,2,736,2,4096,18,18,20
1646,254,2,737,9,4105,76,26,90
1647,254,2,738,5,4110,108,108,50
1648,254,2,739,8,4118,77,77,80
1649,254,2,740,3,4121,24,24,30
1650,254,2,741,3,4124,27,6,30
1651,254,2,742,9,4133,129,129,90
1652,254,2,743,2,4135,16,16,20
1653,254,2,744,2,4137,19,19,20
1654,254,2,745,5,4142,67,67,50
1655,254,2,746,5,4147,47,47,50
1656,254,2,747,4,4151,48,48,40
1657,254,2,748,3,4154,28,28,30
1658,254,2,749,5,4159,54,54,50
1659,254,2,750,9,4168,104,104,90
1660,254,2,751,4,4172,27,27,40
1661,254,2,752,8,4180,70,22,80
1662,254,2,753,3,4183,77,29,30
1663,254,2,754,4,4187,86,86,40
1664,254,2,755,6,4193,71,71,60
1665,254,2,756,9,4202,88,88,90
1666,254,2,757,5,4207,40,40,50
1667,254,2,758,7,4214,77,24,70
1668,254,2,759,5,4219,92,92,50
1669,254,2,760,2,4221,16,16,20
1670,254,2,761,9,4230,98,98,90
1671,254,2,762,9,4239,95,95,90
1672,254,2,763,7,4246,78,78,70
1673,254,2,764,9,4255,77,77,90
1674,254,2,765,6,4261,53,53,60
1675,254,2,766,7,4268,60,60,70
1676,254,2,767,7,4275,63,63,70
1677,254,2,768,9,4284,82,26,90
1678,254,2,769,8,4292,117,29,80
1679,254,2,770,8,4300,183,183,80
1680,254,2,771,6,4306,70,22,60
1681,254,2,772,9,4315,135,44,90
1682,254,2,773,4,4319,130,53,40
1683,254,2,774,2,4321,92,37,20
1684,254,2,775,3,4324,75,75,30
1685,254,2,776,6,4330,61,25,60
1686,254,2,777,6,4336,103,103,60
1687,254,2,778,7,4343,55,18,70
1688,254,2,779,9,4352,113,39,90
1689,254,2,780,9,4361,157,157,90
1690,254,2,781,3,4364,25,25,30
1691,254,2,782,9,4373,96,96,90
1692,254,2,783,4,4377,45,45,40
1693,254,2,784,7,4384,79,31,70
1694,254,2,785,3,4387,77,77,30
1695,254,2,786,9,4396,93,34,90
1696,254,2,787,5,4401,98,40,50
1697,254,2,788,5,4406,115,115,50
1698,254,2,789,6,4412,64,64,60
1699,254,2,790,9,4421,98,35,90
1700,254,2,791,3,4424,99,99,30
1701,254,2,792,8,4432,88,25,80
1702,254,2,793,3,4435,95,31,30
1703,254,2,794,7,4442,145,145,70
1704,254,2,795,8,4450,90,90,80
1705,254,2,796,3,4453,41,6,30
1706,254,2,797,2,4455,53,53,20
1707,254,2,798,7,4462,70,70,70
1708,254,2,799,3,4465,32,12,30
1709,254,2,800,8,4473,87,31,80
1710,254,2,801,4,4477,94,94,40
1711,254,2,802,6,4483,62,25,60
1712,254,2,803,4,4487,69,69,40
1713,254,2,804,2,4489,28,28,20
1714,254,2,805,9,4498,107,107,90
1715,254,2,806,5,4503,58,58,50
1716,254,2,807,8,4511,83,83,80
1717,254,2,808,6,4517,53,53,60
1718,254,2,809,7,4524,65,65,70
1719,254,2,810,9,4533,95,95,90
1720,254,2,811,7,4540,73,73,70
1721,254,2,812,6,4546,73,73,60
1722,254,2,813,3,4549,34,11,30
1723,254,2,814,4,4553,63,63,40
1724,254,2,815,5,4558,44,44,50
1725,254,2,816,2,4560,15,15,20
1726,254,2,817,7,4567,70,70,70
1727,254,2,818,3,4570,26,26,30
1728,254,2,819,2,4572,18,18,20
1729,254,2,820,2,4574,24,24,20
1730,254,2,821,6,4580,44,44,60
1731,254,2,822,6,4586,51,24,60
1732,254,2,823,9,4595,131,59,90
1733,254,2,824,6,4601,132,132,60
1734,254,2,825,7,4608,65,65,70
1735,254,2,826,4,4612,45,17,40
1736,254,2,827,2,4614,52,17,20
1737,254,2,828,3,4617,61,61,30
1738,254,2,829,9,4626,95,35,90
1739,254,2,830,9,4635,150,150,90
1740,254,2,831,4,4639,40,15,40
1741,254,2,832,5,4644,83,23,50
1742,254,2,833,6,4650,115,41,60
1743,254,2,834,2,4652,84,30,20
1744,254,2,835,5,4657,101,101,50
1745,254,2,836,6,4663,67,19,60
1746,254,2,837,3,4666,81,81,30
1747,254,2,838,3,4669,29,7,30
1748,254,2,839,7,4676,87,31,70
1749,254,2,840,7,4683,137,137,70
1750,254,2,841,8,4691,87,87,80
1751,254,2,842,4,4695,46,46,40
1752,254,2,843,7,4702,82,82,70
1753,254,2,844,7,4709,83,83,70
1754,254,2,845,9,4718,116,116,90
1755,254,2,846,5,4723,52,16,50
1756,254,2,847,8,4731,118,118,80
1757,254,2,848,3,4734,35,35,30
1758,254,2,849,2,4736,26,9,20
1759,254,2,850,5,4741,67,20,50
1760,254,2,851,4,4745,86,86,40
1761,254,2,852,7,4752,70,70,70
1762,254,2,853,7,4759,68,68,70
1763,254,2,854,6,4765,51,19,60
1764,254,2,855,7,4772,102,102,70
1765,254,2,856,8,4780,82,24,80
1766,254,2,857,2,4782,78,78,20
1767,254,2,858,8,4790,89,89,80
1768,254,2,859,9,4799,86,34,90
1769,254,2,860,7,4806,126,126,70
1770,254,2,861,8,4814,89,35,80
1771,254,2,862,2,4816,71,23,20
1772,254,2,863,8,4824,125,51,80
1773,254,2,864,6,4830,136,47,60
1774,254,2,865,3,4833,111,32,30
1775,254,2,866,5,4838,140,140,50
1776,254,2,867,3,4841,34,34,30
1777,254,2,868,7,4848,75,75,70
1778,254,2,869,5,4853,47,16,50
1779,254,2,870,9,4862,144,144,90
1780,254,2,871,7,4869,74,74,70
1781,254,2,872,4,4873,31,31,40
1782,254,2,873,7,4880,75,75,70
1783,254,2,874,5,4885,37,37,50
1784,254,2,875,6,4891,60,60,60
1785,254,2,876,8,4899,83,22,80
1786,254,2,877,5,4904,116,42,50
1787,254,2,878,7,4911,137,137,70
1788,254,2,879,5,4916,57,21,50
1789,254,2,880,3,4919,68,68,30
1790,254,2,881,2,4921,20,20,20
1791,254,2,882,7,4928,50,50,70
1792,254,2,883,8,4936,86,86,80
1793,254,2,884,3,4939,24,24,30
1794,254,2,885,3,4942,25,25,30
1795,254,2,886,8,4950,84,84,80
1796,254,2,887,5,4955,50,17,50
1797,254,2,888,7,4962,98,98,70
1798,254,2,889,8,4970,83,83,80
1799,254,2,890,2,4972,15,15,20
1800,254,2,891,4,4976,33,33,40
1801,254,2,892,3,4979,31,31,30
1802,254,2,893,2,4981,22,22,20
1803,254,2,894,4,4985,41,41,40
1804,254,2,895,5,4990,53,19,50
1805,254,2,896,2,4992,61,61,20
1806,254,2,897,7,4999,55,15,70
1807,254,3,1,6,6,59,59,60
1808,254,3,2,2,8,22,6,20
1809,254,3,3,2,10,32,32,20
1810,254,3,4,7,17,62,24,70
1811,254,3,5,6,23,99,99,60
1812,254,3,6,5,28,61,61,50
1813,254,3,7,8,36,74,74,80
1814,254,3,8,2,38,17,17,20
1815,254,3,9,9,47,98,98,90
1816,254,3,10,9,56,88,88,90
1817,254,3,11,3,59,23,23,30
1818,254,3,12,7,66,79,79,70
1819,254,3,13,5,71,63,63,50
1820,254,3,14,7,78,60,60,70
1821,254,3,15,3,81,31,31,30
1822,254,3,16,6,87,85,85,60
1823,254,3,17,2,89,19,19,20
1824,254,3,18,3,92,35,7,30
1825,254,3,19,8,100,110,110,80
1826,254,3,20,7,107,71,71,70
1827,254,3,21,6,113,62,62,60
1828,254,3,22,6,119,67,67,60
1829,254,3,23,7,126,81,81,70
1830,254,3,24,7,133,72,72,70
1831,254,3,25,3,136,36,7,30
1832,254,3,26,8,144,128,128,80
1833,254,3,27,4,148,33,33,40
1834,254,3,28,6,154,63,63,60
1835,254,3,29,5,159,51,51,50
1836,254,3,30,5,164,51,51,50
1837,254,3,31,8,172,99,99,80
1838,254,3,32,8,180,92,92,80
1839,254,3,33,2,182,17,17,20
1840,254,3,34,2,184,12,12,20
1841,254,3,35,6,190,52,52,60
1842,254,3,36,3,193,25,25,30
1843,254,3,37,2,195,15,15,20
1844,254,3,38,8,203,78,78,80
1845,254,3,39,2,205,20,20,20
1846,254,3,40,8,213,74,26,80
1847,254,3,41,8,221,144,144,80
1848,254,3,42,5,226,52,17,50
1849,254,3,43,3,229,54,54,30
1850,254,3,44,8,237,76,76,80
1851,254,3,45,5,242,42,42,50
1852,254,3,46,3,245,30,30,30
1853,254,3,47,8,253,78,78,80
1854,254,3,48,9,262,100,100,90
1855,254,3,49,8,270,84,33,80
1856,254,3,50,4,274,89,32,40
1857,254,3,51,7,281,126,50,70
1858,254,3,52,9,290,179,179,90
1859,254,3,53,3,293,36,36,30
1860,254,3,54,7,300,59,59,70
1861,254,3,55,7,307,65,21,70
1862,254,3,56,5,312,103,103,50
1863,254,3,57,2,314,23,7,20
1864,254,3,58,4,318,51,19,40
1865,254,3,59,8,326,116,34,80
1866,254,3,60,9,335,171,67,90
1867,254,3,61,3,338,141,141,30
1868,254,3,62,4,342,56,56,40
1869,254,3,63,6,348,62,16,60
1870,254,3,64,9,357,135,55,90
1871,254,3,65,2,359,95,95,20
1872,254,3,66,9,368,95,35,90
1873,254,3,67,7,375,129,129,70
1874,254,3,68,5,380,49,18,50
1875,254,3,69,3,383,64,19,30
1876,254,3,70,3,386,70,24,30
1877,254,3,71,7,393,117,117,70
1878,254,3,72,4,397,46,14,40
1879,254,3,73,4,401,65,65,40
1880,254,3,74,7,408,52,52,70
1881,254,3,75,4,412,33,33,40
1882,254,3,76,2,414,18,18,20
1883,254,3,77,9,423,97,97,90
1884,254,3,78,7,430,65,65,70
1885,254,3,79,6,436,58,20,60
1886,254,3,80,8,444,123,123,80
1887,254,3,81,4,448,34,34,40
1888,254,3,82,9,457,86,86,90
1889,254,3,83,3,460,28,28,30
1890,254,3,84,2,462,19,3,20
1891,254,3,85,7,469,73,27,70
1892,254,3,86,6,475,111,111,60
1893,254,3,87,6,481,67,67,60
1894,254,3,88,4,485,40,40,40
1895,254,3,89,7,492,56,56,70
1896,254,3,90,7,499,64,64,70
1897,254,3,91,7,506,72,72,70
1898,254,3,92,5,511,44,44,50
1899,254,3,93,7,518,69,69,70
1900,254,3,94,5,523,47,16,50
1901,254,3,95,9,532,114,114,90
1902,254,3,96,6,538,68,68,60
1903,254,3,97,9,547,103,103,90
1904,254,3,98,6,553,61,61,60
1905,254,3,99,9,562,93,37,90
1906,254,3,100,9,571,149,149,90
1907,254,3,101,2,573,19,19,20
1908,254,3,102,6,579,52,52,60
1909,254,3,103,6,585,46,46,60
1910,254,3,104,8,593,76,76,80
1911,254,3,105,9,602,105,105,90
1912,254,3,106,8,610,100,33,80
1913,254,3,107,8,618,153,54,80
1914,254,3,108,2,620,120,120,20
1915,254,3,109,2,622,17,4,20
1916,254,3,110,2,624,32,32,20
1917,254,3,111,5,629,55,55,50
1918,254,3,112,3,632,36,36,30
1919,254,3,113,9,641,103,103,90
1920,254,3,114,5,646,44,44,50
1921,254,3,115,4,650,37,37,40
1922,254,3,116,5,655,52,52,50
1923,254,3,117,7,662,74,74,70
1924,254,3,118,9,671,88,88,90
1925,254,3,119,4,675,41,11,40
1926,254,3,120,3,678,54,25,30
1927,254,3,121,6,684,96,31,60
1928,254,3,122,5,689,127,127,50
1929,254,3,123,9,698,101,25,90
1930,254,3,124,9,707,156,156,90
1931,254,3,125,3,710,23,23,30
1932,254,3,126,6,716,68,68,60
1933,254,3,127,6,722,63,20,60
1934,254,3,128,4,726,77,77,40
1935,254,3,129,3,729,27,11,30
1936,254,3,130,9,738,111,111,90
1937,254,3,131,8,746,76,76,80
1938,254,3,132,5,751,51,51,50
1939,254,3,133,8,759,78,21,80
1940,254,3,134,2,761,74,19,20
1941,254,3,135,9,770,154,154,90
1942,254,3,136,2,772,13,5,20
1943,254,3,137,7,779,83,37,70
1944,254,3,138,7,786,117,117,70
1945,254,3,139,7,793,70,70,70
1946,254,3,140,3,796,37,37,30
1947,254,3,141,7,803,60,15,70
1948,254,3,142,7,810,103,103,70
1949,254,3,143,6,816,60,22,60
1950,254,3,144,9,825,136,136,90
1951,254,3,145,3,828,27,27,30
1952,254,3,146,7,835,65,65,70
1953,254,3,147,7,842,89,89,70
1954,254,3,148,4,846,43,43,40
1955,254,3,149,6,852,59,59,60
1956,254,3,150,3,855,32,32,30
1957,254,3,151,7,862,59,19,70
1958,254,3,152,9,871,129,129,90
1959,254,3,153,5,876,42,13,50
1960,254,3,154,5,881,84,84,50
1961,254,3,155,2,883,15,15,20
1962,254,3,156,2,885,13,3,20
1963,254,3,157,7,892,71,71,70
1964,254,3,158,7,899,60,19,70
1965,254,3,159,6,905,97,97,60
1966,254,3,160,8,913,89,89,80
1967,254,3,161,4,917,53,21,40
1968,254,3,162,7,924,106,36,70
1969,254,3,163,6,930,127,127,60
1970,254,3,164,6,936,57,57,60
1971,254,3,165,3,939,40,40,30
1972,254,3,166,4,943,34,8,40
1973,254,3,167,6,949,107,107,60
1974,254,3,168,3,952,22,22,30
1975,254,3,169,2,954,12,12,20
1976,254,3,170,3,957,21,21,30
1977,254,3,171,5,962,54,22,50
1978,254,3,172,5,967,93,93,50
1979,254,3,173,6,973,57,57,60
1980,254,3,174,5,978,54,54,50
1981,254,3,175,9,987,82,29,90
1982,254,3,176,3,990,75,23,30
1983,254,3,177,6,996,111,111,60
1984,254,3,178,3,999,22,22,30
1985,254,3,179,4,1003,40,40,40
1986,254,3,180,8,1011,77,77,80
1987,254,3,181,7,1018,67,67,70
1988,254,3,182,5,1023,59,59,50
1989,254,3,183,2,1025,18,6,20
1990,254,3,184,3,1028,39,17,30
1991,254,3,185,3,1031,52,52,30
1992,254,3,186,5,1036,46,13,50
1993,254,3,187,3,1039,64,64,30
1994,254,3,188,2,1041,22,22,20
1995,254,3,189,6,1047,63,26,60
1996,254,3,190,9,1056,139,139,90
1997,254,3,191,5,1061,43,43,50
1998,254,3,192,9,1070,90,90,90
1999,254,3,193,3,1073,26,26,30
2000,254,3,194,4,1077,38,8,40
2001,254,3,195,9,1086,123,123,90
2002,254,3,196,4,1090,51,22,40
2003,254,3,197,4,1094,66,66,40
2004,254,3,198,5,1099,45,19,50
2005,254,3,199,7,1106,92,92,70
2006,254,3,200,8,1114,90,90,80
2007,254,3,201,9,1123,104,104,90
2008,254,3,202,6,1129,69,69,60
2009,254,3,203,2,1131,24,24,20
2010,254,3,204,8,1139,73,73,80
2011,254,3,205,6,1145,54,54,60
2012,254,3,206,8,1153,73,73,80
2013,254,3,207,3,1156,28,28,30
2014,254,3,208,7,1163,71,71,70
2015,254,3,209,7,1170,60,60,70
2016,254,3,210,8,1178,80,80,80
2017,254,3,211,9,1187,95,95,90
2018,254,3,212,2,1189,22,22,20
2019,254,3,213,7,1196,66,22,70
2020,254,3,214,5,1201,84,84,50
2021,254,3,215,3,1204,32,32,30
2022,254,3,216,8,1212,85,85,80
2023,254,3,217,2,1214,23,23,20
2024,254,3,218,6,1220,64,22,60
2025,254,3,219,5,1225,93,93,50
2026,254,3,220,8,1233,86,86,80
2027,254,3,221,7,1240,87,87,70
2028,254,3,222,3,1243,26,26,30
2029,254,3,223,8,1251,73,25,80
2030,254,3,224,2,1253,65,65,20
2031,254,3,225,4,1257,43,43,40
2032,254,3,226,3,1260,27,27,30
2033,254,3,227,2,1262,14,14,20
2034,254,3,228,4,1266,52,19,40
2035,254,3,229,2,1268,50,50,20
2036,254,3,230,9,1277,82,36,90
2037,254,3,231,3,1280,84,84,30
2038,254,3,232,4,1284,42,14,40
2039,254,3,233,9,1293,118,118,90
2040,254,3,234,3,1296,31,31,30
2041,254,3,235,3,1299,36,36,30
2042,254,3,236,4,1303,33,33,40
2043,254,3,237,8,1311,73,73,80
2044,254,3,238,4,1315,45,14,40
2045,254,3,239,4,1319,76,76,40
2046,254,3,240,4,1323,55,55,40
2047,254,3,241,3,1326,21,21,30
2048,254,3,242,9,1335,77,77,90
2049,254,3,243,3,1338,28,28,30
2050,254,3,244,6,1344,56,56,60
2051,254,3,245,6,1350,74,74,60
2052,254,3,246,9,1359,94,31,90
2053,254,3,247,2,1361,86,86,20
2054,254,3,248,2,1363,17,6,20
2055,254,3,249,5,1368,60,22,50
2056,254,3,250,2,1370,55,55,20
2057,254,3,251,9,1379,86,28,90
2058,254,3,252,5,1384,116,45,50
2059,254,3,253,3,1387,94,94,30
2060,254,3,254,8,1395,75,27,80
2061,254,3,255,2,1397,73,25,20
2062,254,3,256,4,1401,82,28,40
2063,254,3,257,9,1410,146,49,90
2064,254,3,258,4,1414,133,133,40
2065,254,3,259,9,1423,87,87,90
2066,254,3,260,9,1432,85,35,90
2067,254,3,261,8,1440,144,47,80
2068,254,3,262,3,1443,128,128,30
2069,254,3,263,9,1452,94,38,90
2070,254,3,264,3,1455,79,79,30
2071,254,3,265,9,1464,85,36,90
2072,254,3,266,2,1466,67,18,20
2073,254,3,267,8,1474,136,43,80
2074,254,3,268,3,1477,130,51,30
2075,254,3,269,5,1482,129,129,50
2076,254,3,270,6,1488,61,20,60
2077,254,3,271,9,1497,142,142,90
2078,254,3,272,6,1503,59,20,60
2079,254,3,273,5,1508,96,96,50
2080,254,3,274,6,1514,61,29,60
2081,254,3,275,4,1518,64,64,40
2082,254,3,276,6,1524,49,16,60
2083,254,3,277,4,1528,67,67,40
2084,254,3,278,5,1533,57,19,50
2085,254,3,279,7,1540,102,102,70
2086,254,3,280,9,1549,97,97,90
2087,254,3,281,9,1558,97,97,90
2088,254,3,282,5,1563,40,15,50
2089,254,3,283,6,1569,91,35,60
2090,254,3,284,2,1571,80,20,20
2091,254,3,285,6,1577,135,135,60
2092,254,3,286,3,1580,34,34,30
2093,254,3,287,9,1589,112,112,90
2094,254,3,288,7,1596,70,21,70
2095,254,3,289,5,1601,94,28,50
2096,254,3,290,8,1609,151,151,80
2097,254,3,291,6,1615,51,51,60
2098,254,3,292,8,1623,83,83,80
2099,254,3,293,2,1625,24,24,20
2100,254,3,294,5,1630,44,44,50
2101,254,3,295,9,1639,86,28,90
2102,254,3,296,5,1644,118,118,50
2103,254,3,297,9,1653,95,95,90
2104,254,3,298,5,1658,51,14,50
2105,254,3,299,8,1666,109,109,80
2106,254,3,300,7,1673,82,34,70
2107,254,3,301,5,1678,99,99,50
2108,254,3,302,5,1683,42,42,50
2109,254,3,303,5,1688,43,43,50
2110,254,3,304,9,1697,93,93,90
2111,254,3,305,6,1703,61,61,60
2112,254,3,306,2,1705,20,20,20
2113,254,3,307,8,1713,79,79,80
2114,254,3,308,6,1719,53,53,60
2115,254,3,309,2,1721,25,10,20
2116,254,3,310,4,1725,51,51,40
2117,254,3,311,2,1727,16,3,20
2118,254,3,312,9,1736,95,29,90
2119,254,3,313,3,1739,103,34,30
2120,254,3,314,7,1746,139,139,70
2121,254,3,315,8,1754,74,24,80
2122,254,3,316,2,1756,65,65,20
2123,254,3,317,2,1758,17,17,20
2124,254,3,318,8,1766,75,75,80
2125,254,3,319,4,1770,44,44,40
2126,254,3,320,2,1772,19,19,20
2127,254,3,321,8,1780,95,95,80
2128,254,3,322,8,1788,75,75,80
2129,254,3,323,9,1797,95,95,90
2130,254,3,324,4,1801,42,42,40
2131,254,3,325,6,1807,69,26,60
2132,254,3,326,5,1812,92,92,50
2133,254,3,327,5,1817,50,50,50
2134,254,3,328,3,1820,31,31,30
2135,254,3,329,8,1828,65,65,80
2136,254,3,330,8,1836,73,73,80
2137,254,3,331,4,1840,32,32,40
2138,254,3,332,5,1845,38,38,50
2139,254,3,333,9,1854,94,94,90
2140,254,3,334,4,1858,35,35,40
2141,254,3,335,8,1866,94,94,80
2142,254,3,336,3,1869,26,26,30
2143,254,3,337,3,1872,31,31,30
2144,254,3,338,5,1877,45,45,50
2145,254,3,339,7,1884,71,71,70
2146,254,3,340,3,1887,26,26,30
2147,254,3,341,8,1895,89,89,80
2148,254,3,342,4,1899,45,45,40
2149,254,3,343,2,1901,25,25,20
2150,254,3,344,8,1909,73,73,80
2151,254,3,345,6,1915,68,68,60
2152,254,3,346,8,1923,59,59,80
2153,254,3,347,2,1925,29,29,20
2154,254,3,348,9,1934,93,93,90
2155,254,3,349,2,1936,17,17,20
2156,254,3,350,7,1943,75,75,70
2157,254,3,351,6,1949,65,22,60
2158,254,3,352,5,1954,103,103,50
2159,254,3,353,9,1963,84,84,90
2160,254,3,354,2,1965,20,6,20
2161,254,3,355,8,1973,94,27,80
2162,254,3,356,9,1982,146,47,90
2163,254,3,357,8,1990,180,180,80
2164,254,3,358,6,1996,75,75,60
2165,254,3,359,5,2001,61,61,50
2166,254,3,360,4,2005,36,36,40
2167,254,3,361,6,2011,66,66,60
2168,254,3,362,2,2013,14,14,20
2169,254,3,363,3,2016,23,8,30
2170,254,3,364,2,2018,40,40,20
2171,254,3,365,5,2023,48,48,50
2172,254,3,366,6,2029,58,16,60
2173,254,3,367,8,2037,113,113,80
2174,254,3,368,3,2040,28,28,30
2175,254,3,369,6,2046,57,57,60
2176,254,3,370,4,2050,31,31,40
2177,254,3,371,5,2055,51,51,50
2178,254,3,372,6,2061,66,22,60
2179,254,3,373,2,2063,59,59,20
2180,254,3,374,7,2070,86,86,70
2181,254,3,375,7,2077,60,60,70
2182,254,3,376,7,2084,64,64,70
2183,254,3,377,5,2089,51,14,50
2184,254,3,378,5,2094,84,84,50
2185,254,3,379,6,2100,62,62,60
2186,254,3,380,6,2106,74,74,60
2187,254,3,381,7,2113,59,59,70
2188,254,3,382,8,2121,75,75,80
2189,254,3,383,7,2128,72,72,70
2190,254,3,384,2,2130,22,22,20
2191,254,3,385,4,2134,42,42,40
2192,254,3,386,2,2136,18,8,20
2193,254,3,387,2,2138,32,32,20
2194,254,3,388,8,2146,97,97,80
2195,254,3,389,8,2154,76,29,80
2196,254,3,390,5,2159,93,28,50
2197,254,3,391,4,2163,122,38,40
2198,254,3,392,3,2166,119,119,30
2199,254,3,393,3,2169,35,16,30
2200,254,3,394,7,2176,91,91,70
2201,254,3,395,6,2182,60,60,60
2202,254,3,396,3,2185,35,35,30
2203,254,3,397,6,2191,53,53,60
2204,254,3,398,7,2198,67,20,70
2205,254,3,399,5,2203,92,27,50
2206,254,3,400,2,2205,84,84,20
2207,254,3,401,8,2213,82,82,80
2208,254,3,402,6,2219,68,68,60
2209,254,3,403,4,2223,39,39,40
2210,254,3,404,3,2226,32,12,30
2211,254,3,405,3,2229,52,52,30
2212,254,3,406,5,2234,58,18,50
2213,254,3,407,3,2237,63,63,30
2214,254,3,408,7,2244,69,24,70
2215,254,3,409,5,2249,106,106,50
2216,254,3,410,4,2253,35,35,40
2217,254,3,411,3,2256,29,29,30
2218,254,3,412,5,2261,50,22,50
2219,254,3,413,3,2264,66,66,30
2220,254,3,414,8,2272,83,83,80
2221,254,3,415,5,2277,49,18,50
2222,254,3,416,5,2282,76,24,50
2223,254,3,417,8,2290,136,136,80
2224,254,3,418,6,2296,67,67,60
2225,254,3,419,9,2305,90,90,90
2226,254,3,420,7,2312,62,62,70
2227,254,3,421,4,2316,38,38,40
2228,254,3,422,8,2324,85,28,80
2229,254,3,423,2,2326,82,82,20
2230,254,3,424,6,2332,68,26,60
2231,254,3,425,2,2334,59,59,20
2232,254,3,426,4,2338,41,10,40
2233,254,3,427,3,2341,60,18,30
2234,254,3,428,3,2344,77,77,30
2235,254,3,429,8,2352,75,75,80
2236,254,3,430,6,2358,55,23,60
2237,254,3,431,6,2364,84,84,60
2238,254,3,432,6,2370,54,54,60
2239,254,3,433,3,2373,17,17,30
2240,254,3,434,4,2377,47,14,40
2241,254,3,435,2,2379,51,51,20
2242,254,3,436,2,2381,19,19,20
2243,254,3,437,7,2388,75,39,70
2244,254,3,438,2,2390,59,59,20
2245,254,3,439,2,2392,32,12,20
2246,254,3,440,7,2399,86,86,70
2247,254,3,441,2,2401,22,8,20
2248,254,3,442,9,2410,102,102,90
2249,254,3,443,9,2419,81,81,90
2250,254,3,444,8,2427,86,86,80
2251,254,3,445,8,2435,73,32,80
2252,254,3,446,2,2437,68,68,20
2253,254,3,447,7,2444,87,87,70
2254,254,3,448,7,2451,49,49,70
2255,254,3,449,2,2453,27,27,20
2256,254,3,450,2,2455,19,19,20
2257,254,3,451,7,2462,85,28,70
2258,254,3,452,4,2466,92,30,40
2259,254,3,453,3,2469,100,32,30
2260,254,3,454,8,2477,148,45,80
2261,254,3,455,3,2480,130,130,30
2262,254,3,456,5,2485,59,59,50
2263,254,3,457,9,2494,86,86,90
2264,254,3,458,3,2497,14,14,30
2265,254,3,459,8,2505,83,26,80
2266,254,3,460,6,2511,114,114,60
2267,254,3,461,7,2518,67,18,70
2268,254,3,462,5,2523,103,103,50
2269,254,3,463,7,2530,67,22,70
2270,254,3,464,9,2539,139,139,90
2271,254,3,465,3,2542,30,7,30
2272,254,3,466,6,2548,81,28,60
2273,254,3,467,5,2553,107,107,50
2274,254,3,468,8,2561,77,77,80
2275,254,3,469,9,2570,89,34,90
2276,254,3,470,8,2578,127,127,80
2277,254,3,471,4,2582,40,40,40
2278,254,3,472,7,2589,72,72,70
2279,254,3,473,9,2598,107,107,90
2280,254,3,474,4,2602,45,45,40
2281,254,3,475,5,2607,53,53,50
2282,254,3,476,6,2613,54,54,60
2283,254,3,477,7,2620,73,73,70
2284,254,3,478,3,2623,35,9,30
2285,254,3,479,3,2626,59,59,30
2286,254,3,480,2,2628,23,23,20
2287,254,3,481,3,2631,34,11,30
2288,254,3,482,4,2635,60,60,40
2289,254,3,483,3,2638,31,31,30
2290,254,3,484,7,2645,72,28,70
2291,254,3,485,2,2647,59,59,20
2292,254,3,486,8,2655,66,66,80
2293,254,3,487,6,2661,64,64,60
2294,254,3,488,2,2663,22,22,20
2295,254,3,489,9,2672,86,86,90
2296,254,3,490,2,2674,27,27,20
2297,254,3,491,2,2676,18,18,20
2298,254,3,492,3,2679,19,6,30
2299,254,3,493,4,2683,59,59,40
2300,254,3,494,4,2687,43,18,40
2301,254,3,495,7,2694,95,95,70
2302,254,3,496,3,2697,24,8,30
2303,254,3,497,3,2700,46,46,30
2304,254,3,498,8,2708,71,71,80
2305,254,3,499,5,2713,47,47,50
2306,254,3,500,6,2719,62,62,60
2307,254,3,501,2,2721,21,21,20
2308,254,3,502,6,2727,53,53,60
2309,254,3,503,4,2731,42,42,40
2310,254,3,504,3,2734,43,43,30
2311,254,3,505,8,2742,74,74,80
2312,254,3,506,9,2751,82,27,90
2313,254,3,507,4,2755,101,101,40
2314,254,3,508,5,2760,46,46,50
2315,254,3,509,6,2766,53,53,60
2316,254,3,510,4,2770,35,35,40
2317,254,3,511,8,2778,86,86,80
2318,254,3,512,5,2783,51,51,50
2319,254,3,513,6,2789,58,58,60
2320,254,3,514,3,2792,27,27,30
2321,254,3,515,3,2795,21,8,30
2322,254,3,516,5,2800,53,53,50
2323,254,3,517,7,2807,84,84,70
2324,254,3,518,6,2813,70,70,60
2325,254,3,519,7,2820,64,20,70
2326,254,3,520,8,2828,120,42,80
2327,254,3,521,9,2837,158,158,90
2328,254,3,522,5,2842,60,60,50
2329,254,3,523,2,2844,20,20,20
2330,254,3,524,5,2849,57,57,50
2331,254,3,525,5,2854,38,14,50
2332,254,3,526,2,2856,47,47,20
2333,254,3,527,3,2859,30,30,30
2334,254,3,528,2,2861,14,14,20
2335,254,3,529,2,2863,10,3,20
2336,254,3,530,7,2870,72,22,70
2337,254,3,531,3,2873,85,85,30
2338,254,3,532,9,2882,107,107,90
2339,254,3,533,2,2884,17,17,20
2340,254,3,534,7,2891,63,27,70
2341,254,3,535,8,2899,116,116,80
2342,254,3,536,3,2902,40,40,30
2343,254,3,537,9,2911,91,91,90
2344,254,3,538,7,2918,72,19,70
2345,254,3,539,8,2926,126,126,80
2346,254,3,540,2,2928,16,16,20
2347,254,3,541,6,2934,57,57,60
2348,254,3,542,8,2942,78,29,80
2349,254,3,543,9,2951,139,139,90
2350,254,3,544,6,2957,72,72,60
2351,254,3,545,9,2966,83,83,90
2352,254,3,546,4,2970,36,36,40
2353,254,3,547,5,2975,41,41,50
2354,254,3,548,8,2983,74,28,80
2355,254,3,549,4,2987,88,31,40
2356,254,3,550,4,2991,91,91,40
2357,254,3,551,3,2994,40,40,30
2358,254,3,552,8,3002,71,71,80
2359,254,3,553,4,3006,55,22,40
2360,254,3,554,7,3013,97,97,70
2361,254,3,555,3,3016,31,31,30
2362,254,3,556,8,3024,80,80,80
2363,254,3,557,6,3030,60,60,60
2364,254,3,558,5,3035,48,48,50
2365,254,3,559,5,3040,56,56,50
2366,254,3,560,9,3049,79,21,90
2367,254,3,561,7,3056,115,115,70
2368,254,3,562,2,3058,14,14,20
2369,254,3,563,7,3065,61,20,70
2370,254,3,564,9,3074,139,139,90
2371,254,3,565,6,3080,60,60,60
2372,254,3,566,4,3084,47,10,40
2373,254,3,567,3,3087,76,17,30
2374,254,3,568,7,3094,119,119,70
2375,254,3,569,6,3100,66,23,60
2376,254,3,570,5,3105,90,90,50
2377,254,3,571,6,3111,62,62,60
2378,254,3,572,6,3117,55,16,60
2379,254,3,573,7,3124,110,110,70
2380,254,3,574,8,3132,90,90,80
2381,254,3,575,5,3137,47,47,50
2382,254,3,576,9,3146,85,85,90
2383,254,3,577,6,3152,46,46,60
2384,254,3,578,2,3154,18,18,20
2385,254,3,579,9,3163,74,74,90
2386,254,3,580,2,3165,16,16,20
2387,254,3,581,8,3173,77,77,80
2388,254,3,582,5,3178,42,42,50
2389,254,3,583,7,3185,76,22,70
2390,254,3,584,3,3188,83,23,30
2391,254,3,585,3,3191,91,31,30
2392,254,3,586,4,3195,91,91,40
2393,254,3,587,9,3204,104,35,90
2394,254,3,588,7,3211,144,144,70
2395,254,3,589,6,3217,49,20,60
2396,254,3,590,9,3226,113,33,90
2397,254,3,591,4,3230,126,126,40
2398,254,3,592,9,3239,95,95,90
2399,254,3,593,7,3246,75,25,70
2400,254,3,594,8,3254,137,46,80
2401,254,3,595,6,3260,145,145,60
2402,254,3,596,8,3268,99,99,80
2403,254,3,597,7,3275,67,24,70
2404,254,3,598,2,3277,60,60,20
2405,254,3,599,2,3279,15,15,20
2406,254,3,600,9,3288,75,75,90
2407,254,3,601,7,3295,78,78,70
2408,254,3,602,7,3302,67,19,70
2409,254,3,603,5,3307,102,41,50
2410,254,3,604,8,3315,140,140,80
2411,254,3,605,7,3322,65,20,70
2412,254,3,606,3,3325,77,77,30
2413,254,3,607,3,3328,30,30,30
2414,254,3,608,9,3337,96,26,90
2415,254,3,609,3,3340,113,113,30
2416,254,3,610,4,3344,38,38,40
2417,254,3,611,6,3350,50,9,60
2418,254,3,612,8,3358,120,120,80
2419,254,3,613,8,3366,80,80,80
2420,254,3,614,4,3370,27,27,40
2421,254,3,615,8,3378,69,69,80
2422,254,3,616,3,3381,29,29,30
2423,254,3,617,5,3386,45,19,50
2424,254,3,618,7,3393,82,82,70
2425,254,3,619,6,3399,50,23,60
2426,254,3,620,7,3406,100,100,70
2427,254,3,621,3,3409,35,35,30
2428,254,3,622,5,3414,38,38,50
2429,254,3,623,9,3423,96,96,90
2430,254,3,624,4,3427,51,51,40
2431,254,3,625,7,3434,59,22,70
2432,254,3,626,6,3440,99,99,60
2433,254,3,627,9,3449,83,83,90
2434,254,3,628,9,3458,94,94,90
2435,254,3,629,4,3462,42,16,40
2436,254,3,630,6,3468,76,76,60
2437,254,3,631,8,3476,80,35,80
2438,254,3,632,7,3483,120,48,70
2439,254,3,633,6,3489,133,133,60
2440,254,3,634,5,3494,45,17,50
2441,254,3,635,7,3501,98,98,70
2442,254,3,636,2,3503,17,17,20
2443,254,3,637,5,3508,50,20,50
2444,254,3,638,3,3511,66,28,30
2445,254,3,639,6,3517,104,104,60
2446,254,3,640,5,3522,42,42,50
2447,254,3,641,8,3530,88,88,80
2448,254,3,642,5,3535,60,18,50
2449,254,3,643,7,3542,120,120,70
2450,254,3,644,2,3544,16,16,20
2451,254,3,645,8,3552,71,71,80
2452,254,3,646,9,3561,85,85,90
2453,254,3,647,8,3569,87,87,80
2454,254,3,648,8,3577,76,76,80
2455,254,3,649,6,3583,65,65,60
2456,254,3,650,6,3589,61,61,60
2457,254,3,651,7,3596,55,55,70
2458,254,3,652,9,3605,76,26,90
2459,254,3,653,5,3610,104,104,50
2460,254,3,654,7,3617,65,23,70
2461,254,3,655,2,3619,68,68,20
2462,254,3,656,5,3624,50,50,50
2463,254,3,657,3,3627,30,30,30
2464,254,3,658,2,3629,25,5,20
2465,254,3,659,5,3634,72,72,50
2466,254,3,660,7,3641,77,77,70
2467,254,3,661,8,3649,76,76,80
2468,254,3,662,9,3658,75,75,90
2469,254,3,663,2,3660,22,22,20
2470,254,3,664,4,3664,40,9,40
2471,254,3,665,5,3669,73,21,50
2472,254,3,666,5,3674,99,99,50
2473,254,3,667,9,3683,85,28,90
2474,254,3,668,9,3692,142,142,90
2475,254,3,669,5,3697,55,55,50
2476,254,3,670,6,3703,55,55,60
2477,254,3,671,7,3710,60,22,70
2478,254,3,672,5,3715,86,30,50
2479,254,3,673,6,3721,133,133,60
2480,254,3,674,2,3723,21,21,20
2481,254,3,675,5,3728,51,51,50
2482,254,3,676,4,3732,47,47,40
2483,254,3,677,3,3735,31,10,30
2484,254,3,678,8,3743,104,104,80
2485,254,3,679,4,3747,44,44,40
2486,254,3,680,6,3753,53,53,60
2487,254,3,681,7,3760,90,90,70
2488,254,3,682,5,3765,52,10,50
2489,254,3,683,8,3773,126,43,80
2490,254,3,684,7,3780,146,50,70
2491,254,3,685,3,3783,133,45,30
2492,254,3,686,5,3788,136,136,50
2493,254,3,687,4,3792,41,41,40
2494,254,3,688,9,3801,105,105,90
2495,254,3,689,4,3805,54,54,40
2496,254,3,690,2,3807,20,20,20
2497,254,3,691,8,3815,84,84,80
2498,254,3,692,5,3820,55,55,50
2499,254,3,693,8,3828,80,80,80
2500,254,3,694,5,3833,52,52,50
2501,254,3,695,6,3839,61,61,60
2502,254,3,696,8,3847,76,76,80
2503,254,3,697,4,3851,44,44,40
2504,254,3,698,5,3856,50,50,50
2505,254,3,699,7,3863,69,69,70
2506,254,3,700,4,3867,50,50,40
2507,254,3,701,8,3875,73,73,80
2508,254,3,702,8,3883,88,30,80
2509,254,3,703,2,3885,84,31,20
2510,254,3,704,8,3893,134,134,80
2511,254,3,705,6,3899,65,65,60
2512,254,3,706,2,3901,17,17,20
2513,254,3,707,2,3903,27,27,20
2514,254,3,708,4,3907,35,35,40
2515,254,3,709,9,3916,90,90,90
2516,254,3,710,4,3920,20,20,40
2517,254,3,711,8,3928,56,56,80
2518,254,3,712,6,3934,65,65,60
2519,254,3,713,7,3941,77,77,70
2520,254,3,714,3,3944,32,11,30
2521,254,3,715,3,3947,54,54,30
2522,254,3,716,2,3949,16,16,20
2523,254,3,717,4,3953,41,41,40
2524,254,3,718,6,3959,58,23,60
2525,254,3,719,2,3961,53,53,20
2526,254,3,720,8,3969,69,69,80
2527,254,3,721,6,3975,49,49,60
2528,254,3,722,4,3979,50,17,40
2529,254,3,723,8,3987,138,138,80
2530,254,3,724,3,3990,37,15,30
2531,254,3,725,8,3998,107,107,80
2532,254,3,726,6,4004,60,60,60
2533,254,3,727,6,4010,56,56,60
2534,254,3,728,5,4015,58,11,50
2535,254,3,729,5,4020,96,40,50
2536,254,3,730,2,4022,79,24,20
2537,254,3,731,5,4027,119,119,50
2538,254,3,732,3,4030,31,31,30
2539,254,3,733,4,4034,32,32,40
2540,254,3,734,8,4042,64,25,80
2541,254,3,735,9,4051,144,144,90
2542,254,3,736,9,4060,101,101,90
2543,254,3,737,2,4062,25,25,20
2544,254,3,738,8,4070,105,105,80
2545,254,3,739,8,4078,101,39,80
2546,254,3,740,5,4083,116,116,50
2547,254,3,741,3,4086,28,9,30
2548,254,3,742,7,4093,87,29,70
2549,254,3,743,5,4098,101,36,50
2550,254,3,744,7,4105,134,134,70
2551,254,3,745,5,4110,53,53,50
2552,254,3,746,8,4118,81,81,80
2553,254,3,747,4,4122,41,18,40
2554,254,3,748,9,4131,135,135,90
2555,254,3,749,9,4140,116,116,90
2556,254,3,750,7,4147,68,68,70
2557,254,3,751,8,4155,93,35,80
2558,254,3,752,5,4160,126,126,50
2559,254,3,753,8,4168,98,98,80
2560,254,3,754,6,4174,60,60,60
2561,254,3,755,3,4177,22,22,30
2562,254,3,756,7,4184,76,28,70
2563,254,3,757,7,4191,108,37,70
2564,254,3,758,2,4193,90,90,20
2565,254,3,759,2,4195,24,24,20
2566,254,3,760,7,4202,68,20,70
2567,254,3,761,8,4210,124,124,80
2568,254,3,762,2,4212,9,6,20
2569,254,3,763,7,4219,75,22,70
2570,254,3,764,5,4224,101,101,50
2571,254,3,765,8,4232,88,29,80
2572,254,3,766,3,4235,87,87,30
2573,254,3,767,7,4242,71,24,70
2574,254,3,768,4,4246,92,92,40
2575,254,3,769,4,4250,34,34,40
2576,254,3,770,9,4259,97,97,90
2577,254,3,771,8,4267,92,92,80
2578,254,3,772,5,4272,47,47,50
2579,254,3,773,7,4279,78,78,70
2580,254,3,774,4,4283,35,35,40
2581,254,3,775,8,4291,84,84,80
2582,254,3,776,4,4295,36,36,40
2583,254,3,777,7,4302,64,64,70
2584,254,3,778,6,4308,57,15,60
2585,254,3,779,2,4310,75,75,20
2586,254,3,780,7,4317,59,59,70
2587,254,3,781,6,4323,67,67,60
2588,254,3,782,9,4332,95,95,90
2589,254,3,783,9,4341,103,103,90
2590,254,3,784,8,4349,89,28,80
2591,254,3,785,5,4354,124,124,50
2592,254,3,786,3,4357,28,28,30
2593,254,3,787,8,4365,83,83,80
2594,254,3,788,8,4373,81,30,80
2595,254,3,789,5,4378,103,39,50
2596,254,3,790,3,4381,94,94,30
2597,254,3,791,9,4390,83,20,90
2598,254,3,792,8,4398,154,154,80
2599,254,3,793,9,4407,85,85,90
2600,254,3,794,5,4412,52,52,50
2601,254,3,795,6,4418,66,17,60
2602,254,3,796,9,4427,147,52,90
2603,254,3,797,7,4434,153,60,70
2604,254,3,798,5,4439,141,141,50
2605,254,3,799,4,4443,33,33,40
2606,254,3,800,7,4450,71,71,70
2607,254,3,801,5,4455,57,57,50
2608,254,3,802,6,4461,63,63,60
2609,254,3,803,5,4466,59,59,50
2610,254,3,804,3,4469,19,19,30
2611,254,3,805,8,4477,86,86,80
2612,254,3,806,9,4486,80,25,90
2613,254,3,807,7,4493,125,125,70
2614,254,3,808,8,4501,78,78,80
2615,254,3,809,7,4508,59,59,70
2616,254,3,810,6,4514,66,66,60
2617,254,3,811,6,4520,66,66,60
2618,254,3,812,9,4529,79,29,90
2619,254,3,813,6,4535,90,90,60
2620,254,3,814,4,4539,32,13,40
2621,254,3,815,8,4547,114,40,80
2622,254,3,816,7,4554,140,52,70
2623,254,3,817,4,4558,118,118,40
2624,254,3,818,6,4564,71,27,60
2625,254,3,819,8,4572,121,121,80
2626,254,3,820,7,4579,71,71,70
2627,254,3,821,3,4582,21,21,30
2628,254,3,822,9,4591,79,79,90
2629,254,3,823,2,4593,17,6,20
2630,254,3,824,6,4599,85,85,60
2631,254,3,825,5,4604,41,17,50
2632,254,3,826,4,4608,75,75,40
2633,254,3,827,9,4617,90,90,90
2634,254,3,828,3,4620,24,24,30
2635,254,3,829,2,4622,17,3,20
2636,254,3,830,8,4630,100,100,80
2637,254,3,831,5,4635,60,21,50
2638,254,3,832,3,4638,74,74,30
2639,254,3,833,5,4643,59,59,50
2640,254,3,834,8,4651,76,28,80
2641,254,3,835,9,4660,142,142,90
2642,254,3,836,4,4664,43,43,40
2643,254,3,837,8,4672,81,30,80
2644,254,3,838,6,4678,97,97,60
2645,254,3,839,4,4682,40,40,40
2646,254,3,840,3,4685,25,25,30
2647,254,3,841,3,4688,30,30,30
2648,254,3,842,8,4696,84,30,80
2649,254,3,843,8,4704,125,46,80
2650,254,3,844,8,4712,168,168,80
2651,254,3,845,9,4721,88,88,90
2652,254,3,846,9,4730,87,87,90
2653,254,3,847,7,4737,70,70,70
2654,254,3,848,5,4742,47,16,50
2655,254,3,849,8,4750,109,109,80
2656,254,3,850,6,4756,86,86,60
2657,254,3,851,9,4765,94,33,90
2658,254,3,852,4,4769,106,106,40
2659,254,3,853,3,4772,31,31,30
2660,254,3,854,8,4780,85,35,80
2661,254,3,855,3,4783,79,79,30
2662,254,3,856,3,4786,27,7,30
2663,254,3,857,7,4793,79,79,70
2664,254,3,858,6,4799,64,22,60
2665,254,3,859,5,4804,91,91,50
2666,254,3,860,7,4811,63,63,70
2667,254,3,861,6,4817,56,14,60
2668,254,3,862,2,4819,57,57,20
2669,254,3,863,8,4827,70,20,80
2670,254,3,864,9,4836,154,49,90
2671,254,3,865,4,4840,144,144,40
2672,254,3,866,2,4842,19,19,20
2673,254,3,867,4,4846,48,48,40
2674,254,3,868,9,4855,87,28,90
2675,254,3,869,7,4862,134,134,70
2676,254,3,870,9,4871,93,93,90
2677,254,3,871,5,4876,62,62,50
2678,254,3,872,3,4879,32,32,30
2679,254,3,873,4,4883,40,11,40
2680,254,3,874,9,4892,113,113,90
2681,254,3,875,3,4895,33,8,30
2682,254,3,876,8,4903,103,103,80
2683,254,3,877,9,4912,95,95,90
2684,254,3,878,2,4914,17,3,20
2685,254,3,879,5,4919,59,59,50
2686,254,3,880,7,4926,67,67,70
2687,254,3,881,5,4931,46,46,50
2688,254,3,882,7,4938,66,66,70
2689,254,3,883,9,4947,93,93,90
2690,254,3,884,6,4953,58,58,60
2691,254,3,885,9,4962,95,95,90
2692,254,3,886,5,4967,45,17,50
2693,254,3,887,9,4976,121,121,90
2694,254,3,888,3,4979,35,35,30
2695,254,3,889,8,4987,89,89,80
2696,254,3,890,3,4990,33,33,30
2697,254,3,891,5,4995,43,14,50
