,Scenario,Trial,Inspection,Interval,Time,Defects,Rate
0,280,1,1,4,4,39,40
1,280,1,2,6,10,1,60
2,280,1,3,2,12,1,20
3,280,1,4,2,14,1,20
4,280,1,5,8,22,1,80
5,280,1,6,3,25,1,30
6,280,1,7,4,29,164,40
7,280,1,8,3,32,1,30
8,280,1,9,5,37,1,50
9,280,1,10,5,42,1,50
10,280,1,11,8,50,1,80
11,280,1,12,2,52,1,20
12,280,1,13,9,61,1,90
13,280,1,14,6,67,1,60
14,280,1,15,7,74,1,70
15,280,1,16,4,78,1,40
16,280,1,17,6,84,1,60
17,280,1,18,3,87,1,30
18,280,1,19,2,89,1,20
19,280,1,20,7,96,1,70
20,280,1,21,7,103,1,70
21,280,1,22,8,111,622,80
22,280,1,23,4,115,221,40
23,280,1,24,2,117,87,20
24,280,1,25,3,120,40,30
25,280,1,26,8,128,1,80
26,280,1,27,6,134,1,60
27,280,1,28,8,142,172,80
28,280,1,29,7,149,1,70
29,280,1,30,3,152,123,30
30,280,1,31,4,156,1,40
31,280,1,32,8,164,1,80
32,280,1,33,3,167,149,30
33,280,1,34,8,175,1,80
34,280,1,35,7,182,138,70
35,280,1,36,8,190,1,80
36,280,1,37,4,194,144,40
37,280,1,38,8,202,1,80
38,280,1,39,2,204,1,20
39,280,1,40,5,209,1,50
40,280,1,41,9,218,1,90
41,280,1,42,5,223,1,50
42,280,1,43,2,225,219,20
43,280,1,44,9,234,1,90
44,280,1,45,4,238,1,40
45,280,1,46,4,242,186,40
46,280,1,47,9,251,1,90
47,280,1,48,5,256,180,50
48,280,1,49,6,262,1,60
49,280,1,50,4,266,118,40
50,280,1,51,7,273,1,70
51,280,1,52,8,281,1,80
52,280,1,53,8,289,1,80
53,280,1,54,6,295,224,60
54,280,1,55,2,297,72,20
55,280,1,56,4,301,1,40
56,280,1,57,8,309,1,80
57,280,1,58,2,311,138,20
58,280,1,59,4,315,46,40
59,280,1,60,2,317,1,20
60,280,1,61,6,323,70,60
61,280,1,62,6,329,56,60
62,280,1,63,6,335,1,60
63,280,1,64,6,341,1,60
64,280,1,65,7,348,1,70
65,280,1,66,3,351,1,30
66,280,1,67,6,357,1,60
67,280,1,68,2,359,1,20
68,280,1,69,9,368,1,90
69,280,1,70,2,370,1,20
70,280,1,71,3,373,1,30
71,280,1,72,4,377,1,40
72,280,1,73,9,386,1,90
73,280,1,74,3,389,1,30
74,280,1,75,3,392,1,30
75,280,1,76,6,398,1,60
76,280,1,77,7,405,529,70
77,280,1,78,4,409,226,40
78,280,1,79,7,416,1,70
79,280,1,80,9,425,1,90
80,280,1,81,7,432,1,70
81,280,1,82,5,437,239,50
82,280,1,83,8,445,1,80
83,280,1,84,6,451,158,60
84,280,1,85,4,455,1,40
85,280,1,86,6,461,1,60
86,280,1,87,7,468,1,70
87,280,1,88,5,473,186,50
88,280,1,89,3,476,1,30
89,280,1,90,3,479,1,30
90,280,1,91,2,481,1,20
91,280,1,92,9,490,1,90
92,280,1,93,4,494,1,40
93,280,1,94,4,498,1,40
94,280,1,95,5,503,229,50
95,280,1,96,2,505,1,20
96,280,1,97,8,513,158,80
97,280,1,98,4,517,71,40
98,280,1,99,9,526,1,90
99,280,1,100,8,534,1,80
100,280,1,101,6,540,1,60
101,280,1,102,9,549,1,90
102,280,1,103,9,558,1,90
103,280,1,104,2,560,1,20
104,280,1,105,9,569,380,90
105,280,1,106,5,574,129,50
106,280,1,107,6,580,1,60
107,280,1,108,8,588,1,80
108,280,1,109,2,590,160,20
109,280,1,110,5,595,1,50
110,280,1,111,3,598,1,30
111,280,1,112,2,600,1,20
112,280,1,113,7,607,196,70
113,280,1,114,8,615,1,80
114,280,1,115,5,620,156,50
115,280,1,116,8,628,1,80
116,280,1,117,5,633,1,50
117,280,1,118,5,638,1,50
118,280,1,119,8,646,1,80
119,280,1,120,9,655,295,90
120,280,1,121,6,661,1,60
121,280,1,122,3,664,1,30
122,280,1,123,4,668,1,40
123,280,1,124,8,676,1,80
124,280,1,125,5,681,1,50
125,280,1,126,9,690,1,90
126,280,1,127,4,694,370,40
127,280,1,128,9,703,1,90
128,280,1,129,3,706,1,30
129,280,1,130,6,712,1,60
130,280,1,131,6,718,1,60
131,280,1,132,7,725,1,70
132,280,1,133,6,731,1,60
133,280,1,134,7,738,1,70
134,280,1,135,7,745,1,70
135,280,1,136,9,754,541,90
136,280,1,137,4,758,158,40
137,280,1,138,7,765,1,70
138,280,1,139,4,769,1,40
139,280,1,140,4,773,163,40
140,280,1,141,2,775,62,20
141,280,1,142,3,778,1,30
142,280,1,143,5,783,1,50
143,280,1,144,4,787,1,40
144,280,1,145,2,789,1,20
145,280,1,146,5,794,1,50
146,280,1,147,8,802,188,80
147,280,1,148,5,807,103,50
148,280,1,149,8,815,1,80
149,280,1,150,7,822,1,70
150,280,1,151,7,829,1,70
151,280,1,152,2,831,1,20
152,280,1,153,8,839,1,80
153,280,1,154,9,848,1,90
154,280,1,155,2,850,1,20
155,280,1,156,9,859,409,90
156,280,1,157,9,868,1,90
157,280,1,158,2,870,1,20
158,280,1,159,8,878,244,80
159,280,1,160,8,886,130,80
160,280,1,161,5,891,1,50
161,280,1,162,6,897,1,60
162,280,1,163,9,906,1,90
163,280,1,164,3,909,1,30
164,280,1,165,7,916,1,70
165,280,1,166,3,919,1,30
166,280,1,167,7,926,1,70
167,280,1,168,7,933,1,70
168,280,1,169,8,941,1,80
169,280,1,170,5,946,1,50
170,280,1,171,9,955,1,90
171,280,1,172,7,962,557,70
172,280,1,173,3,965,1,30
173,280,1,174,7,972,1,70
174,280,1,175,9,981,1,90
175,280,1,176,6,987,1,60
176,280,1,177,8,995,392,80
177,280,1,178,9,1004,1,90
178,280,1,179,3,1007,1,30
179,280,1,180,2,1009,231,20
180,280,1,181,7,1016,122,70
181,280,1,182,9,1025,79,90
182,280,1,183,9,1034,1,90
183,280,1,184,6,1040,1,60
184,280,1,185,9,1049,1,90
185,280,1,186,4,1053,1,40
186,280,1,187,5,1058,277,50
187,280,1,188,2,1060,1,20
188,280,1,189,8,1068,1,80
189,280,1,190,6,1074,1,60
190,280,1,191,6,1080,1,60
191,280,1,192,4,1084,1,40
192,280,1,193,5,1089,1,50
193,280,1,194,6,1095,288,60
194,280,1,195,5,1100,1,50
195,280,1,196,2,1102,1,20
196,280,1,197,2,1104,140,20
197,280,1,198,3,1107,1,30
198,280,1,199,6,1113,1,60
199,280,1,200,6,1119,1,60
200,280,1,201,7,1126,1,70
201,280,1,202,2,1128,1,20
202,280,1,203,9,1137,1,90
203,280,1,204,4,1141,1,40
204,280,1,205,7,1148,1,70
205,280,1,206,3,1151,1,30
206,280,1,207,6,1157,1,60
207,280,1,208,2,1159,1,20
208,280,1,209,4,1163,1,40
209,280,1,210,9,1172,1,90
210,280,1,211,9,1181,1,90
211,280,1,212,2,1183,1,20
212,280,1,213,5,1188,618,50
213,280,1,214,6,1194,1,60
214,280,1,215,6,1200,1,60
215,280,1,216,4,1204,1,40
216,280,1,217,5,1209,1,50
217,280,1,218,7,1216,380,70
218,280,1,219,3,1219,1,30
219,280,1,220,8,1227,1,80
220,280,1,221,6,1233,1,60
221,280,1,222,6,1239,1,60
222,280,1,223,9,1248,1,90
223,280,1,224,3,1251,1,30
224,280,1,225,5,1256,1,50
225,280,1,226,2,1258,1,20
226,280,1,227,6,1264,1,60
227,280,1,228,4,1268,431,40
228,280,1,229,2,1270,1,20
229,280,1,230,8,1278,182,80
230,280,1,231,5,1283,1,50
231,280,1,232,3,1286,1,30
232,280,1,233,9,1295,184,90
233,280,1,234,3,1298,87,30
234,280,1,235,9,1307,1,90
235,280,1,236,3,1310,1,30
236,280,1,237,8,1318,1,80
237,280,1,238,5,1323,1,50
238,280,1,239,2,1325,228,20
239,280,1,240,7,1332,1,70
240,280,1,241,9,1341,1,90
241,280,1,242,2,1343,1,20
242,280,1,243,5,1348,1,50
243,280,1,244,6,1354,255,60
244,280,1,245,6,1360,1,60
245,280,1,246,5,1365,1,50
246,280,1,247,7,1372,1,70
247,280,1,248,6,1378,1,60
248,280,1,249,6,1384,1,60
249,280,1,250,4,1388,326,40
250,280,1,251,7,1395,1,70
251,280,1,252,5,1400,163,50
252,280,1,253,2,1402,1,20
253,280,1,254,9,1411,1,90
254,280,1,255,7,1418,1,70
255,280,1,256,4,1422,202,40
256,280,1,257,9,1431,1,90
257,280,1,258,3,1434,1,30
258,280,1,259,6,1440,1,60
259,280,1,260,3,1443,1,30
260,280,1,261,9,1452,1,90
261,280,1,262,6,1458,1,60
262,280,1,263,5,1463,1,50
263,280,1,264,4,1467,365,40
264,280,1,265,3,1470,1,30
265,280,1,266,2,1472,138,20
266,280,1,267,7,1479,1,70
267,280,1,268,3,1482,112,30
268,280,1,269,2,1484,63,20
269,280,1,270,8,1492,1,80
270,280,1,271,5,1497,95,50
271,280,1,272,4,1501,1,40
272,280,1,273,8,1509,1,80
273,280,1,274,9,1518,1,90
274,280,1,275,2,1520,1,20
275,280,1,276,7,1527,214,70
276,280,1,277,2,1529,1,20
277,280,1,278,9,1538,1,90
278,280,1,279,5,1543,176,50
279,280,1,280,2,1545,1,20
280,280,1,281,5,1550,1,50
281,280,1,282,6,1556,1,60
282,280,1,283,9,1565,1,90
283,280,1,284,5,1570,1,50
284,280,1,285,6,1576,1,60
285,280,1,286,8,1584,406,80
286,280,1,287,7,1591,1,70
287,280,1,288,2,1593,1,20
288,280,1,289,9,1602,1,90
289,280,1,290,4,1606,1,40
290,280,1,291,5,1611,1,50
291,280,1,292,3,1614,1,30
292,280,1,293,8,1622,1,80
293,280,1,294,5,1627,1,50
294,280,1,295,2,1629,1,20
295,280,1,296,8,1637,481,80
296,280,1,297,6,1643,1,60
297,280,1,298,5,1648,1,50
298,280,1,299,3,1651,1,30
299,280,1,300,5,1656,1,50
300,280,1,301,4,1660,1,40
301,280,1,302,2,1662,1,20
302,280,1,303,7,1669,1,70
303,280,1,304,8,1677,461,80
304,280,1,305,3,1680,1,30
305,280,1,306,7,1687,1,70
306,280,1,307,8,1695,1,80
307,280,1,308,4,1699,292,40
308,280,1,309,4,1703,1,40
309,280,1,310,2,1705,1,20
310,280,1,311,6,1711,138,60
311,280,1,312,4,1715,1,40
312,280,1,313,9,1724,1,90
313,280,1,314,6,1730,1,60
314,280,1,315,9,1739,1,90
315,280,1,316,8,1747,1,80
316,280,1,317,9,1756,331,90
317,280,1,318,7,1763,1,70
318,280,1,319,3,1766,1,30
319,280,1,320,9,1775,236,90
320,280,1,321,9,1784,142,90
321,280,1,322,9,1793,1,90
322,280,1,323,2,1795,1,20
323,280,1,324,9,1804,1,90
324,280,1,325,9,1813,1,90
325,280,1,326,3,1816,1,30
326,280,1,327,4,1820,1,40
327,280,1,328,3,1823,1,30
328,280,1,329,7,1830,1,70
329,280,1,330,3,1833,344,30
330,280,1,331,6,1839,147,60
331,280,1,332,9,1848,1,90
332,280,1,333,3,1851,1,30
333,280,1,334,7,1858,1,70
334,280,1,335,5,1863,1,50
335,280,1,336,8,1871,1,80
336,280,1,337,9,1880,1,90
337,280,1,338,5,1885,1,50
338,280,1,339,5,1890,1,50
339,280,1,340,4,1894,1,40
340,280,1,341,2,1896,1,20
341,280,1,342,5,1901,1,50
342,280,1,343,9,1910,1,90
343,280,1,344,4,1914,1,40
344,280,1,345,6,1920,1,60
345,280,1,346,7,1927,1,70
346,280,1,347,7,1934,694,70
347,280,1,348,4,1938,1,40
348,280,1,349,8,1946,1,80
349,280,1,350,5,1951,1,50
350,280,1,351,8,1959,366,80
351,280,1,352,5,1964,1,50
352,280,1,353,2,1966,1,20
353,280,1,354,5,1971,1,50
354,280,1,355,4,1975,1,40
355,280,1,356,3,1978,1,30
356,280,1,357,9,1987,298,90
357,280,1,358,3,1990,1,30
358,280,1,359,9,1999,1,90
359,280,1,360,3,2002,1,30
360,280,1,361,9,2011,1,90
361,280,1,362,9,2020,1,90
362,280,1,363,6,2026,1,60
363,280,1,364,6,2032,410,60
364,280,1,365,8,2040,172,80
365,280,1,366,9,2049,1,90
366,280,1,367,5,2054,1,50
367,280,1,368,9,2063,213,90
368,280,1,369,5,2068,1,50
369,280,1,370,2,2070,1,20
370,280,1,371,3,2073,111,30
371,280,1,372,4,2077,66,40
372,280,1,373,8,2085,1,80
373,280,1,374,7,2092,1,70
374,280,1,375,8,2100,1,80
375,280,1,376,8,2108,1,80
376,280,1,377,4,2112,1,40
377,280,1,378,2,2114,251,20
378,280,1,379,3,2117,1,30
379,280,1,380,6,2123,1,60
380,280,1,381,4,2127,1,40
381,280,1,382,2,2129,1,20
382,280,1,383,4,2133,1,40
383,280,1,384,3,2136,233,30
384,280,1,385,3,2139,90,30
385,280,1,386,5,2144,1,50
386,280,1,387,8,2152,1,80
387,280,1,388,6,2158,1,60
388,280,1,389,6,2164,1,60
389,280,1,390,9,2173,266,90
390,280,1,391,7,2180,1,70
391,280,1,392,3,2183,157,30
392,280,1,393,9,2192,1,90
393,280,1,394,7,2199,1,70
394,280,1,395,6,2205,1,60
395,280,1,396,9,2214,1,90
396,280,1,397,8,2222,1,80
397,280,1,398,5,2227,1,50
398,280,1,399,8,2235,1,80
399,280,1,400,9,2244,1,90
400,280,1,401,5,2249,1,50
401,280,1,402,8,2257,1,80
402,280,1,403,2,2259,1,20
403,280,1,404,6,2265,1,60
404,280,1,405,6,2271,1,60
405,280,1,406,6,2277,1,60
406,280,1,407,5,2282,1,50
407,280,1,408,6,2288,1,60
408,280,1,409,3,2291,1,30
409,280,1,410,6,2297,1,60
410,280,1,411,2,2299,1,20
411,280,1,412,5,2304,887,50
412,280,1,413,8,2312,328,80
413,280,1,414,7,2319,153,70
414,280,1,415,2,2321,1,20
415,280,1,416,8,2329,1,80
416,280,1,417,4,2333,1,40
417,280,1,418,4,2337,154,40
418,280,1,419,2,2339,61,20
419,280,1,420,6,2345,1,60
420,280,1,421,5,2350,1,50
421,280,1,422,5,2355,1,50
422,280,1,423,6,2361,1,60
423,280,1,424,6,2367,203,60
424,280,1,425,2,2369,68,20
425,280,1,426,4,2373,1,40
426,280,1,427,6,2379,84,60
427,280,1,428,2,2381,1,20
428,280,1,429,2,2383,1,20
429,280,1,430,8,2391,1,80
430,280,1,431,2,2393,1,20
431,280,1,432,4,2397,1,40
432,280,1,433,9,2406,1,90
433,280,1,434,5,2411,232,50
434,280,1,435,4,2415,1,40
435,280,1,436,3,2418,1,30
436,280,1,437,5,2423,153,50
437,280,1,438,2,2425,1,20
438,280,1,439,5,2430,88,50
439,280,1,440,6,2436,1,60
440,280,1,441,4,2440,87,40
441,280,1,442,8,2448,1,80
442,280,1,443,7,2455,129,70
443,280,1,444,9,2464,1,90
444,280,1,445,4,2468,1,40
445,280,1,446,9,2477,1,90
446,280,1,447,6,2483,1,60
447,280,1,448,4,2487,1,40
448,280,1,449,4,2491,297,40
449,280,1,450,7,2498,1,70
450,280,1,451,4,2502,1,40
451,280,1,452,8,2510,1,80
452,280,1,453,2,2512,229,20
453,280,1,454,4,2516,1,40
454,280,1,455,4,2520,1,40
455,280,1,456,3,2523,1,30
456,280,1,457,8,2531,189,80
457,280,1,458,3,2534,1,30
458,280,1,459,8,2542,1,80
459,280,1,460,4,2546,152,40
460,280,1,461,9,2555,119,90
461,280,1,462,9,2564,1,90
462,280,1,463,8,2572,1,80
463,280,1,464,7,2579,1,70
464,280,1,465,2,2581,1,20
465,280,1,466,8,2589,1,80
466,280,1,467,2,2591,1,20
467,280,1,468,4,2595,1,40
468,280,1,469,5,2600,1,50
469,280,1,470,5,2605,1,50
470,280,1,471,5,2610,437,50
471,280,1,472,3,2613,1,30
472,280,1,473,4,2617,1,40
473,280,1,474,8,2625,212,80
474,280,1,475,2,2627,1,20
475,280,1,476,8,2635,136,80
476,280,1,477,8,2643,1,80
477,280,1,478,2,2645,1,20
478,280,1,479,9,2654,1,90
479,280,1,480,3,2657,173,30
480,280,1,481,8,2665,127,80
481,280,1,482,4,2669,1,40
482,280,1,483,8,2677,1,80
483,280,1,484,5,2682,1,50
484,280,1,485,2,2684,1,20
485,280,1,486,6,2690,1,60
486,280,1,487,9,2699,1,90
487,280,1,488,7,2706,1,70
488,280,1,489,8,2714,1,80
489,280,1,490,6,2720,1,60
490,280,1,491,6,2726,1,60
491,280,1,492,3,2729,1,30
492,280,1,493,4,2733,1,40
493,280,1,494,9,2742,1,90
494,280,1,495,8,2750,1,80
495,280,1,496,8,2758,1,80
496,280,1,497,4,2762,1,40
497,280,1,498,2,2764,1,20
498,280,1,499,8,2772,1,80
499,280,1,500,4,2776,1,40
500,280,1,501,6,2782,1,60
501,280,1,502,9,2791,1,90
502,280,1,503,9,2800,1,90
503,280,1,504,8,2808,1,80
504,280,1,505,6,2814,1,60
505,280,1,506,6,2820,1,60
506,280,1,507,4,2824,1,40
507,280,1,508,3,2827,1,30
508,280,1,509,5,2832,1,50
509,280,1,510,6,2838,1,60
510,280,1,511,9,2847,1,90
511,280,1,512,9,2856,1,90
512,280,1,513,5,2861,1,50
513,280,1,514,8,2869,1,80
514,280,1,515,9,2878,1,90
515,280,1,516,3,2881,1,30
516,280,1,517,5,2886,1561,50
517,280,1,518,4,2890,1,40
518,280,1,519,2,2892,507,20
519,280,1,520,2,2894,1,20
520,280,1,521,9,2903,1,90
521,280,1,522,6,2909,1,60
522,280,1,523,9,2918,1,90
523,280,1,524,6,2924,346,60
524,280,1,525,5,2929,1,50
525,280,1,526,6,2935,1,60
526,280,1,527,4,2939,209,40
527,280,1,528,7,2946,119,70
528,280,1,529,5,2951,1,50
529,280,1,530,7,2958,1,70
530,280,1,531,3,2961,1,30
531,280,1,532,9,2970,1,90
532,280,1,533,2,2972,1,20
533,280,1,534,8,2980,1,80
534,280,1,535,6,2986,309,60
535,280,1,536,8,2994,1,80
536,280,1,537,6,3000,1,60
537,280,1,538,7,3007,1,70
538,280,1,539,7,3014,1,70
539,280,1,540,2,3016,1,20
540,280,1,541,8,3024,1,80
541,280,1,542,7,3031,1,70
542,280,1,543,8,3039,1,80
543,280,1,544,4,3043,468,40
544,280,1,545,4,3047,1,40
545,280,1,546,7,3054,1,70
546,280,1,547,8,3062,1,80
547,280,1,548,4,3066,1,40
548,280,1,549,6,3072,1,60
549,280,1,550,3,3075,1,30
550,280,1,551,5,3080,1,50
551,280,1,552,9,3089,444,90
552,280,1,553,2,3091,152,20
553,280,1,554,2,3093,50,20
554,280,1,555,6,3099,1,60
555,280,1,556,4,3103,1,40
556,280,1,557,2,3105,1,20
557,280,1,558,3,3108,1,30
558,280,1,559,3,3111,138,30
559,280,1,560,8,3119,1,80
560,280,1,561,3,3122,1,30
561,280,1,562,6,3128,1,60
562,280,1,563,3,3131,1,30
563,280,1,564,9,3140,1,90
564,280,1,565,3,3143,1,30
565,280,1,566,5,3148,1,50
566,280,1,567,9,3157,1,90
567,280,1,568,6,3163,1,60
568,280,1,569,5,3168,1,50
569,280,1,570,9,3177,514,90
570,280,1,571,3,3180,1,30
571,280,1,572,4,3184,206,40
572,280,1,573,5,3189,1,50
573,280,1,574,9,3198,1,90
574,280,1,575,3,3201,1,30
575,280,1,576,5,3206,1,50
576,280,1,577,9,3215,264,90
577,280,1,578,5,3220,1,50
578,280,1,579,6,3226,1,60
579,280,1,580,8,3234,213,80
580,280,1,581,9,3243,1,90
581,280,1,582,4,3247,1,40
582,280,1,583,3,3250,1,30
583,280,1,584,7,3257,236,70
584,280,1,585,9,3266,1,90
585,280,1,586,7,3273,1,70
586,280,1,587,8,3281,1,80
587,280,1,588,7,3288,1,70
588,280,1,589,9,3297,323,90
589,280,1,590,3,3300,105,30
590,280,1,591,6,3306,83,60
591,280,1,592,7,3313,63,70
592,280,1,593,9,3322,1,90
593,280,1,594,6,3328,96,60
594,280,1,595,2,3330,1,20
595,280,1,596,9,3339,1,90
596,280,1,597,3,3342,1,30
597,280,1,598,2,3344,134,20
598,280,1,599,2,3346,1,20
599,280,1,600,5,3351,1,50
600,280,1,601,5,3356,111,50
601,280,1,602,8,3364,1,80
602,280,1,603,7,3371,116,70
603,280,1,604,7,3378,1,70
604,280,1,605,3,3381,1,30
605,280,1,606,6,3387,161,60
606,280,1,607,2,3389,1,20
607,280,1,608,8,3397,1,80
608,280,1,609,6,3403,1,60
609,280,1,610,9,3412,1,90
610,280,1,611,2,3414,228,20
611,280,1,612,4,3418,1,40
612,280,1,613,5,3423,1,50
613,280,1,614,9,3432,1,90
614,280,1,615,3,3435,1,30
615,280,1,616,3,3438,1,30
616,280,1,617,6,3444,1,60
617,280,1,618,5,3449,1,50
618,280,1,619,3,3452,1,30
619,280,1,620,9,3461,1,90
620,280,1,621,8,3469,1,80
621,280,1,622,9,3478,1,90
622,280,1,623,6,3484,1,60
623,280,1,624,6,3490,1,60
624,280,1,625,6,3496,1,60
625,280,1,626,9,3505,1,90
626,280,1,627,4,3509,1,40
627,280,1,628,7,3516,1,70
628,280,1,629,9,3525,1,90
629,280,1,630,8,3533,921,80
630,280,1,631,7,3540,1,70
631,280,1,632,6,3546,1,60
632,280,1,633,4,3550,1,40
633,280,1,634,8,3558,421,80
634,280,1,635,8,3566,1,80
635,280,1,636,3,3569,1,30
636,280,1,637,5,3574,1,50
637,280,1,638,5,3579,1,50
638,280,1,639,3,3582,277,30
639,280,1,640,8,3590,149,80
640,280,1,641,7,3597,1,70
641,280,1,642,9,3606,152,90
642,280,1,643,5,3611,1,50
643,280,1,644,9,3620,1,90
644,280,1,645,9,3629,1,90
645,280,1,646,7,3636,1,70
646,280,1,647,4,3640,1,40
647,280,1,648,9,3649,1,90
648,280,1,649,5,3654,1,50
649,280,1,650,7,3661,423,70
650,280,1,651,6,3667,1,60
651,280,1,652,7,3674,1,70
652,280,1,653,8,3682,1,80
653,280,1,654,6,3688,1,60
654,280,1,655,9,3697,1,90
655,280,1,656,8,3705,1,80
656,280,1,657,3,3708,1,30
657,280,1,658,8,3716,463,80
658,280,1,659,7,3723,1,70
659,280,1,660,4,3727,1,40
660,280,1,661,5,3732,1,50
661,280,1,662,4,3736,1,40
662,280,1,663,6,3742,1,60
663,280,1,664,6,3748,1,60
664,280,1,665,5,3753,1,50
665,280,1,666,9,3762,438,90
666,280,1,667,8,3770,1,80
667,280,1,668,9,3779,283,90
668,280,1,669,5,3784,120,50
669,280,1,670,6,3790,73,60
670,280,1,671,9,3799,1,90
671,280,1,672,4,3803,1,40
672,280,1,673,4,3807,151,40
673,280,1,674,8,3815,1,80
674,280,1,675,4,3819,1,40
675,280,1,676,2,3821,130,20
676,280,1,677,6,3827,1,60
677,280,1,678,7,3834,1,70
678,280,1,679,4,3838,1,40
679,280,1,680,4,3842,1,40
680,280,1,681,6,3848,1,60
681,280,1,682,2,3850,1,20
682,280,1,683,4,3854,1,40
683,280,1,684,2,3856,1,20
684,280,1,685,4,3860,298,40
685,280,1,686,7,3867,120,70
686,280,1,687,8,3875,1,80
687,280,1,688,8,3883,1,80
688,280,1,689,9,3892,1,90
689,280,1,690,8,3900,1,80
690,280,1,691,2,3902,1,20
691,280,1,692,2,3904,297,20
692,280,1,693,3,3907,1,30
693,280,1,694,5,3912,1,50
694,280,1,695,5,3917,1,50
695,280,1,696,4,3921,1,40
696,280,1,697,6,3927,1,60
697,280,1,698,4,3931,1,40
698,280,1,699,5,3936,1,50
699,280,1,700,3,3939,348,30
700,280,1,701,9,3948,1,90
701,280,1,702,8,3956,1,80
702,280,1,703,5,3961,1,50
703,280,1,704,2,3963,1,20
704,280,1,705,8,3971,1,80
705,280,1,706,7,3978,1,70
706,280,1,707,3,3981,1,30
707,280,1,708,9,3990,1,90
708,280,1,709,3,3993,491,30
709,280,1,710,3,3996,150,30
710,280,1,711,8,4004,101,80
711,280,1,712,9,4013,1,90
712,280,1,713,4,4017,1,40
713,280,1,714,6,4023,1,60
714,280,1,715,5,4028,211,50
715,280,1,716,5,4033,1,50
716,280,1,717,5,4038,1,50
717,280,1,718,5,4043,1,50
718,280,1,719,4,4047,203,40
719,280,1,720,3,4050,1,30
720,280,1,721,3,4053,1,30
721,280,1,722,4,4057,1,40
722,280,1,723,2,4059,1,20
723,280,1,724,4,4063,1,40
724,280,1,725,7,4070,1,70
725,280,1,726,2,4072,244,20
726,280,1,727,3,4075,86,30
727,280,1,728,6,4081,52,60
728,280,1,729,6,4087,1,60
729,280,1,730,2,4089,90,20
730,280,1,731,5,4094,1,50
731,280,1,732,7,4101,1,70
732,280,1,733,9,4110,1,90
733,280,1,734,2,4112,1,20
734,280,1,735,9,4121,1,90
735,280,1,736,8,4129,1,80
736,280,1,737,5,4134,1,50
737,280,1,738,5,4139,1,50
738,280,1,739,2,4141,1,20
739,280,1,740,6,4147,437,60
740,280,1,741,3,4150,144,30
741,280,1,742,7,4157,1,70
742,280,1,743,9,4166,1,90
743,280,1,744,6,4172,1,60
744,280,1,745,9,4181,277,90
745,280,1,746,5,4186,1,50
746,280,1,747,3,4189,1,30
747,280,1,748,8,4197,1,80
748,280,1,749,6,4203,1,60
749,280,1,750,8,4211,1,80
750,280,1,751,4,4215,309,40
751,280,1,752,4,4219,113,40
752,280,1,753,4,4223,57,40
753,280,1,754,4,4227,1,40
754,280,1,755,8,4235,1,80
755,280,1,756,2,4237,1,20
756,280,1,757,8,4245,1,80
757,280,1,758,6,4251,209,60
758,280,1,759,9,4260,1,90
759,280,1,760,8,4268,1,80
760,280,1,761,3,4271,215,30
761,280,1,762,5,4276,1,50
762,280,1,763,5,4281,1,50
763,280,1,764,5,4286,160,50
764,280,1,765,7,4293,1,70
765,280,1,766,8,4301,141,80
766,280,1,767,5,4306,1,50
767,280,1,768,9,4315,149,90
768,280,1,769,9,4324,1,90
769,280,1,770,3,4327,139,30
770,280,1,771,5,4332,1,50
771,280,1,772,7,4339,1,70
772,280,1,773,4,4343,1,40
773,280,1,774,8,4351,1,80
774,280,1,775,5,4356,1,50
775,280,1,776,3,4359,1,30
776,280,1,777,9,4368,1,90
777,280,1,778,9,4377,390,90
778,280,1,779,9,4386,1,90
779,280,1,780,3,4389,1,30
780,280,1,781,9,4398,1,90
781,280,1,782,9,4407,1,90
782,280,1,783,5,4412,1,50
783,280,1,784,8,4420,408,80
784,280,1,785,6,4426,1,60
785,280,1,786,2,4428,152,20
786,280,1,787,8,4436,106,80
787,280,1,788,7,4443,1,70
788,280,1,789,7,4450,1,70
789,280,1,790,5,4455,1,50
790,280,1,791,7,4462,1,70
791,280,1,792,2,4464,245,20
792,280,1,793,2,4466,79,20
793,280,1,794,9,4475,82,90
794,280,1,795,5,4480,1,50
795,280,1,796,8,4488,110,80
796,280,1,797,9,4497,1,90
797,280,1,798,2,4499,1,20
798,280,1,799,9,4508,1,90
799,280,1,800,6,4514,1,60
800,280,1,801,4,4518,1,40
801,280,1,802,7,4525,311,70
802,280,1,803,3,4528,1,30
803,280,1,804,7,4535,1,70
804,280,1,805,9,4544,1,90
805,280,1,806,8,4552,1,80
806,280,1,807,6,4558,316,60
807,280,1,808,5,4563,1,50
808,280,1,809,5,4568,1,50
809,280,1,810,7,4575,1,70
810,280,1,811,4,4579,1,40
811,280,1,812,8,4587,1,80
812,280,1,813,3,4590,1,30
813,280,1,814,7,4597,1,70
814,280,1,815,4,4601,389,40
815,280,1,816,8,4609,1,80
816,280,1,817,2,4611,183,20
817,280,1,818,2,4613,1,20
818,280,1,819,9,4622,1,90
819,280,1,820,2,4624,1,20
820,280,1,821,6,4630,169,60
821,280,1,822,7,4637,1,70
822,280,1,823,4,4641,1,40
823,280,1,824,5,4646,1,50
824,280,1,825,9,4655,234,90
825,280,1,826,4,4659,1,40
826,280,1,827,3,4662,1,30
827,280,1,828,2,4664,1,20
828,280,1,829,9,4673,1,90
829,280,1,830,3,4676,1,30
830,280,1,831,4,4680,1,40
831,280,1,832,3,4683,1,30
832,280,1,833,2,4685,1,20
833,280,1,834,2,4687,256,20
834,280,1,835,6,4693,1,60
835,280,1,836,5,4698,1,50
836,280,1,837,9,4707,1,90
837,280,1,838,6,4713,1,60
838,280,1,839,2,4715,1,20
839,280,1,840,7,4722,1,70
840,280,1,841,5,4727,1,50
841,280,1,842,3,4730,1,30
842,280,1,843,9,4739,1,90
843,280,1,844,9,4748,1,90
844,280,1,845,7,4755,1,70
845,280,1,846,2,4757,1,20
846,280,1,847,3,4760,643,30
847,280,1,848,2,4762,184,20
848,280,1,849,8,4770,1,80
849,280,1,850,3,4773,149,30
850,280,1,851,6,4779,1,60
851,280,1,852,5,4784,1,50
852,280,1,853,5,4789,1,50
853,280,1,854,8,4797,1,80
854,280,1,855,2,4799,1,20
855,280,1,856,8,4807,1,80
856,280,1,857,4,4811,305,40
857,280,1,858,3,4814,1,30
858,280,1,859,6,4820,1,60
859,280,1,860,6,4826,199,60
860,280,1,861,5,4831,1,50
861,280,1,862,4,4835,1,40
862,280,1,863,2,4837,1,20
863,280,1,864,3,4840,1,30
864,280,1,865,9,4849,209,90
865,280,1,866,4,4853,103,40
866,280,1,867,4,4857,1,40
867,280,1,868,9,4866,1,90
868,280,1,869,6,4872,1,60
869,280,1,870,3,4875,1,30
870,280,1,871,8,4883,248,80
871,280,1,872,2,4885,1,20
872,280,1,873,9,4894,1,90
873,280,1,874,8,4902,233,80
874,280,1,875,2,4904,74,20
875,280,1,876,6,4910,1,60
876,280,1,877,8,4918,1,80
877,280,1,878,2,4920,1,20
878,280,1,879,2,4922,1,20
879,280,1,880,2,4924,1,20
880,280,1,881,7,4931,1,70
881,280,1,882,6,4937,1,60
882,280,1,883,5,4942,1,50
883,280,1,884,9,4951,1,90
884,280,1,885,4,4955,1,40
885,280,1,886,7,4962,409,70
886,280,1,887,4,4966,140,40
887,280,1,888,9,4975,107,90
888,280,1,889,8,4983,1,80
889,280,1,890,8,4991,136,80
890,280,1,891,2,4993,1,20
891,280,1,892,6,4999,81,60
892,280,2,1,3,3,28,30
893,280,2,2,4,7,29,40
894,280,2,3,7,14,1,70
895,280,2,4,2,16,60,20
896,280,2,5,6,22,1,60
897,280,2,6,6,28,1,60
898,280,2,7,9,37,1,90
899,280,2,8,4,41,1,40
900,280,2,9,5,46,1,50
901,280,2,10,8,54,1,80
902,280,2,11,5,59,1,50
903,280,2,12,9,68,1,90
904,280,2,13,8,76,442,80
905,280,2,14,3,79,150,30
906,280,2,15,8,87,1,80
907,280,2,16,3,90,1,30
908,280,2,17,9,99,1,90
909,280,2,18,9,108,1,90
910,280,2,19,9,117,1,90
911,280,2,20,7,124,1,70
912,280,2,21,2,126,1,20
913,280,2,22,6,132,1,60
914,280,2,23,9,141,1,90
915,280,2,24,6,147,1,60
916,280,2,25,2,149,522,20
917,280,2,26,7,156,1,70
918,280,2,27,2,158,1,20
919,280,2,28,3,161,1,30
920,280,2,29,6,167,269,60
921,280,2,30,3,170,112,30
922,280,2,31,6,176,1,60
923,280,2,32,3,179,1,30
924,280,2,33,5,184,1,50
925,280,2,34,4,188,1,40
926,280,2,35,3,191,159,30
927,280,2,36,4,195,1,40
928,280,2,37,2,197,85,20
929,280,2,38,2,199,1,20
930,280,2,39,7,206,1,70
931,280,2,40,4,210,1,40
932,280,2,41,9,219,193,90
933,280,2,42,7,226,1,70
934,280,2,43,3,229,1,30
935,280,2,44,7,236,1,70
936,280,2,45,9,245,1,90
937,280,2,46,4,249,263,40
938,280,2,47,6,255,1,60
939,280,2,48,4,259,1,40
940,280,2,49,4,263,1,40
941,280,2,50,8,271,1,80
942,280,2,51,3,274,1,30
943,280,2,52,8,282,269,80
944,280,2,53,6,288,1,60
945,280,2,54,5,293,1,50
946,280,2,55,9,302,224,90
947,280,2,56,8,310,1,80
948,280,2,57,4,314,1,40
949,280,2,58,2,316,1,20
950,280,2,59,2,318,1,20
951,280,2,60,4,322,1,40
952,280,2,61,9,331,266,90
953,280,2,62,7,338,139,70
954,280,2,63,8,346,1,80
955,280,2,64,5,351,1,50
956,280,2,65,9,360,1,90
957,280,2,66,8,368,1,80
958,280,2,67,3,371,1,30
959,280,2,68,4,375,314,40
960,280,2,69,3,378,113,30
961,280,2,70,2,380,53,20
962,280,2,71,6,386,50,60
963,280,2,72,8,394,74,80
964,280,2,73,2,396,1,20
965,280,2,74,6,402,91,60
966,280,2,75,6,408,63,60
967,280,2,76,2,410,32,20
968,280,2,77,8,418,1,80
969,280,2,78,7,425,132,70
970,280,2,79,9,434,1,90
971,280,2,80,3,437,1,30
972,280,2,81,4,441,1,40
973,280,2,82,3,444,154,30
974,280,2,83,7,451,99,70
975,280,2,84,5,456,1,50
976,280,2,85,8,464,1,80
977,280,2,86,5,469,1,50
978,280,2,87,6,475,214,60
979,280,2,88,9,484,130,90
980,280,2,89,4,488,50,40
981,280,2,90,9,497,1,90
982,280,2,91,6,503,148,60
983,280,2,92,6,509,82,60
984,280,2,93,7,516,1,70
985,280,2,94,5,521,103,50
986,280,2,95,3,524,1,30
987,280,2,96,7,531,1,70
988,280,2,97,8,539,1,80
989,280,2,98,8,547,1,80
990,280,2,99,4,551,1,40
991,280,2,100,7,558,274,70
992,280,2,101,8,566,167,80
993,280,2,102,9,575,98,90
994,280,2,103,7,582,1,70
995,280,2,104,3,585,1,30
996,280,2,105,4,589,1,40
997,280,2,106,4,593,1,40
998,280,2,107,4,597,1,40
999,280,2,108,7,604,229,70
1000,280,2,109,2,606,1,20
1001,280,2,110,7,613,112,70
1002,280,2,111,7,620,100,70
1003,280,2,112,9,629,1,90
1004,280,2,113,5,634,126,50
1005,280,2,114,4,638,64,40
1006,280,2,115,7,645,1,70
1007,280,2,116,3,648,1,30
1008,280,2,117,8,656,1,80
1009,280,2,118,8,664,1,80
1010,280,2,119,6,670,1,60
1011,280,2,120,8,678,1,80
1012,280,2,121,5,683,1,50
1013,280,2,122,4,687,1,40
1014,280,2,123,4,691,1,40
1015,280,2,124,8,699,1,80
1016,280,2,125,9,708,1,90
1017,280,2,126,3,711,522,30
1018,280,2,127,6,717,1,60
1019,280,2,128,8,725,1,80
1020,280,2,129,7,732,1,70
1021,280,2,130,9,741,391,90
1022,280,2,131,4,745,1,40
1023,280,2,132,2,747,1,20
1024,280,2,133,9,756,1,90
1025,280,2,134,7,763,1,70
1026,280,2,135,4,767,1,40
1027,280,2,136,4,771,1,40
1028,280,2,137,6,777,365,60
1029,280,2,138,9,786,1,90
1030,280,2,139,9,795,237,90
1031,280,2,140,7,802,1,70
1032,280,2,141,4,806,133,40
1033,280,2,142,3,809,1,30
1034,280,2,143,3,812,1,30
1035,280,2,144,8,820,1,80
1036,280,2,145,2,822,155,20
1037,280,2,146,7,829,91,70
1038,280,2,147,6,835,1,60
1039,280,2,148,9,844,1,90
1040,280,2,149,8,852,182,80
1041,280,2,150,2,854,1,20
1042,280,2,151,3,857,1,30
1043,280,2,152,3,860,1,30
1044,280,2,153,4,864,1,40
1045,280,2,154,5,869,1,50
1046,280,2,155,9,878,257,90
1047,280,2,156,9,887,1,90
1048,280,2,157,8,895,1,80
1049,280,2,158,4,899,230,40
1050,280,2,159,5,904,1,50
1051,280,2,160,9,913,1,90
1052,280,2,161,6,919,1,60
1053,280,2,162,6,925,1,60
1054,280,2,163,7,932,307,70
1055,280,2,164,5,937,1,50
1056,280,2,165,4,941,1,40
1057,280,2,166,3,944,1,30
1058,280,2,167,3,947,1,30
1059,280,2,168,9,956,1,90
1060,280,2,169,6,962,1,60
1061,280,2,170,3,965,1,30
1062,280,2,171,5,970,1,50
1063,280,2,172,8,978,1,80
1064,280,2,173,6,984,1,60
1065,280,2,174,9,993,1,90
1066,280,2,175,9,1002,1,90
1067,280,2,176,3,1005,1,30
1068,280,2,177,7,1012,1,70
1069,280,2,178,4,1016,1,40
1070,280,2,179,4,1020,668,40
1071,280,2,180,6,1026,1,60
1072,280,2,181,6,1032,1,60
1073,280,2,182,2,1034,1,20
1074,280,2,183,6,1040,1,60
1075,280,2,184,8,1048,1,80
1076,280,2,185,5,1053,1,50
1077,280,2,186,4,1057,1,40
1078,280,2,187,7,1064,1,70
1079,280,2,188,2,1066,513,20
1080,280,2,189,6,1072,1,60
1081,280,2,190,2,1074,1,20
1082,280,2,191,9,1083,1,90
1083,280,2,192,7,1090,313,70
1084,280,2,193,3,1093,111,30
1085,280,2,194,7,1100,1,70
1086,280,2,195,4,1104,1,40
1087,280,2,196,8,1112,1,80
1088,280,2,197,3,1115,190,30
1089,280,2,198,9,1124,1,90
1090,280,2,199,7,1131,142,70
1091,280,2,200,7,1138,1,70
1092,280,2,201,9,1147,1,90
1093,280,2,202,9,1156,1,90
1094,280,2,203,9,1165,1,90
1095,280,2,204,8,1173,1,80
1096,280,2,205,8,1181,1,80
1097,280,2,206,7,1188,1,70
1098,280,2,207,9,1197,503,90
1099,280,2,208,6,1203,1,60
1100,280,2,209,9,1212,219,90
1101,280,2,210,2,1214,100,20
1102,280,2,211,3,1217,1,30
1103,280,2,212,8,1225,1,80
1104,280,2,213,8,1233,155,80
1105,280,2,214,2,1235,45,20
1106,280,2,215,2,1237,35,20
1107,280,2,216,4,1241,1,40
1108,280,2,217,2,1243,1,20
1109,280,2,218,9,1252,1,90
1110,280,2,219,9,1261,178,90
1111,280,2,220,7,1268,1,70
1112,280,2,221,5,1273,1,50
1113,280,2,222,7,1280,1,70
1114,280,2,223,5,1285,1,50
1115,280,2,224,8,1293,281,80
1116,280,2,225,5,1298,124,50
1117,280,2,226,4,1302,1,40
1118,280,2,227,5,1307,1,50
1119,280,2,228,3,1310,1,30
1120,280,2,229,7,1317,1,70
1121,280,2,230,6,1323,1,60
1122,280,2,231,4,1327,1,40
1123,280,2,232,7,1334,1,70
1124,280,2,233,9,1343,349,90
1125,280,2,234,9,1352,1,90
1126,280,2,235,6,1358,227,60
1127,280,2,236,3,1361,1,30
1128,280,2,237,9,1370,1,90
1129,280,2,238,4,1374,1,40
1130,280,2,239,6,1380,1,60
1131,280,2,240,6,1386,1,60
1132,280,2,241,7,1393,279,70
1133,280,2,242,6,1399,1,60
1134,280,2,243,5,1404,162,50
1135,280,2,244,6,1410,89,60
1136,280,2,245,5,1415,65,50
1137,280,2,246,5,1420,1,50
1138,280,2,247,3,1423,77,30
1139,280,2,248,2,1425,1,20
1140,280,2,249,2,1427,1,20
1141,280,2,250,7,1434,1,70
1142,280,2,251,6,1440,1,60
1143,280,2,252,5,1445,1,50
1144,280,2,253,4,1449,1,40
1145,280,2,254,5,1454,1,50
1146,280,2,255,8,1462,1,80
1147,280,2,256,7,1469,1,70
1148,280,2,257,6,1475,1,60
1149,280,2,258,5,1480,1,50
1150,280,2,259,5,1485,1,50
1151,280,2,260,3,1488,1,30
1152,280,2,261,9,1497,1,90
1153,280,2,262,9,1506,1,90
1154,280,2,263,5,1511,1,50
1155,280,2,264,9,1520,1,90
1156,280,2,265,6,1526,1,60
1157,280,2,266,4,1530,1,40
1158,280,2,267,6,1536,771,60
1159,280,2,268,2,1538,1,20
1160,280,2,269,4,1542,1,40
1161,280,2,270,7,1549,332,70
1162,280,2,271,4,1553,1,40
1163,280,2,272,6,1559,1,60
1164,280,2,273,3,1562,1,30
1165,280,2,274,2,1564,202,20
1166,280,2,275,2,1566,1,20
1167,280,2,276,6,1572,115,60
1168,280,2,277,4,1576,1,40
1169,280,2,278,6,1582,96,60
1170,280,2,279,4,1586,1,40
1171,280,2,280,8,1594,1,80
1172,280,2,281,8,1602,1,80
1173,280,2,282,4,1606,1,40
1174,280,2,283,3,1609,1,30
1175,280,2,284,6,1615,1,60
1176,280,2,285,5,1620,1,50
1177,280,2,286,8,1628,1,80
1178,280,2,287,6,1634,374,60
1179,280,2,288,5,1639,154,50
1180,280,2,289,3,1642,1,30
1181,280,2,290,8,1650,1,80
1182,280,2,291,9,1659,1,90
1183,280,2,292,5,1664,1,50
1184,280,2,293,7,1671,1,70
1185,280,2,294,9,1680,1,90
1186,280,2,295,9,1689,402,90
1187,280,2,296,4,1693,1,40
1188,280,2,297,6,1699,1,60
1189,280,2,298,5,1704,1,50
1190,280,2,299,5,1709,1,50
1191,280,2,300,2,1711,1,20
1192,280,2,301,9,1720,388,90
1193,280,2,302,9,1729,1,90
1194,280,2,303,3,1732,1,30
1195,280,2,304,5,1737,1,50
1196,280,2,305,6,1743,1,60
1197,280,2,306,9,1752,1,90
1198,280,2,307,4,1756,1,40
1199,280,2,308,7,1763,355,70
1200,280,2,309,4,1767,141,40
1201,280,2,310,5,1772,74,50
1202,280,2,311,2,1774,1,20
1203,280,2,312,4,1778,1,40
1204,280,2,313,3,1781,1,30
1205,280,2,314,3,1784,111,30
1206,280,2,315,7,1791,1,70
1207,280,2,316,2,1793,1,20
1208,280,2,317,7,1800,1,70
1209,280,2,318,9,1809,1,90
1210,280,2,319,7,1816,1,70
1211,280,2,320,2,1818,1,20
1212,280,2,321,9,1827,349,90
1213,280,2,322,9,1836,1,90
1214,280,2,323,9,1845,1,90
1215,280,2,324,5,1850,1,50
1216,280,2,325,4,1854,1,40
1217,280,2,326,8,1862,1,80
1218,280,2,327,9,1871,1,90
1219,280,2,328,8,1879,1,80
1220,280,2,329,3,1882,1,30
1221,280,2,330,3,1885,1,30
1222,280,2,331,8,1893,1,80
1223,280,2,332,8,1901,1,80
1224,280,2,333,5,1906,1,50
1225,280,2,334,5,1911,1,50
1226,280,2,335,4,1915,731,40
1227,280,2,336,9,1924,1,90
1228,280,2,337,2,1926,1,20
1229,280,2,338,7,1933,329,70
1230,280,2,339,9,1942,1,90
1231,280,2,340,2,1944,1,20
1232,280,2,341,4,1948,201,40
1233,280,2,342,6,1954,1,60
1234,280,2,343,5,1959,144,50
1235,280,2,344,4,1963,1,40
1236,280,2,345,8,1971,1,80
1237,280,2,346,9,1980,1,90
1238,280,2,347,5,1985,221,50
1239,280,2,348,9,1994,1,90
1240,280,2,349,7,2001,1,70
1241,280,2,350,5,2006,1,50
1242,280,2,351,7,2013,1,70
1243,280,2,352,2,2015,1,20
1244,280,2,353,5,2020,1,50
1245,280,2,354,8,2028,387,80
1246,280,2,355,4,2032,1,40
1247,280,2,356,6,2038,1,60
1248,280,2,357,9,2047,1,90
1249,280,2,358,9,2056,1,90
1250,280,2,359,2,2058,1,20
1251,280,2,360,8,2066,1,80
1252,280,2,361,7,2073,1,70
1253,280,2,362,7,2080,1,70
1254,280,2,363,8,2088,1,80
1255,280,2,364,5,2093,1,50
1256,280,2,365,6,2099,1,60
1257,280,2,366,8,2107,1,80
1258,280,2,367,4,2111,706,40
1259,280,2,368,7,2118,1,70
1260,280,2,369,8,2126,1,80
1261,280,2,370,7,2133,1,70
1262,280,2,371,2,2135,1,20
1263,280,2,372,3,2138,1,30
1264,280,2,373,3,2141,1,30
1265,280,2,374,3,2144,1,30
1266,280,2,375,7,2151,495,70
1267,280,2,376,6,2157,1,60
1268,280,2,377,5,2162,1,50
1269,280,2,378,9,2171,1,90
1270,280,2,379,9,2180,1,90
1271,280,2,380,4,2184,1,40
1272,280,2,381,5,2189,401,50
1273,280,2,382,8,2197,1,80
1274,280,2,383,2,2199,1,20
1275,280,2,384,6,2205,1,60
1276,280,2,385,7,2212,1,70
1277,280,2,386,8,2220,1,80
1278,280,2,387,2,2222,1,20
1279,280,2,388,5,2227,1,50
1280,280,2,389,4,2231,1,40
1281,280,2,390,5,2236,1,50
1282,280,2,391,9,2245,1,90
1283,280,2,392,6,2251,557,60
1284,280,2,393,7,2258,1,70
1285,280,2,394,7,2265,1,70
1286,280,2,395,7,2272,1,70
1287,280,2,396,8,2280,1,80
1288,280,2,397,2,2282,396,20
1289,280,2,398,8,2290,184,80
1290,280,2,399,8,2298,1,80
1291,280,2,400,6,2304,146,60
1292,280,2,401,5,2309,72,50
1293,280,2,402,9,2318,1,90
1294,280,2,403,7,2325,153,70
1295,280,2,404,3,2328,1,30
1296,280,2,405,6,2334,94,60
1297,280,2,406,6,2340,1,60
1298,280,2,407,5,2345,109,50
1299,280,2,408,7,2352,1,70
1300,280,2,409,3,2355,109,30
1301,280,2,410,9,2364,1,90
1302,280,2,411,5,2369,139,50
1303,280,2,412,5,2374,1,50
1304,280,2,413,9,2383,1,90
1305,280,2,414,9,2392,1,90
1306,280,2,415,9,2401,1,90
1307,280,2,416,2,2403,1,20
1308,280,2,417,7,2410,1,70
1309,280,2,418,6,2416,1,60
1310,280,2,419,8,2424,1,80
1311,280,2,420,8,2432,1,80
1312,280,2,421,3,2435,1,30
1313,280,2,422,8,2443,571,80
1314,280,2,423,2,2445,1,20
1315,280,2,424,2,2447,1,20
1316,280,2,425,9,2456,1,90
1317,280,2,426,5,2461,1,50
1318,280,2,427,4,2465,1,40
1319,280,2,428,6,2471,1,60
1320,280,2,429,5,2476,1,50
1321,280,2,430,3,2479,1,30
1322,280,2,431,7,2486,462,70
1323,280,2,432,3,2489,1,30
1324,280,2,433,4,2493,1,40
1325,280,2,434,9,2502,1,90
1326,280,2,435,6,2508,277,60
1327,280,2,436,5,2513,1,50
1328,280,2,437,6,2519,147,60
1329,280,2,438,6,2525,1,60
1330,280,2,439,9,2534,1,90
1331,280,2,440,6,2540,1,60
1332,280,2,441,8,2548,1,80
1333,280,2,442,5,2553,1,50
1334,280,2,443,4,2557,1,40
1335,280,2,444,2,2559,1,20
1336,280,2,445,9,2568,375,90
1337,280,2,446,9,2577,1,90
1338,280,2,447,2,2579,1,20
1339,280,2,448,8,2587,238,80
1340,280,2,449,8,2595,1,80
1341,280,2,450,2,2597,1,20
1342,280,2,451,6,2603,1,60
1343,280,2,452,8,2611,1,80
1344,280,2,453,5,2616,1,50
1345,280,2,454,8,2624,329,80
1346,280,2,455,5,2629,1,50
1347,280,2,456,9,2638,188,90
1348,280,2,457,7,2645,1,70
1349,280,2,458,8,2653,163,80
1350,280,2,459,7,2660,1,70
1351,280,2,460,8,2668,177,80
1352,280,2,461,9,2677,1,90
1353,280,2,462,3,2680,1,30
1354,280,2,463,8,2688,1,80
1355,280,2,464,3,2691,182,30
1356,280,2,465,2,2693,70,20
1357,280,2,466,2,2695,1,20
1358,280,2,467,9,2704,1,90
1359,280,2,468,8,2712,1,80
1360,280,2,469,2,2714,169,20
1361,280,2,470,5,2719,1,50
1362,280,2,471,8,2727,123,80
1363,280,2,472,4,2731,1,40
1364,280,2,473,9,2740,1,90
1365,280,2,474,8,2748,182,80
1366,280,2,475,4,2752,1,40
1367,280,2,476,3,2755,1,30
1368,280,2,477,5,2760,1,50
1369,280,2,478,9,2769,1,90
1370,280,2,479,4,2773,1,40
1371,280,2,480,3,2776,262,30
1372,280,2,481,5,2781,1,50
1373,280,2,482,3,2784,1,30
1374,280,2,483,6,2790,1,60
1375,280,2,484,8,2798,217,80
1376,280,2,485,2,2800,1,20
1377,280,2,486,4,2804,1,40
1378,280,2,487,4,2808,1,40
1379,280,2,488,2,2810,158,20
1380,280,2,489,6,2816,1,60
1381,280,2,490,6,2822,1,60
1382,280,2,491,2,2824,155,20
1383,280,2,492,3,2827,1,30
1384,280,2,493,7,2834,1,70
1385,280,2,494,5,2839,1,50
1386,280,2,495,7,2846,188,70
1387,280,2,496,8,2854,1,80
1388,280,2,497,5,2859,166,50
1389,280,2,498,8,2867,1,80
1390,280,2,499,6,2873,138,60
1391,280,2,500,8,2881,1,80
1392,280,2,501,6,2887,1,60
1393,280,2,502,9,2896,1,90
1394,280,2,503,4,2900,1,40
1395,280,2,504,3,2903,1,30
1396,280,2,505,2,2905,1,20
1397,280,2,506,3,2908,1,30
1398,280,2,507,4,2912,1,40
1399,280,2,508,9,2921,1,90
1400,280,2,509,9,2930,1,90
1401,280,2,510,4,2934,1,40
1402,280,2,511,4,2938,1,40
1403,280,2,512,2,2940,1,20
1404,280,2,513,6,2946,1,60
1405,280,2,514,5,2951,1,50
1406,280,2,515,8,2959,671,80
1407,280,2,516,7,2966,253,70
1408,280,2,517,4,2970,1,40
1409,280,2,518,9,2979,1,90
1410,280,2,519,7,2986,1,70
1411,280,2,520,3,2989,1,30
1412,280,2,521,7,2996,1,70
1413,280,2,522,8,3004,1,80
1414,280,2,523,5,3009,1,50
1415,280,2,524,8,3017,409,80
1416,280,2,525,6,3023,1,60
1417,280,2,526,3,3026,1,30
1418,280,2,527,5,3031,1,50
1419,280,2,528,4,3035,255,40
1420,280,2,529,2,3037,1,20
1421,280,2,530,9,3046,153,90
1422,280,2,531,5,3051,1,50
1423,280,2,532,8,3059,1,80
1424,280,2,533,2,3061,136,20
1425,280,2,534,8,3069,113,80
1426,280,2,535,2,3071,42,20
1427,280,2,536,5,3076,1,50
1428,280,2,537,4,3080,68,40
1429,280,2,538,4,3084,1,40
1430,280,2,539,2,3086,1,20
1431,280,2,540,8,3094,1,80
1432,280,2,541,9,3103,1,90
1433,280,2,542,4,3107,1,40
1434,280,2,543,9,3116,275,90
1435,280,2,544,2,3118,80,20
1436,280,2,545,3,3121,1,30
1437,280,2,546,8,3129,1,80
1438,280,2,547,9,3138,1,90
1439,280,2,548,6,3144,1,60
1440,280,2,549,4,3148,1,40
1441,280,2,550,3,3151,1,30
1442,280,2,551,8,3159,317,80
1443,280,2,552,7,3166,143,70
1444,280,2,553,7,3173,1,70
1445,280,2,554,4,3177,1,40
1446,280,2,555,3,3180,1,30
1447,280,2,556,3,3183,1,30
1448,280,2,557,4,3187,1,40
1449,280,2,558,3,3190,213,30
1450,280,2,559,6,3196,1,60
1451,280,2,560,4,3200,118,40
1452,280,2,561,7,3207,1,70
1453,280,2,562,4,3211,1,40
1454,280,2,563,5,3216,1,50
1455,280,2,564,7,3223,209,70
1456,280,2,565,3,3226,1,30
1457,280,2,566,4,3230,1,40
1458,280,2,567,3,3233,1,30
1459,280,2,568,4,3237,1,40
1460,280,2,569,2,3239,1,20
1461,280,2,570,2,3241,1,20
1462,280,2,571,5,3246,1,50
1463,280,2,572,5,3251,1,50
1464,280,2,573,7,3258,327,70
1465,280,2,574,4,3262,117,40
1466,280,2,575,5,3267,1,50
1467,280,2,576,9,3276,1,90
1468,280,2,577,3,3279,1,30
1469,280,2,578,4,3283,1,40
1470,280,2,579,2,3285,1,20
1471,280,2,580,7,3292,1,70
1472,280,2,581,9,3301,1,90
1473,280,2,582,6,3307,1,60
1474,280,2,583,7,3314,1,70
1475,280,2,584,3,3317,414,30
1476,280,2,585,3,3320,141,30
1477,280,2,586,4,3324,1,40
1478,280,2,587,4,3328,110,40
1479,280,2,588,8,3336,1,80
1480,280,2,589,8,3344,142,80
1481,280,2,590,8,3352,1,80
1482,280,2,591,3,3355,1,30
1483,280,2,592,3,3358,1,30
1484,280,2,593,3,3361,172,30
1485,280,2,594,3,3364,1,30
1486,280,2,595,4,3368,1,40
1487,280,2,596,8,3376,148,80
1488,280,2,597,4,3380,1,40
1489,280,2,598,9,3389,1,90
1490,280,2,599,9,3398,1,90
1491,280,2,600,8,3406,1,80
1492,280,2,601,8,3414,301,80
1493,280,2,602,7,3421,1,70
1494,280,2,603,4,3425,1,40
1495,280,2,604,7,3432,1,70
1496,280,2,605,3,3435,1,30
1497,280,2,606,5,3440,264,50
1498,280,2,607,3,3443,1,30
1499,280,2,608,2,3445,1,20
1500,280,2,609,4,3449,1,40
1501,280,2,610,4,3453,1,40
1502,280,2,611,6,3459,1,60
1503,280,2,612,8,3467,1,80
1504,280,2,613,2,3469,1,20
1505,280,2,614,2,3471,310,20
1506,280,2,615,2,3473,109,20
1507,280,2,616,6,3479,1,60
1508,280,2,617,6,3485,1,60
1509,280,2,618,7,3492,175,70
1510,280,2,619,4,3496,1,40
1511,280,2,620,3,3499,1,30
1512,280,2,621,4,3503,129,40
1513,280,2,622,3,3506,1,30
1514,280,2,623,3,3509,1,30
1515,280,2,624,8,3517,1,80
1516,280,2,625,2,3519,1,20
1517,280,2,626,7,3526,1,70
1518,280,2,627,5,3531,245,50
1519,280,2,628,5,3536,1,50
1520,280,2,629,7,3543,1,70
1521,280,2,630,9,3552,1,90
1522,280,2,631,3,3555,1,30
1523,280,2,632,6,3561,1,60
1524,280,2,633,5,3566,1,50
1525,280,2,634,9,3575,1,90
1526,280,2,635,4,3579,1,40
1527,280,2,636,7,3586,415,70
1528,280,2,637,3,3589,1,30
1529,280,2,638,6,3595,1,60
1530,280,2,639,2,3597,202,20
1531,280,2,640,9,3606,1,90
1532,280,2,641,3,3609,1,30
1533,280,2,642,9,3618,1,90
1534,280,2,643,9,3627,258,90
1535,280,2,644,7,3634,1,70
1536,280,2,645,5,3639,147,50
1537,280,2,646,6,3645,1,60
1538,280,2,647,8,3653,1,80
1539,280,2,648,2,3655,1,20
1540,280,2,649,7,3662,238,70
1541,280,2,650,8,3670,1,80
1542,280,2,651,5,3675,1,50
1543,280,2,652,5,3680,1,50
1544,280,2,653,6,3686,248,60
1545,280,2,654,5,3691,1,50
1546,280,2,655,9,3700,173,90
1547,280,2,656,7,3707,1,70
1548,280,2,657,6,3713,1,60
1549,280,2,658,3,3716,1,30
1550,280,2,659,5,3721,1,50
1551,280,2,660,3,3724,253,30
1552,280,2,661,6,3730,1,60
1553,280,2,662,2,3732,1,20
1554,280,2,663,8,3740,1,80
1555,280,2,664,4,3744,1,40
1556,280,2,665,5,3749,1,50
1557,280,2,666,9,3758,1,90
1558,280,2,667,8,3766,1,80
1559,280,2,668,4,3770,1,40
1560,280,2,669,9,3779,456,90
1561,280,2,670,2,3781,1,20
1562,280,2,671,5,3786,1,50
1563,280,2,672,3,3789,1,30
1564,280,2,673,4,3793,1,40
1565,280,2,674,8,3801,1,80
1566,280,2,675,2,3803,1,20
1567,280,2,676,5,3808,1,50
1568,280,2,677,8,3816,1,80
1569,280,2,678,3,3819,1,30
1570,280,2,679,2,3821,1,20
1571,280,2,680,8,3829,458,80
1572,280,2,681,8,3837,1,80
1573,280,2,682,8,3845,1,80
1574,280,2,683,2,3847,302,20
1575,280,2,684,8,3855,1,80
1576,280,2,685,7,3862,194,70
1577,280,2,686,6,3868,1,60
1578,280,2,687,4,3872,1,40
1579,280,2,688,8,3880,1,80
1580,280,2,689,6,3886,1,60
1581,280,2,690,7,3893,255,70
1582,280,2,691,8,3901,1,80
1583,280,2,692,5,3906,1,50
1584,280,2,693,5,3911,1,50
1585,280,2,694,8,3919,1,80
1586,280,2,695,4,3923,1,40
1587,280,2,696,4,3927,1,40
1588,280,2,697,9,3936,1,90
1589,280,2,698,3,3939,1,30
1590,280,2,699,5,3944,1,50
1591,280,2,700,5,3949,1,50
1592,280,2,701,8,3957,494,80
1593,280,2,702,3,3960,1,30
1594,280,2,703,8,3968,211,80
1595,280,2,704,7,3975,1,70
1596,280,2,705,4,3979,149,40
1597,280,2,706,7,3986,1,70
1598,280,2,707,5,3991,1,50
1599,280,2,708,6,3997,155,60
1600,280,2,709,8,4005,1,80
1601,280,2,710,2,4007,1,20
1602,280,2,711,9,4016,1,90
1603,280,2,712,4,4020,199,40
1604,280,2,713,3,4023,1,30
1605,280,2,714,9,4032,1,90
1606,280,2,715,3,4035,1,30
1607,280,2,716,6,4041,1,60
1608,280,2,717,8,4049,1,80
1609,280,2,718,9,4058,1,90
1610,280,2,719,7,4065,1,70
1611,280,2,720,3,4068,1,30
1612,280,2,721,3,4071,403,30
1613,280,2,722,8,4079,1,80
1614,280,2,723,7,4086,251,70
1615,280,2,724,4,4090,1,40
1616,280,2,725,8,4098,1,80
1617,280,2,726,3,4101,1,30
1618,280,2,727,6,4107,1,60
1619,280,2,728,5,4112,1,50
1620,280,2,729,5,4117,1,50
1621,280,2,730,2,4119,290,20
1622,280,2,731,9,4128,1,90
1623,280,2,732,4,4132,1,40
1624,280,2,733,4,4136,211,40
1625,280,2,734,3,4139,1,30
1626,280,2,735,8,4147,144,80
1627,280,2,736,6,4153,1,60
1628,280,2,737,9,4162,1,90
1629,280,2,738,6,4168,1,60
1630,280,2,739,3,4171,1,30
1631,280,2,740,3,4174,1,30
1632,280,2,741,9,4183,1,90
1633,280,2,742,9,4192,341,90
1634,280,2,743,6,4198,166,60
1635,280,2,744,7,4205,1,70
1636,280,2,745,9,4214,1,90
1637,280,2,746,4,4218,1,40
1638,280,2,747,5,4223,242,50
1639,280,2,748,7,4230,115,70
1640,280,2,749,7,4237,1,70
1641,280,2,750,2,4239,88,20
1642,280,2,751,7,4246,84,70
1643,280,2,752,6,4252,1,60
1644,280,2,753,7,4259,1,70
1645,280,2,754,4,4263,1,40
1646,280,2,755,5,4268,1,50
1647,280,2,756,9,4277,1,90
1648,280,2,757,2,4279,230,20
1649,280,2,758,8,4287,1,80
1650,280,2,759,2,4289,1,20
1651,280,2,760,6,4295,188,60
1652,280,2,761,4,4299,87,40
1653,280,2,762,8,4307,84,80
1654,280,2,763,6,4313,1,60
1655,280,2,764,9,4322,1,90
1656,280,2,765,8,4330,1,80
1657,280,2,766,6,4336,1,60
1658,280,2,767,6,4342,1,60
1659,280,2,768,9,4351,1,90
1660,280,2,769,8,4359,1,80
1661,280,2,770,5,4364,424,50
1662,280,2,771,3,4367,1,30
1663,280,2,772,4,4371,209,40
1664,280,2,773,9,4380,1,90
1665,280,2,774,5,4385,1,50
1666,280,2,775,9,4394,1,90
1667,280,2,776,2,4396,237,20
1668,280,2,777,6,4402,1,60
1669,280,2,778,9,4411,1,90
1670,280,2,779,3,4414,183,30
1671,280,2,780,2,4416,70,20
1672,280,2,781,8,4424,67,80
1673,280,2,782,5,4429,1,50
1674,280,2,783,8,4437,1,80
1675,280,2,784,4,4441,1,40
1676,280,2,785,3,4444,1,30
1677,280,2,786,4,4448,1,40
1678,280,2,787,3,4451,1,30
1679,280,2,788,7,4458,1,70
1680,280,2,789,2,4460,268,20
1681,280,2,790,6,4466,1,60
1682,280,2,791,7,4473,169,70
1683,280,2,792,3,4476,62,30
1684,280,2,793,9,4485,73,90
1685,280,2,794,8,4493,1,80
1686,280,2,795,3,4496,1,30
1687,280,2,796,4,4500,1,40
1688,280,2,797,9,4509,1,90
1689,280,2,798,4,4513,226,40
1690,280,2,799,5,4518,1,50
1691,280,2,800,3,4521,130,30
1692,280,2,801,9,4530,1,90
1693,280,2,802,3,4533,1,30
1694,280,2,803,6,4539,1,60
1695,280,2,804,4,4543,1,40
1696,280,2,805,8,4551,1,80
1697,280,2,806,4,4555,279,40
1698,280,2,807,3,4558,1,30
1699,280,2,808,2,4560,1,20
1700,280,2,809,8,4568,169,80
1701,280,2,810,8,4576,1,80
1702,280,2,811,5,4581,1,50
1703,280,2,812,3,4584,1,30
1704,280,2,813,6,4590,1,60
1705,280,2,814,4,4594,233,40
1706,280,2,815,7,4601,1,70
1707,280,2,816,8,4609,1,80
1708,280,2,817,5,4614,1,50
1709,280,2,818,3,4617,1,30
1710,280,2,819,8,4625,285,80
1711,280,2,820,5,4630,1,50
1712,280,2,821,6,4636,167,60
1713,280,2,822,2,4638,48,20
1714,280,2,823,9,4647,1,90
1715,280,2,824,7,4654,1,70
1716,280,2,825,7,4661,1,70
1717,280,2,826,3,4664,1,30
1718,280,2,827,5,4669,1,50
1719,280,2,828,3,4672,1,30
1720,280,2,829,8,4680,1,80
1721,280,2,830,7,4687,1,70
1722,280,2,831,9,4696,1,90
1723,280,2,832,2,4698,1,20
1724,280,2,833,6,4704,1,60
1725,280,2,834,9,4713,1,90
1726,280,2,835,7,4720,1,70
1727,280,2,836,6,4726,1,60
1728,280,2,837,2,4728,1,20
1729,280,2,838,9,4737,1,90
1730,280,2,839,4,4741,1,40
1731,280,2,840,5,4746,1,50
1732,280,2,841,9,4755,821,90
1733,280,2,842,6,4761,1,60
1734,280,2,843,7,4768,1,70
1735,280,2,844,2,4770,348,20
1736,280,2,845,4,4774,1,40
1737,280,2,846,5,4779,1,50
1738,280,2,847,6,4785,1,60
1739,280,2,848,3,4788,1,30
1740,280,2,849,7,4795,1,70
1741,280,2,850,2,4797,1,20
1742,280,2,851,7,4804,291,70
1743,280,2,852,8,4812,1,80
1744,280,2,853,5,4817,1,50
1745,280,2,854,4,4821,1,40
1746,280,2,855,5,4826,251,50
1747,280,2,856,2,4828,1,20
1748,280,2,857,9,4837,1,90
1749,280,2,858,3,4840,1,30
1750,280,2,859,7,4847,1,70
1751,280,2,860,3,4850,1,30
1752,280,2,861,7,4857,293,70
1753,280,2,862,8,4865,1,80
1754,280,2,863,7,4872,1,70
1755,280,2,864,6,4878,1,60
1756,280,2,865,4,4882,1,40
1757,280,2,866,8,4890,322,80
1758,280,2,867,8,4898,1,80
1759,280,2,868,7,4905,1,70
1760,280,2,869,8,4913,258,80
1761,280,2,870,2,4915,1,20
1762,280,2,871,6,4921,1,60
1763,280,2,872,6,4927,1,60
1764,280,2,873,7,4934,1,70
1765,280,2,874,6,4940,253,60
1766,280,2,875,6,4946,1,60
1767,280,2,876,5,4951,1,50
1768,280,2,877,6,4957,1,60
1769,280,2,878,8,4965,1,80
1770,280,2,879,6,4971,1,60
1771,280,2,880,3,4974,1,30
1772,280,2,881,5,4979,1,50
1773,280,2,882,3,4982,1,30
1774,280,2,883,9,4991,1,90
1775,280,2,884,3,4994,1,30
1776,280,2,885,4,4998,1,40
1777,280,3,1,4,4,1,40
1778,280,3,2,6,10,1,60
1779,280,3,3,3,13,79,30
1780,280,3,4,5,18,57,50
1781,280,3,5,8,26,1,80
1782,280,3,6,7,33,1,70
1783,280,3,7,5,38,1,50
1784,280,3,8,2,40,1,20
1785,280,3,9,5,45,1,50
1786,280,3,10,4,49,1,40
1787,280,3,11,4,53,1,40
1788,280,3,12,4,57,1,40
1789,280,3,13,9,66,1,90
1790,280,3,14,4,70,1,40
1791,280,3,15,9,79,1,90
1792,280,3,16,5,84,1,50
1793,280,3,17,4,88,489,40
1794,280,3,18,3,91,166,30
1795,280,3,19,3,94,1,30
1796,280,3,20,3,97,1,30
1797,280,3,21,9,106,1,90
1798,280,3,22,4,110,1,40
1799,280,3,23,3,113,1,30
1800,280,3,24,7,120,226,70
1801,280,3,25,2,122,1,20
1802,280,3,26,8,130,1,80
1803,280,3,27,8,138,1,80
1804,280,3,28,7,145,1,70
1805,280,3,29,8,153,315,80
1806,280,3,30,4,157,1,40
1807,280,3,31,9,166,190,90
1808,280,3,32,2,168,1,20
1809,280,3,33,5,173,89,50
1810,280,3,34,4,177,1,40
1811,280,3,35,8,185,1,80
1812,280,3,36,3,188,127,30
1813,280,3,37,4,192,1,40
1814,280,3,38,4,196,94,40
1815,280,3,39,7,203,1,70
1816,280,3,40,5,208,1,50
1817,280,3,41,7,215,1,70
1818,280,3,42,2,217,1,20
1819,280,3,43,6,223,1,60
1820,280,3,44,8,231,1,80
1821,280,3,45,6,237,1,60
1822,280,3,46,2,239,1,20
1823,280,3,47,4,243,1,40
1824,280,3,48,3,246,1,30
1825,280,3,49,8,254,1,80
1826,280,3,50,4,258,1,40
1827,280,3,51,4,262,1,40
1828,280,3,52,7,269,536,70
1829,280,3,53,2,271,1,20
1830,280,3,54,8,279,1,80
1831,280,3,55,2,281,246,20
1832,280,3,56,2,283,87,20
1833,280,3,57,5,288,46,50
1834,280,3,58,5,293,1,50
1835,280,3,59,7,300,87,70
1836,280,3,60,3,303,48,30
1837,280,3,61,7,310,62,70
1838,280,3,62,5,315,1,50
1839,280,3,63,3,318,1,30
1840,280,3,64,5,323,1,50
1841,280,3,65,6,329,158,60
1842,280,3,66,8,337,1,80
1843,280,3,67,5,342,1,50
1844,280,3,68,2,344,146,20
1845,280,3,69,3,347,1,30
1846,280,3,70,7,354,1,70
1847,280,3,71,4,358,1,40
1848,280,3,72,7,365,183,70
1849,280,3,73,3,368,1,30
1850,280,3,74,7,375,1,70
1851,280,3,75,3,378,1,30
1852,280,3,76,9,387,1,90
1853,280,3,77,8,395,1,80
1854,280,3,78,6,401,1,60
1855,280,3,79,7,408,1,70
1856,280,3,80,8,416,456,80
1857,280,3,81,9,425,1,90
1858,280,3,82,5,430,1,50
1859,280,3,83,3,433,1,30
1860,280,3,84,7,440,1,70
1861,280,3,85,5,445,1,50
1862,280,3,86,6,451,1,60
1863,280,3,87,2,453,1,20
1864,280,3,88,7,460,441,70
1865,280,3,89,5,465,1,50
1866,280,3,90,3,468,1,30
1867,280,3,91,5,473,1,50
1868,280,3,92,2,475,1,20
1869,280,3,93,3,478,1,30
1870,280,3,94,2,480,1,20
1871,280,3,95,9,489,1,90
1872,280,3,96,8,497,1,80
1873,280,3,97,3,500,1,30
1874,280,3,98,2,502,1,20
1875,280,3,99,7,509,1,70
1876,280,3,100,5,514,1,50
1877,280,3,101,4,518,1,40
1878,280,3,102,2,520,519,20
1879,280,3,103,4,524,1,40
1880,280,3,104,8,532,1,80
1881,280,3,105,3,535,1,30
1882,280,3,106,5,540,313,50
1883,280,3,107,3,543,1,30
1884,280,3,108,5,548,1,50
1885,280,3,109,6,554,1,60
1886,280,3,110,8,562,244,80
1887,280,3,111,9,571,1,90
1888,280,3,112,9,580,1,90
1889,280,3,113,6,586,232,60
1890,280,3,114,6,592,1,60
1891,280,3,115,8,600,1,80
1892,280,3,116,9,609,231,90
1893,280,3,117,7,616,1,70
1894,280,3,118,9,625,192,90
1895,280,3,119,8,633,1,80
1896,280,3,120,8,641,164,80
1897,280,3,121,9,650,1,90
1898,280,3,122,8,658,182,80
1899,280,3,123,8,666,112,80
1900,280,3,124,6,672,70,60
1901,280,3,125,6,678,1,60
1902,280,3,126,6,684,1,60
1903,280,3,127,9,693,1,90
1904,280,3,128,8,701,1,80
1905,280,3,129,8,709,258,80
1906,280,3,130,5,714,1,50
1907,280,3,131,4,718,146,40
1908,280,3,132,3,721,1,30
1909,280,3,133,4,725,1,40
1910,280,3,134,5,730,1,50
1911,280,3,135,3,733,1,30
1912,280,3,136,6,739,196,60
1913,280,3,137,6,745,122,60
1914,280,3,138,9,754,82,90
1915,280,3,139,4,758,1,40
1916,280,3,140,2,760,1,20
1917,280,3,141,8,768,1,80
1918,280,3,142,9,777,1,90
1919,280,3,143,4,781,184,40
1920,280,3,144,8,789,1,80
1921,280,3,145,6,795,164,60
1922,280,3,146,9,804,1,90
1923,280,3,147,9,813,175,90
1924,280,3,148,6,819,1,60
1925,280,3,149,3,822,1,30
1926,280,3,150,4,826,1,40
1927,280,3,151,8,834,1,80
1928,280,3,152,2,836,212,20
1929,280,3,153,6,842,1,60
1930,280,3,154,8,850,1,80
1931,280,3,155,8,858,1,80
1932,280,3,156,3,861,1,30
1933,280,3,157,2,863,227,20
1934,280,3,158,7,870,1,70
1935,280,3,159,5,875,1,50
1936,280,3,160,5,880,187,50
1937,280,3,161,6,886,1,60
1938,280,3,162,4,890,138,40
1939,280,3,163,6,896,1,60
1940,280,3,164,5,901,131,50
1941,280,3,165,2,903,1,20
1942,280,3,166,2,905,1,20
1943,280,3,167,9,914,1,90
1944,280,3,168,4,918,1,40
1945,280,3,169,3,921,1,30
1946,280,3,170,6,927,1,60
1947,280,3,171,4,931,245,40
1948,280,3,172,3,934,1,30
1949,280,3,173,8,942,1,80
1950,280,3,174,5,947,1,50
1951,280,3,175,7,954,1,70
1952,280,3,176,8,962,285,80
1953,280,3,177,8,970,1,80
1954,280,3,178,3,973,179,30
1955,280,3,179,4,977,1,40
1956,280,3,180,4,981,1,40
1957,280,3,181,6,987,1,60
1958,280,3,182,9,996,206,90
1959,280,3,183,9,1005,1,90
1960,280,3,184,9,1014,1,90
1961,280,3,185,7,1021,244,70
1962,280,3,186,5,1026,1,50
1963,280,3,187,8,1034,1,80
1964,280,3,188,3,1037,1,30
1965,280,3,189,7,1044,222,70
1966,280,3,190,8,1052,141,80
1967,280,3,191,9,1061,1,90
1968,280,3,192,7,1068,1,70
1969,280,3,193,2,1070,1,20
1970,280,3,194,5,1075,1,50
1971,280,3,195,9,1084,1,90
1972,280,3,196,9,1093,1,90
1973,280,3,197,3,1096,1,30
1974,280,3,198,7,1103,1,70
1975,280,3,199,9,1112,455,90
1976,280,3,200,5,1117,1,50
1977,280,3,201,2,1119,1,20
1978,280,3,202,9,1128,267,90
1979,280,3,203,8,1136,1,80
1980,280,3,204,2,1138,1,20
1981,280,3,205,6,1144,1,60
1982,280,3,206,5,1149,1,50
1983,280,3,207,3,1152,1,30
1984,280,3,208,8,1160,1,80
1985,280,3,209,9,1169,354,90
1986,280,3,210,5,1174,1,50
1987,280,3,211,2,1176,1,20
1988,280,3,212,8,1184,1,80
1989,280,3,213,4,1188,1,40
1990,280,3,214,2,1190,1,20
1991,280,3,215,5,1195,1,50
1992,280,3,216,6,1201,340,60
1993,280,3,217,9,1210,193,90
1994,280,3,218,7,1217,1,70
1995,280,3,219,2,1219,113,20
1996,280,3,220,5,1224,60,50
1997,280,3,221,5,1229,1,50
1998,280,3,222,6,1235,1,60
1999,280,3,223,6,1241,147,60
2000,280,3,224,5,1246,1,50
2001,280,3,225,9,1255,130,90
2002,280,3,226,6,1261,1,60
2003,280,3,227,5,1266,145,50
2004,280,3,228,7,1273,1,70
2005,280,3,229,9,1282,1,90
2006,280,3,230,5,1287,170,50
2007,280,3,231,3,1290,1,30
2008,280,3,232,6,1296,1,60
2009,280,3,233,3,1299,1,30
2010,280,3,234,4,1303,155,40
2011,280,3,235,8,1311,1,80
2012,280,3,236,6,1317,145,60
2013,280,3,237,2,1319,1,20
2014,280,3,238,3,1322,76,30
2015,280,3,239,4,1326,1,40
2016,280,3,240,4,1330,81,40
2017,280,3,241,2,1332,47,20
2018,280,3,242,5,1337,1,50
2019,280,3,243,8,1345,1,80
2020,280,3,244,4,1349,1,40
2021,280,3,245,9,1358,1,90
2022,280,3,246,4,1362,1,40
2023,280,3,247,9,1371,259,90
2024,280,3,248,3,1374,1,30
2025,280,3,249,5,1379,143,50
2026,280,3,250,8,1387,1,80
2027,280,3,251,2,1389,103,20
2028,280,3,252,8,1397,1,80
2029,280,3,253,8,1405,1,80
2030,280,3,254,5,1410,1,50
2031,280,3,255,3,1413,1,30
2032,280,3,256,8,1421,1,80
2033,280,3,257,5,1426,1,50
2034,280,3,258,6,1432,1,60
2035,280,3,259,9,1441,1,90
2036,280,3,260,8,1449,440,80
2037,280,3,261,6,1455,163,60
2038,280,3,262,9,1464,1,90
2039,280,3,263,6,1470,1,60
2040,280,3,264,2,1472,183,20
2041,280,3,265,8,1480,1,80
2042,280,3,266,8,1488,153,80
2043,280,3,267,7,1495,1,70
2044,280,3,268,9,1504,1,90
2045,280,3,269,7,1511,1,70
2046,280,3,270,9,1520,1,90
2047,280,3,271,2,1522,1,20
2048,280,3,272,5,1527,1,50
2049,280,3,273,8,1535,368,80
2050,280,3,274,2,1537,1,20
2051,280,3,275,8,1545,165,80
2052,280,3,276,6,1551,1,60
2053,280,3,277,7,1558,155,70
2054,280,3,278,9,1567,1,90
2055,280,3,279,5,1572,132,50
2056,280,3,280,4,1576,1,40
2057,280,3,281,4,1580,106,40
2058,280,3,282,9,1589,1,90
2059,280,3,283,2,1591,1,20
2060,280,3,284,5,1596,1,50
2061,280,3,285,6,1602,1,60
2062,280,3,286,3,1605,1,30
2063,280,3,287,3,1608,1,30
2064,280,3,288,4,1612,226,40
2065,280,3,289,9,1621,1,90
2066,280,3,290,9,1630,1,90
2067,280,3,291,3,1633,1,30
2068,280,3,292,7,1640,1,70
2069,280,3,293,5,1645,307,50
2070,280,3,294,6,1651,1,60
2071,280,3,295,7,1658,1,70
2072,280,3,296,7,1665,1,70
2073,280,3,297,3,1668,1,30
2074,280,3,298,3,1671,1,30
2075,280,3,299,4,1675,270,40
2076,280,3,300,9,1684,1,90
2077,280,3,301,9,1693,1,90
2078,280,3,302,3,1696,1,30
2079,280,3,303,3,1699,1,30
2080,280,3,304,5,1704,1,50
2081,280,3,305,8,1712,1,80
2082,280,3,306,4,1716,1,40
2083,280,3,307,2,1718,1,20
2084,280,3,308,2,1720,1,20
2085,280,3,309,7,1727,1,70
2086,280,3,310,2,1729,1,20
2087,280,3,311,7,1736,1,70
2088,280,3,312,8,1744,1,80
2089,280,3,313,5,1749,1,50
2090,280,3,314,5,1754,1,50
2091,280,3,315,2,1756,1,20
2092,280,3,316,5,1761,1,50
2093,280,3,317,3,1764,1,30
2094,280,3,318,8,1772,1,80
2095,280,3,319,7,1779,1,70
2096,280,3,320,2,1781,1,20
2097,280,3,321,9,1790,881,90
2098,280,3,322,2,1792,1,20
2099,280,3,323,5,1797,1,50
2100,280,3,324,9,1806,375,90
2101,280,3,325,9,1815,1,90
2102,280,3,326,3,1818,193,30
2103,280,3,327,8,1826,1,80
2104,280,3,328,6,1832,1,60
2105,280,3,329,8,1840,179,80
2106,280,3,330,9,1849,1,90
2107,280,3,331,4,1853,154,40
2108,280,3,332,9,1862,116,90
2109,280,3,333,8,1870,1,80
2110,280,3,334,4,1874,1,40
2111,280,3,335,5,1879,1,50
2112,280,3,336,3,1882,1,30
2113,280,3,337,9,1891,1,90
2114,280,3,338,2,1893,1,20
2115,280,3,339,3,1896,230,30
2116,280,3,340,3,1899,112,30
2117,280,3,341,2,1901,42,20
2118,280,3,342,6,1907,1,60
2119,280,3,343,8,1915,1,80
2120,280,3,344,8,1923,1,80
2121,280,3,345,9,1932,201,90
2122,280,3,346,3,1935,1,30
2123,280,3,347,2,1937,1,20
2124,280,3,348,5,1942,1,50
2125,280,3,349,5,1947,172,50
2126,280,3,350,7,1954,97,70
2127,280,3,351,6,1960,82,60
2128,280,3,352,2,1962,1,20
2129,280,3,353,7,1969,1,70
2130,280,3,354,4,1973,1,40
2131,280,3,355,5,1978,1,50
2132,280,3,356,2,1980,1,20
2133,280,3,357,3,1983,154,30
2134,280,3,358,2,1985,65,20
2135,280,3,359,9,1994,1,90
2136,280,3,360,9,2003,1,90
2137,280,3,361,5,2008,199,50
2138,280,3,362,6,2014,80,60
2139,280,3,363,8,2022,55,80
2140,280,3,364,3,2025,1,30
2141,280,3,365,3,2028,81,30
2142,280,3,366,9,2037,1,90
2143,280,3,367,7,2044,1,70
2144,280,3,368,7,2051,1,70
2145,280,3,369,2,2053,192,20
2146,280,3,370,3,2056,78,30
2147,280,3,371,7,2063,1,70
2148,280,3,372,5,2068,1,50
2149,280,3,373,7,2075,1,70
2150,280,3,374,9,2084,1,90
2151,280,3,375,2,2086,1,20
2152,280,3,376,5,2091,1,50
2153,280,3,377,7,2098,1,70
2154,280,3,378,5,2103,1,50
2155,280,3,379,8,2111,1,80
2156,280,3,380,2,2113,1,20
2157,280,3,381,2,2115,1,20
2158,280,3,382,4,2119,423,40
2159,280,3,383,9,2128,203,90
2160,280,3,384,9,2137,1,90
2161,280,3,385,3,2140,157,30
2162,280,3,386,5,2145,71,50
2163,280,3,387,5,2150,1,50
2164,280,3,388,2,2152,1,20
2165,280,3,389,8,2160,1,80
2166,280,3,390,6,2166,1,60
2167,280,3,391,2,2168,1,20
2168,280,3,392,6,2174,1,60
2169,280,3,393,3,2177,247,30
2170,280,3,394,7,2184,1,70
2171,280,3,395,3,2187,1,30
2172,280,3,396,8,2195,1,80
2173,280,3,397,3,2198,1,30
2174,280,3,398,3,2201,1,30
2175,280,3,399,5,2206,1,50
2176,280,3,400,5,2211,274,50
2177,280,3,401,4,2215,1,40
2178,280,3,402,8,2223,158,80
2179,280,3,403,5,2228,1,50
2180,280,3,404,2,2230,1,20
2181,280,3,405,8,2238,1,80
2182,280,3,406,4,2242,1,40
2183,280,3,407,7,2249,220,70
2184,280,3,408,2,2251,1,20
2185,280,3,409,3,2254,1,30
2186,280,3,410,9,2263,1,90
2187,280,3,411,5,2268,182,50
2188,280,3,412,9,2277,1,90
2189,280,3,413,8,2285,183,80
2190,280,3,414,2,2287,1,20
2191,280,3,415,5,2292,1,50
2192,280,3,416,2,2294,1,20
2193,280,3,417,8,2302,1,80
2194,280,3,418,7,2309,1,70
2195,280,3,419,8,2317,1,80
2196,280,3,420,6,2323,1,60
2197,280,3,421,8,2331,1,80
2198,280,3,422,6,2337,1,60
2199,280,3,423,9,2346,1,90
2200,280,3,424,3,2349,1,30
2201,280,3,425,3,2352,514,30
2202,280,3,426,8,2360,200,80
2203,280,3,427,4,2364,75,40
2204,280,3,428,3,2367,1,30
2205,280,3,429,3,2370,1,30
2206,280,3,430,9,2379,110,90
2207,280,3,431,5,2384,1,50
2208,280,3,432,6,2390,1,60
2209,280,3,433,9,2399,177,90
2210,280,3,434,2,2401,1,20
2211,280,3,435,3,2404,1,30
2212,280,3,436,2,2406,92,20
2213,280,3,437,3,2409,1,30
2214,280,3,438,7,2416,1,70
2215,280,3,439,6,2422,1,60
2216,280,3,440,8,2430,1,80
2217,280,3,441,6,2436,1,60
2218,280,3,442,8,2444,1,80
2219,280,3,443,4,2448,1,40
2220,280,3,444,9,2457,1,90
2221,280,3,445,3,2460,1,30
2222,280,3,446,6,2466,1,60
2223,280,3,447,8,2474,481,80
2224,280,3,448,6,2480,1,60
2225,280,3,449,5,2485,1,50
2226,280,3,450,3,2488,1,30
2227,280,3,451,6,2494,299,60
2228,280,3,452,6,2500,1,60
2229,280,3,453,6,2506,1,60
2230,280,3,454,2,2508,1,20
2231,280,3,455,9,2517,1,90
2232,280,3,456,9,2526,1,90
2233,280,3,457,5,2531,1,50
2234,280,3,458,6,2537,1,60
2235,280,3,459,5,2542,1,50
2236,280,3,460,3,2545,1,30
2237,280,3,461,8,2553,1,80
2238,280,3,462,7,2560,1,70
2239,280,3,463,6,2566,1,60
2240,280,3,464,6,2572,1,60
2241,280,3,465,9,2581,1,90
2242,280,3,466,6,2587,1,60
2243,280,3,467,4,2591,1,40
2244,280,3,468,3,2594,782,30
2245,280,3,469,9,2603,300,90
2246,280,3,470,5,2608,1,50
2247,280,3,471,6,2614,1,60
2248,280,3,472,8,2622,1,80
2249,280,3,473,2,2624,225,20
2250,280,3,474,3,2627,1,30
2251,280,3,475,9,2636,1,90
2252,280,3,476,8,2644,1,80
2253,280,3,477,7,2651,275,70
2254,280,3,478,9,2660,132,90
2255,280,3,479,6,2666,92,60
2256,280,3,480,2,2668,1,20
2257,280,3,481,3,2671,68,30
2258,280,3,482,8,2679,1,80
2259,280,3,483,6,2685,1,60
2260,280,3,484,9,2694,1,90
2261,280,3,485,2,2696,1,20
2262,280,3,486,5,2701,1,50
2263,280,3,487,3,2704,216,30
2264,280,3,488,8,2712,1,80
2265,280,3,489,9,2721,1,90
2266,280,3,490,6,2727,209,60
2267,280,3,491,5,2732,121,50
2268,280,3,492,4,2736,1,40
2269,280,3,493,5,2741,1,50
2270,280,3,494,7,2748,1,70
2271,280,3,495,8,2756,1,80
2272,280,3,496,3,2759,1,30
2273,280,3,497,2,2761,239,20
2274,280,3,498,3,2764,1,30
2275,280,3,499,8,2772,1,80
2276,280,3,500,7,2779,1,70
2277,280,3,501,6,2785,1,60
2278,280,3,502,8,2793,1,80
2279,280,3,503,4,2797,1,40
2280,280,3,504,6,2803,1,60
2281,280,3,505,8,2811,1,80
2282,280,3,506,9,2820,443,90
2283,280,3,507,4,2824,1,40
2284,280,3,508,7,2831,1,70
2285,280,3,509,9,2840,301,90
2286,280,3,510,4,2844,1,40
2287,280,3,511,6,2850,1,60
2288,280,3,512,4,2854,190,40
2289,280,3,513,9,2863,118,90
2290,280,3,514,8,2871,1,80
2291,280,3,515,3,2874,119,30
2292,280,3,516,9,2883,1,90
2293,280,3,517,3,2886,1,30
2294,280,3,518,4,2890,1,40
2295,280,3,519,2,2892,1,20
2296,280,3,520,7,2899,1,70
2297,280,3,521,7,2906,257,70
2298,280,3,522,8,2914,1,80
2299,280,3,523,5,2919,1,50
2300,280,3,524,3,2922,1,30
2301,280,3,525,4,2926,216,40
2302,280,3,526,8,2934,126,80
2303,280,3,527,9,2943,1,90
2304,280,3,528,6,2949,118,60
2305,280,3,529,8,2957,106,80
2306,280,3,530,4,2961,59,40
2307,280,3,531,5,2966,1,50
2308,280,3,532,2,2968,1,20
2309,280,3,533,2,2970,83,20
2310,280,3,534,8,2978,1,80
2311,280,3,535,3,2981,1,30
2312,280,3,536,6,2987,1,60
2313,280,3,537,9,2996,200,90
2314,280,3,538,2,2998,1,20
2315,280,3,539,9,3007,1,90
2316,280,3,540,6,3013,1,60
2317,280,3,541,9,3022,1,90
2318,280,3,542,2,3024,1,20
2319,280,3,543,6,3030,1,60
2320,280,3,544,9,3039,1,90
2321,280,3,545,5,3044,1,50
2322,280,3,546,3,3047,1,30
2323,280,3,547,2,3049,1,20
2324,280,3,548,2,3051,461,20
2325,280,3,549,9,3060,1,90
2326,280,3,550,4,3064,1,40
2327,280,3,551,7,3071,1,70
2328,280,3,552,5,3076,1,50
2329,280,3,553,5,3081,1,50
2330,280,3,554,6,3087,1,60
2331,280,3,555,9,3096,1,90
2332,280,3,556,9,3105,1,90
2333,280,3,557,6,3111,519,60
2334,280,3,558,5,3116,1,50
2335,280,3,559,9,3125,1,90
2336,280,3,560,8,3133,1,80
2337,280,3,561,9,3142,1,90
2338,280,3,562,6,3148,421,60
2339,280,3,563,9,3157,1,90
2340,280,3,564,7,3164,1,70
2341,280,3,565,7,3171,1,70
2342,280,3,566,9,3180,1,90
2343,280,3,567,6,3186,1,60
2344,280,3,568,9,3195,1,90
2345,280,3,569,3,3198,1,30
2346,280,3,570,7,3205,513,70
2347,280,3,571,9,3214,1,90
2348,280,3,572,2,3216,1,20
2349,280,3,573,4,3220,1,40
2350,280,3,574,8,3228,1,80
2351,280,3,575,4,3232,1,40
2352,280,3,576,5,3237,1,50
2353,280,3,577,8,3245,1,80
2354,280,3,578,3,3248,1,30
2355,280,3,579,3,3251,1,30
2356,280,3,580,7,3258,1,70
2357,280,3,581,7,3265,588,70
2358,280,3,582,6,3271,1,60
2359,280,3,583,7,3278,1,70
2360,280,3,584,7,3285,1,70
2361,280,3,585,3,3288,1,30
2362,280,3,586,6,3294,1,60
2363,280,3,587,2,3296,1,20
2364,280,3,588,6,3302,1,60
2365,280,3,589,2,3304,1,20
2366,280,3,590,4,3308,1,40
2367,280,3,591,3,3311,1,30
2368,280,3,592,6,3317,1,60
2369,280,3,593,7,3324,562,70
2370,280,3,594,9,3333,1,90
2371,280,3,595,2,3335,268,20
2372,280,3,596,6,3341,1,60
2373,280,3,597,5,3346,1,50
2374,280,3,598,7,3353,1,70
2375,280,3,599,2,3355,1,20
2376,280,3,600,5,3360,1,50
2377,280,3,601,6,3366,1,60
2378,280,3,602,6,3372,1,60
2379,280,3,603,6,3378,1,60
2380,280,3,604,2,3380,374,20
2381,280,3,605,5,3385,1,50
2382,280,3,606,7,3392,1,70
2383,280,3,607,8,3400,210,80
2384,280,3,608,2,3402,1,20
2385,280,3,609,6,3408,1,60
2386,280,3,610,4,3412,169,40
2387,280,3,611,8,3420,1,80
2388,280,3,612,6,3426,1,60
2389,280,3,613,6,3432,1,60
2390,280,3,614,6,3438,1,60
2391,280,3,615,7,3445,1,70
2392,280,3,616,3,3448,289,30
2393,280,3,617,7,3455,1,70
2394,280,3,618,5,3460,1,50
2395,280,3,619,3,3463,1,30
2396,280,3,620,8,3471,1,80
2397,280,3,621,9,3480,1,90
2398,280,3,622,6,3486,343,60
2399,280,3,623,2,3488,1,20
2400,280,3,624,3,3491,1,30
2401,280,3,625,3,3494,1,30
2402,280,3,626,4,3498,1,40
2403,280,3,627,3,3501,1,30
2404,280,3,628,3,3504,1,30
2405,280,3,629,4,3508,1,40
2406,280,3,630,8,3516,309,80
2407,280,3,631,8,3524,1,80
2408,280,3,632,9,3533,190,90
2409,280,3,633,9,3542,1,90
2410,280,3,634,3,3545,1,30
2411,280,3,635,3,3548,1,30
2412,280,3,636,6,3554,1,60
2413,280,3,637,5,3559,1,50
2414,280,3,638,4,3563,1,40
2415,280,3,639,8,3571,271,80
2416,280,3,640,4,3575,1,40
2417,280,3,641,9,3584,204,90
2418,280,3,642,6,3590,1,60
2419,280,3,643,2,3592,1,20
2420,280,3,644,3,3595,1,30
2421,280,3,645,8,3603,1,80
2422,280,3,646,6,3609,245,60
2423,280,3,647,3,3612,1,30
2424,280,3,648,8,3620,1,80
2425,280,3,649,6,3626,1,60
2426,280,3,650,2,3628,1,20
2427,280,3,651,4,3632,1,40
2428,280,3,652,5,3637,1,50
2429,280,3,653,8,3645,1,80
2430,280,3,654,5,3650,1,50
2431,280,3,655,5,3655,1,50
2432,280,3,656,7,3662,1,70
2433,280,3,657,7,3669,1,70
2434,280,3,658,2,3671,1,20
2435,280,3,659,3,3674,515,30
2436,280,3,660,5,3679,1,50
2437,280,3,661,3,3682,1,30
2438,280,3,662,8,3690,1,80
2439,280,3,663,6,3696,1,60
2440,280,3,664,8,3704,1,80
2441,280,3,665,6,3710,1,60
2442,280,3,666,5,3715,1,50
2443,280,3,667,2,3717,460,20
2444,280,3,668,8,3725,171,80
2445,280,3,669,5,3730,1,50
2446,280,3,670,9,3739,1,90
2447,280,3,671,2,3741,1,20
2448,280,3,672,9,3750,1,90
2449,280,3,673,5,3755,1,50
2450,280,3,674,6,3761,1,60
2451,280,3,675,4,3765,1,40
2452,280,3,676,5,3770,1,50
2453,280,3,677,2,3772,1,20
2454,280,3,678,4,3776,375,40
2455,280,3,679,3,3779,1,30
2456,280,3,680,6,3785,1,60
2457,280,3,681,7,3792,1,70
2458,280,3,682,6,3798,1,60
2459,280,3,683,7,3805,1,70
2460,280,3,684,6,3811,1,60
2461,280,3,685,4,3815,1,40
2462,280,3,686,2,3817,1,20
2463,280,3,687,6,3823,1,60
2464,280,3,688,8,3831,1,80
2465,280,3,689,6,3837,1,60
2466,280,3,690,5,3842,1,50
2467,280,3,691,7,3849,1,70
2468,280,3,692,8,3857,1,80
2469,280,3,693,6,3863,1,60
2470,280,3,694,2,3865,1,20
2471,280,3,695,7,3872,1,70
2472,280,3,696,7,3879,855,70
2473,280,3,697,5,3884,1,50
2474,280,3,698,4,3888,280,40
2475,280,3,699,7,3895,122,70
2476,280,3,700,8,3903,1,80
2477,280,3,701,4,3907,1,40
2478,280,3,702,7,3914,1,70
2479,280,3,703,4,3918,1,40
2480,280,3,704,4,3922,267,40
2481,280,3,705,9,3931,148,90
2482,280,3,706,6,3937,1,60
2483,280,3,707,6,3943,1,60
2484,280,3,708,2,3945,1,20
2485,280,3,709,2,3947,143,20
2486,280,3,710,7,3954,77,70
2487,280,3,711,9,3963,78,90
2488,280,3,712,4,3967,1,40
2489,280,3,713,8,3975,1,80
2490,280,3,714,9,3984,176,90
2491,280,3,715,8,3992,1,80
2492,280,3,716,5,3997,140,50
2493,280,3,717,2,3999,1,20
2494,280,3,718,4,4003,1,40
2495,280,3,719,9,4012,1,90
2496,280,3,720,9,4021,1,90
2497,280,3,721,6,4027,1,60
2498,280,3,722,4,4031,1,40
2499,280,3,723,2,4033,288,20
2500,280,3,724,3,4036,1,30
2501,280,3,725,6,4042,175,60
2502,280,3,726,8,4050,110,80
2503,280,3,727,7,4057,1,70
2504,280,3,728,4,4061,1,40
2505,280,3,729,4,4065,1,40
2506,280,3,730,6,4071,175,60
2507,280,3,731,4,4075,89,40
2508,280,3,732,7,4082,1,70
2509,280,3,733,6,4088,107,60
2510,280,3,734,6,4094,1,60
2511,280,3,735,2,4096,1,20
2512,280,3,736,5,4101,1,50
2513,280,3,737,5,4106,1,50
2514,280,3,738,6,4112,189,60
2515,280,3,739,3,4115,1,30
2516,280,3,740,7,4122,1,70
2517,280,3,741,4,4126,147,40
2518,280,3,742,9,4135,122,90
2519,280,3,743,9,4144,1,90
2520,280,3,744,6,4150,152,60
2521,280,3,745,9,4159,1,90
2522,280,3,746,8,4167,1,80
2523,280,3,747,4,4171,1,40
2524,280,3,748,9,4180,1,90
2525,280,3,749,6,4186,1,60
2526,280,3,750,7,4193,335,70
2527,280,3,751,4,4197,124,40
2528,280,3,752,7,4204,1,70
2529,280,3,753,9,4213,1,90
2530,280,3,754,3,4216,1,30
2531,280,3,755,6,4222,193,60
2532,280,3,756,3,4225,1,30
2533,280,3,757,3,4228,98,30
2534,280,3,758,4,4232,1,40
2535,280,3,759,4,4236,1,40
2536,280,3,760,7,4243,1,70
2537,280,3,761,5,4248,1,50
2538,280,3,762,5,4253,1,50
2539,280,3,763,8,4261,1,80
2540,280,3,764,9,4270,1,90
2541,280,3,765,4,4274,1,40
2542,280,3,766,4,4278,1,40
2543,280,3,767,2,4280,1,20
2544,280,3,768,6,4286,1,60
2545,280,3,769,7,4293,1,70
2546,280,3,770,9,4302,1,90
2547,280,3,771,4,4306,1,40
2548,280,3,772,8,4314,1,80
2549,280,3,773,4,4318,690,40
2550,280,3,774,3,4321,1,30
2551,280,3,775,4,4325,1,40
2552,280,3,776,8,4333,1,80
2553,280,3,777,7,4340,1,70
2554,280,3,778,5,4345,1,50
2555,280,3,779,7,4352,1,70
2556,280,3,780,3,4355,1,30
2557,280,3,781,5,4360,1,50
2558,280,3,782,3,4363,1,30
2559,280,3,783,2,4365,468,20
2560,280,3,784,7,4372,1,70
2561,280,3,785,6,4378,1,60
2562,280,3,786,3,4381,1,30
2563,280,3,787,4,4385,1,40
2564,280,3,788,3,4388,347,30
2565,280,3,789,8,4396,1,80
2566,280,3,790,4,4400,1,40
2567,280,3,791,7,4407,198,70
2568,280,3,792,3,4410,1,30
2569,280,3,793,5,4415,121,50
2570,280,3,794,7,4422,1,70
2571,280,3,795,3,4425,1,30
2572,280,3,796,4,4429,1,40
2573,280,3,797,2,4431,1,20
2574,280,3,798,8,4439,1,80
2575,280,3,799,5,4444,1,50
2576,280,3,800,8,4452,1,80
2577,280,3,801,7,4459,362,70
2578,280,3,802,8,4467,150,80
2579,280,3,803,7,4474,1,70
2580,280,3,804,7,4481,138,70
2581,280,3,805,9,4490,1,90
2582,280,3,806,6,4496,1,60
2583,280,3,807,7,4503,1,70
2584,280,3,808,8,4511,1,80
2585,280,3,809,6,4517,297,60
2586,280,3,810,2,4519,98,20
2587,280,3,811,9,4528,1,90
2588,280,3,812,4,4532,116,40
2589,280,3,813,3,4535,1,30
2590,280,3,814,9,4544,121,90
2591,280,3,815,2,4546,1,20
2592,280,3,816,4,4550,1,40
2593,280,3,817,5,4555,102,50
2594,280,3,818,8,4563,1,80
2595,280,3,819,9,4572,1,90
2596,280,3,820,5,4577,1,50
2597,280,3,821,7,4584,1,70
2598,280,3,822,2,4586,248,20
2599,280,3,823,2,4588,1,20
2600,280,3,824,5,4593,1,50
2601,280,3,825,8,4601,198,80
2602,280,3,826,3,4604,84,30
2603,280,3,827,6,4610,1,60
2604,280,3,828,4,4614,1,40
2605,280,3,829,3,4617,1,30
2606,280,3,830,3,4620,1,30
2607,280,3,831,4,4624,1,40
2608,280,3,832,7,4631,253,70
2609,280,3,833,2,4633,1,20
2610,280,3,834,6,4639,116,60
2611,280,3,835,5,4644,1,50
2612,280,3,836,5,4649,1,50
2613,280,3,837,8,4657,1,80
2614,280,3,838,5,4662,1,50
2615,280,3,839,2,4664,1,20
2616,280,3,840,7,4671,1,70
2617,280,3,841,6,4677,1,60
2618,280,3,842,2,4679,1,20
2619,280,3,843,8,4687,1,80
2620,280,3,844,2,4689,1,20
2621,280,3,845,5,4694,408,50
2622,280,3,846,8,4702,1,80
2623,280,3,847,6,4708,230,60
2624,280,3,848,3,4711,1,30
2625,280,3,849,8,4719,1,80
2626,280,3,850,4,4723,1,40
2627,280,3,851,3,4726,1,30
2628,280,3,852,8,4734,1,80
2629,280,3,853,8,4742,1,80
2630,280,3,854,4,4746,351,40
2631,280,3,855,4,4750,1,40
2632,280,3,856,5,4755,1,50
2633,280,3,857,8,4763,1,80
2634,280,3,858,7,4770,1,70
2635,280,3,859,9,4779,358,90
2636,280,3,860,2,4781,1,20
2637,280,3,861,4,4785,158,40
2638,280,3,862,5,4790,66,50
2639,280,3,863,3,4793,48,30
2640,280,3,864,2,4795,1,20
2641,280,3,865,4,4799,51,40
2642,280,3,866,3,4802,1,30
2643,280,3,867,2,4804,1,20
2644,280,3,868,9,4813,107,90
2645,280,3,869,9,4822,81,90
2646,280,3,870,9,4831,1,90
2647,280,3,871,8,4839,1,80
2648,280,3,872,3,4842,1,30
2649,280,3,873,7,4849,1,70
2650,280,3,874,4,4853,252,40
2651,280,3,875,5,4858,1,50
2652,280,3,876,2,4860,1,20
2653,280,3,877,8,4868,1,80
2654,280,3,878,4,4872,1,40
2655,280,3,879,6,4878,257,60
2656,280,3,880,6,4884,1,60
2657,280,3,881,9,4893,207,90
2658,280,3,882,7,4900,1,70
2659,280,3,883,9,4909,1,90
2660,280,3,884,6,4915,1,60
2661,280,3,885,9,4924,1,90
2662,280,3,886,6,4930,1,60
2663,280,3,887,2,4932,1,20
2664,280,3,888,5,4937,339,50
2665,280,3,889,5,4942,1,50
2666,280,3,890,6,4948,1,60
2667,280,3,891,9,4957,250,90
2668,280,3,892,8,4965,119,80
2669,280,3,893,9,4974,1,90
2670,280,3,894,4,4978,1,40
2671,280,3,895,8,4986,187,80
2672,280,3,896,4,4990,1,40
2673,280,3,897,2,4992,81,20
