,Scenario,Trial,Inspection,Interval,Time,Accumulation,Defects,Rate
0,280,1,1,7,7,58,36,70
1,280,1,2,5,12,78,78,50
2,280,1,3,4,16,36,36,40
3,280,1,4,6,22,39,39,60
4,280,1,5,2,24,21,15,20
5,280,1,6,7,31,96,96,70
6,280,1,7,9,40,76,76,90
7,280,1,8,8,48,79,79,80
8,280,1,9,9,57,97,97,90
9,280,1,10,6,63,54,54,60
10,280,1,11,8,71,75,75,80
11,280,1,12,8,79,80,80,80
12,280,1,13,2,81,17,17,20
13,280,1,14,7,88,70,70,70
14,280,1,15,9,97,84,84,90
15,280,1,16,2,99,18,14,20
16,280,1,17,4,103,40,40,40
17,280,1,18,8,111,68,41,80
18,280,1,19,8,119,106,106,80
19,280,1,20,2,121,19,12,20
20,280,1,21,6,127,67,67,60
21,280,1,22,9,136,91,91,90
22,280,1,23,6,142,64,64,60
23,280,1,24,4,146,43,43,40
24,280,1,25,2,148,20,20,20
25,280,1,26,2,150,28,28,20
26,280,1,27,7,157,82,82,70
27,280,1,28,8,165,73,73,80
28,280,1,29,4,169,38,38,40
29,280,1,30,6,175,53,34,60
30,280,1,31,5,180,74,74,50
31,280,1,32,5,185,38,31,50
32,280,1,33,4,189,41,41,40
33,280,1,34,6,195,48,48,60
34,280,1,35,2,197,20,20,20
35,280,1,36,9,206,87,87,90
36,280,1,37,5,211,45,45,50
37,280,1,38,5,216,56,39,50
38,280,1,39,7,223,90,90,70
39,280,1,40,6,229,47,47,60
40,280,1,41,2,231,22,22,20
41,280,1,42,8,239,82,82,80
42,280,1,43,7,246,58,58,70
43,280,1,44,7,253,76,76,70
44,280,1,45,7,260,74,74,70
45,280,1,46,5,265,46,33,50
46,280,1,47,3,268,46,46,30
47,280,1,48,9,277,76,53,90
48,280,1,49,5,282,70,70,50
49,280,1,50,3,285,35,35,30
50,280,1,51,4,289,24,24,40
51,280,1,52,7,296,54,54,70
52,280,1,53,4,300,32,32,40
53,280,1,54,3,303,30,30,30
54,280,1,55,3,306,27,27,30
55,280,1,56,2,308,18,18,20
56,280,1,57,9,317,93,93,90
57,280,1,58,3,320,28,19,30
58,280,1,59,6,326,64,47,60
59,280,1,60,3,329,43,27,30
60,280,1,61,6,335,74,74,60
61,280,1,62,8,343,76,76,80
62,280,1,63,8,351,91,91,80
63,280,1,64,7,358,67,43,70
64,280,1,65,3,361,46,28,30
65,280,1,66,3,364,47,47,30
66,280,1,67,4,368,40,40,40
67,280,1,68,9,377,95,95,90
68,280,1,69,4,381,46,46,40
69,280,1,70,3,384,35,35,30
70,280,1,71,6,390,50,50,60
71,280,1,72,5,395,47,32,50
72,280,1,73,3,398,45,32,30
73,280,1,74,8,406,89,89,80
74,280,1,75,4,410,32,32,40
75,280,1,76,8,418,86,86,80
76,280,1,77,4,422,37,37,40
77,280,1,78,4,426,46,46,40
78,280,1,79,6,432,61,61,60
79,280,1,80,6,438,53,53,60
80,280,1,81,5,443,64,40,50
81,280,1,82,2,445,38,38,20
82,280,1,83,6,451,65,65,60
83,280,1,84,2,453,26,17,20
84,280,1,85,2,455,29,29,20
85,280,1,86,5,460,40,40,50
86,280,1,87,9,469,102,75,90
87,280,1,88,3,472,63,63,30
88,280,1,89,7,479,73,73,70
89,280,1,90,2,481,17,9,20
90,280,1,91,5,486,52,52,50
91,280,1,92,8,494,74,74,80
92,280,1,93,2,496,23,23,20
93,280,1,94,4,500,36,36,40
94,280,1,95,8,508,94,94,80
95,280,1,96,5,513,55,55,50
96,280,1,97,7,520,77,77,70
97,280,1,98,5,525,56,44,50
98,280,1,99,6,531,68,68,60
99,280,1,100,5,536,48,48,50
100,280,1,101,7,543,71,49,70
101,280,1,102,9,552,112,112,90
102,280,1,103,4,556,49,49,40
103,280,1,104,5,561,61,61,50
104,280,1,105,8,569,77,77,80
105,280,1,106,5,574,51,39,50
106,280,1,107,3,577,38,38,30
107,280,1,108,4,581,50,36,40
108,280,1,109,8,589,93,93,80
109,280,1,110,3,592,38,23,30
110,280,1,111,4,596,53,53,40
111,280,1,112,9,605,87,87,90
112,280,1,113,7,612,75,75,70
113,280,1,114,5,617,58,58,50
114,280,1,115,8,625,75,75,80
115,280,1,116,8,633,98,66,80
116,280,1,117,6,639,96,96,60
117,280,1,118,9,648,95,95,90
118,280,1,119,8,656,89,89,80
119,280,1,120,8,664,93,58,80
120,280,1,121,7,671,94,94,70
121,280,1,122,2,673,15,10,20
122,280,1,123,4,677,40,40,40
123,280,1,124,9,686,90,90,90
124,280,1,125,4,690,45,45,40
125,280,1,126,8,698,71,71,80
126,280,1,127,2,700,16,8,20
127,280,1,128,9,709,78,78,90
128,280,1,129,7,716,75,75,70
129,280,1,130,7,723,76,76,70
130,280,1,131,3,726,28,28,30
131,280,1,132,7,733,76,76,70
132,280,1,133,7,740,73,73,70
133,280,1,134,7,747,77,77,70
134,280,1,135,3,750,38,38,30
135,280,1,136,5,755,55,55,50
136,280,1,137,3,758,35,35,30
137,280,1,138,2,760,21,21,20
138,280,1,139,5,765,50,50,50
139,280,1,140,4,769,37,37,40
140,280,1,141,5,774,54,41,50
141,280,1,142,7,781,80,80,70
142,280,1,143,6,787,62,62,60
143,280,1,144,8,795,77,77,80
144,280,1,145,8,803,88,65,80
145,280,1,146,8,811,107,107,80
146,280,1,147,5,816,35,35,50
147,280,1,148,8,824,73,73,80
148,280,1,149,3,827,29,29,30
149,280,1,150,2,829,22,19,20
150,280,1,151,6,835,47,34,60
151,280,1,152,2,837,32,32,20
152,280,1,153,9,846,103,103,90
153,280,1,154,8,854,67,67,80
154,280,1,155,8,862,62,42,80
155,280,1,156,3,865,51,51,30
156,280,1,157,8,873,95,65,80
157,280,1,158,2,875,47,29,20
158,280,1,159,3,878,50,50,30
159,280,1,160,8,886,89,64,80
160,280,1,161,7,893,96,63,70
161,280,1,162,8,901,119,119,80
162,280,1,163,3,904,33,33,30
163,280,1,164,7,911,63,63,70
164,280,1,165,7,918,70,70,70
165,280,1,166,3,921,35,35,30
166,280,1,167,8,929,84,84,80
167,280,1,168,4,933,42,42,40
168,280,1,169,2,935,16,16,20
169,280,1,170,4,939,41,41,40
170,280,1,171,2,941,23,23,20
171,280,1,172,6,947,55,55,60
172,280,1,173,7,954,60,60,70
173,280,1,174,2,956,16,16,20
174,280,1,175,2,958,21,15,20
175,280,1,176,6,964,74,74,60
176,280,1,177,8,972,89,89,80
177,280,1,178,2,974,21,21,20
178,280,1,179,3,977,26,26,30
179,280,1,180,6,983,63,63,60
180,280,1,181,6,989,56,56,60
181,280,1,182,2,991,24,14,20
182,280,1,183,7,998,94,94,70
183,280,1,184,9,1007,120,120,90
184,280,1,185,2,1009,21,12,20
185,280,1,186,9,1018,97,97,90
186,280,1,187,3,1021,29,29,30
187,280,1,188,3,1024,18,13,30
188,280,1,189,9,1033,103,67,90
189,280,1,190,2,1035,51,51,20
190,280,1,191,2,1037,27,18,20
191,280,1,192,4,1041,55,40,40
192,280,1,193,3,1044,53,36,30
193,280,1,194,5,1049,65,65,50
194,280,1,195,4,1053,49,49,40
195,280,1,196,5,1058,47,47,50
196,280,1,197,5,1063,59,59,50
197,280,1,198,7,1070,95,95,70
198,280,1,199,7,1077,55,55,70
199,280,1,200,6,1083,64,41,60
200,280,1,201,5,1088,73,48,50
201,280,1,202,5,1093,70,70,50
202,280,1,203,5,1098,44,44,50
203,280,1,204,6,1104,77,49,60
204,280,1,205,4,1108,66,66,40
205,280,1,206,9,1117,88,88,90
206,280,1,207,6,1123,55,55,60
207,280,1,208,2,1125,24,24,20
208,280,1,209,7,1132,67,67,70
209,280,1,210,2,1134,21,21,20
210,280,1,211,5,1139,41,41,50
211,280,1,212,8,1147,72,53,80
212,280,1,213,8,1155,99,99,80
213,280,1,214,4,1159,48,48,40
214,280,1,215,9,1168,90,90,90
215,280,1,216,7,1175,59,59,70
216,280,1,217,7,1182,74,74,70
217,280,1,218,2,1184,26,26,20
218,280,1,219,4,1188,48,48,40
219,280,1,220,3,1191,25,25,30
220,280,1,221,5,1196,45,45,50
221,280,1,222,2,1198,22,22,20
222,280,1,223,4,1202,33,33,40
223,280,1,224,9,1211,86,86,90
224,280,1,225,5,1216,59,37,50
225,280,1,226,8,1224,92,92,80
226,280,1,227,3,1227,31,31,30
227,280,1,228,3,1230,30,22,30
228,280,1,229,2,1232,22,22,20
229,280,1,230,9,1241,97,97,90
230,280,1,231,9,1250,88,65,90
231,280,1,232,8,1258,83,83,80
232,280,1,233,7,1265,69,69,70
233,280,1,234,2,1267,18,13,20
234,280,1,235,8,1275,88,62,80
235,280,1,236,8,1283,104,104,80
236,280,1,237,5,1288,39,39,50
237,280,1,238,5,1293,44,44,50
238,280,1,239,5,1298,54,54,50
239,280,1,240,8,1306,85,85,80
240,280,1,241,7,1313,70,70,70
241,280,1,242,9,1322,117,83,90
242,280,1,243,3,1325,64,41,30
243,280,1,244,9,1334,123,85,90
244,280,1,245,5,1339,88,88,50
245,280,1,246,8,1347,81,52,80
246,280,1,247,2,1349,57,57,20
247,280,1,248,8,1357,79,79,80
248,280,1,249,9,1366,87,87,90
249,280,1,250,5,1371,44,44,50
250,280,1,251,4,1375,45,45,40
251,280,1,252,7,1382,69,69,70
252,280,1,253,3,1385,30,30,30
253,280,1,254,2,1387,15,15,20
254,280,1,255,6,1393,63,63,60
255,280,1,256,2,1395,12,12,20
256,280,1,257,9,1404,86,86,90
257,280,1,258,3,1407,31,31,30
258,280,1,259,2,1409,27,27,20
259,280,1,260,9,1418,107,107,90
260,280,1,261,4,1422,37,37,40
261,280,1,262,4,1426,45,45,40
262,280,1,263,9,1435,101,101,90
263,280,1,264,6,1441,69,69,60
264,280,1,265,3,1444,29,29,30
265,280,1,266,2,1446,25,25,20
266,280,1,267,4,1450,39,28,40
267,280,1,268,2,1452,40,40,20
268,280,1,269,7,1459,68,68,70
269,280,1,270,5,1464,44,44,50
270,280,1,271,9,1473,88,88,90
271,280,1,272,2,1475,25,25,20
272,280,1,273,3,1478,28,28,30
273,280,1,274,2,1480,28,28,20
274,280,1,275,4,1484,42,42,40
275,280,1,276,5,1489,47,47,50
276,280,1,277,2,1491,20,20,20
277,280,1,278,4,1495,54,54,40
278,280,1,279,9,1504,91,91,90
279,280,1,280,4,1508,52,43,40
280,280,1,281,8,1516,83,83,80
281,280,1,282,3,1519,17,17,30
282,280,1,283,3,1522,35,35,30
283,280,1,284,7,1529,86,86,70
284,280,1,285,9,1538,87,62,90
285,280,1,286,3,1541,49,36,30
286,280,1,287,3,1544,41,41,30
287,280,1,288,6,1550,57,57,60
288,280,1,289,2,1552,19,19,20
289,280,1,290,3,1555,31,31,30
290,280,1,291,7,1562,70,70,70
291,280,1,292,7,1569,65,65,70
292,280,1,293,8,1577,96,96,80
293,280,1,294,8,1585,72,72,80
294,280,1,295,9,1594,101,101,90
295,280,1,296,2,1596,22,22,20
296,280,1,297,8,1604,83,56,80
297,280,1,298,7,1611,99,99,70
298,280,1,299,8,1619,86,68,80
299,280,1,300,5,1624,71,46,50
300,280,1,301,4,1628,62,62,40
301,280,1,302,6,1634,56,56,60
302,280,1,303,6,1640,67,67,60
303,280,1,304,9,1649,80,80,90
304,280,1,305,6,1655,57,57,60
305,280,1,306,5,1660,48,36,50
306,280,1,307,8,1668,91,91,80
307,280,1,308,9,1677,83,83,90
308,280,1,309,3,1680,31,31,30
309,280,1,310,9,1689,95,95,90
310,280,1,311,6,1695,57,57,60
311,280,1,312,6,1701,52,52,60
312,280,1,313,7,1708,65,65,70
313,280,1,314,6,1714,64,43,60
314,280,1,315,6,1720,74,57,60
315,280,1,316,3,1723,41,41,30
316,280,1,317,9,1732,94,94,90
317,280,1,318,4,1736,28,28,40
318,280,1,319,5,1741,39,39,50
319,280,1,320,2,1743,21,21,20
320,280,1,321,5,1748,43,43,50
321,280,1,322,5,1753,50,34,50
322,280,1,323,4,1757,65,46,40
323,280,1,324,9,1766,120,120,90
324,280,1,325,6,1772,72,72,60
325,280,1,326,9,1781,99,75,90
326,280,1,327,3,1784,58,58,30
327,280,1,328,3,1787,25,25,30
328,280,1,329,4,1791,41,34,40
329,280,1,330,9,1800,105,73,90
330,280,1,331,4,1804,76,76,40
331,280,1,332,8,1812,67,67,80
332,280,1,333,8,1820,81,81,80
333,280,1,334,9,1829,100,100,90
334,280,1,335,4,1833,42,42,40
335,280,1,336,4,1837,45,45,40
336,280,1,337,5,1842,46,46,50
337,280,1,338,4,1846,42,42,40
338,280,1,339,8,1854,76,76,80
339,280,1,340,3,1857,34,34,30
340,280,1,341,2,1859,18,18,20
341,280,1,342,5,1864,39,39,50
342,280,1,343,5,1869,49,49,50
343,280,1,344,8,1877,90,90,80
344,280,1,345,4,1881,40,40,40
345,280,1,346,7,1888,70,70,70
346,280,1,347,5,1893,47,47,50
347,280,1,348,8,1901,73,73,80
348,280,1,349,3,1904,23,10,30
349,280,1,350,9,1913,101,101,90
350,280,1,351,6,1919,47,47,60
351,280,1,352,4,1923,44,44,40
352,280,1,353,9,1932,87,87,90
353,280,1,354,8,1940,73,73,80
354,280,1,355,6,1946,60,60,60
355,280,1,356,8,1954,73,73,80
356,280,1,357,6,1960,58,58,60
357,280,1,358,8,1968,63,63,80
358,280,1,359,8,1976,89,89,80
359,280,1,360,5,1981,48,32,50
360,280,1,361,7,1988,80,60,70
361,280,1,362,7,1995,85,63,70
362,280,1,363,3,1998,54,54,30
363,280,1,364,6,2004,61,61,60
364,280,1,365,9,2013,97,73,90
365,280,1,366,5,2018,82,58,50
366,280,1,367,4,2022,69,69,40
367,280,1,368,4,2026,42,42,40
368,280,1,369,2,2028,20,20,20
369,280,1,370,6,2034,67,67,60
370,280,1,371,4,2038,40,40,40
371,280,1,372,3,2041,29,29,30
372,280,1,373,4,2045,38,38,40
373,280,1,374,9,2054,91,64,90
374,280,1,375,3,2057,54,54,30
375,280,1,376,3,2060,27,27,30
376,280,1,377,7,2067,77,77,70
377,280,1,378,8,2075,75,75,80
378,280,1,379,2,2077,17,17,20
379,280,1,380,7,2084,69,69,70
380,280,1,381,3,2087,28,28,30
381,280,1,382,7,2094,64,41,70
382,280,1,383,6,2100,83,83,60
383,280,1,384,4,2104,38,30,40
384,280,1,385,2,2106,35,35,20
385,280,1,386,6,2112,58,58,60
386,280,1,387,2,2114,18,13,20
387,280,1,388,9,2123,96,67,90
388,280,1,389,6,2129,89,89,60
389,280,1,390,9,2138,96,76,90
390,280,1,391,9,2147,111,111,90
391,280,1,392,3,2150,22,22,30
392,280,1,393,9,2159,77,77,90
393,280,1,394,7,2166,77,77,70
394,280,1,395,3,2169,33,33,30
395,280,1,396,2,2171,18,12,20
396,280,1,397,8,2179,89,55,80
397,280,1,398,7,2186,109,109,70
398,280,1,399,7,2193,85,62,70
399,280,1,400,2,2195,38,38,20
400,280,1,401,8,2203,89,89,80
401,280,1,402,3,2206,28,28,30
402,280,1,403,2,2208,12,9,20
403,280,1,404,4,2212,37,22,40
404,280,1,405,7,2219,80,80,70
405,280,1,406,9,2228,70,46,90
406,280,1,407,5,2233,74,74,50
407,280,1,408,9,2242,96,72,90
408,280,1,409,9,2251,116,116,90
409,280,1,410,9,2260,114,85,90
410,280,1,411,5,2265,80,80,50
411,280,1,412,8,2273,79,79,80
412,280,1,413,5,2278,54,54,50
413,280,1,414,4,2282,26,26,40
414,280,1,415,9,2291,91,91,90
415,280,1,416,3,2294,26,26,30
416,280,1,417,4,2298,26,26,40
417,280,1,418,4,2302,38,38,40
418,280,1,419,9,2311,97,97,90
419,280,1,420,6,2317,51,51,60
420,280,1,421,3,2320,29,29,30
421,280,1,422,4,2324,35,35,40
422,280,1,423,4,2328,36,36,40
423,280,1,424,3,2331,33,21,30
424,280,1,425,8,2339,115,115,80
425,280,1,426,2,2341,25,25,20
426,280,1,427,8,2349,80,80,80
427,280,1,428,8,2357,83,83,80
428,280,1,429,4,2361,33,33,40
429,280,1,430,2,2363,16,16,20
430,280,1,431,8,2371,67,67,80
431,280,1,432,5,2376,52,52,50
432,280,1,433,4,2380,46,46,40
433,280,1,434,9,2389,104,104,90
434,280,1,435,8,2397,84,59,80
435,280,1,436,2,2399,49,49,20
436,280,1,437,8,2407,91,91,80
437,280,1,438,8,2415,78,78,80
438,280,1,439,5,2420,43,43,50
439,280,1,440,9,2429,62,62,90
440,280,1,441,2,2431,20,20,20
441,280,1,442,3,2434,31,31,30
442,280,1,443,8,2442,84,84,80
443,280,1,444,6,2448,66,47,60
444,280,1,445,6,2454,75,55,60
445,280,1,446,3,2457,50,50,30
446,280,1,447,6,2463,63,63,60
447,280,1,448,6,2469,48,48,60
448,280,1,449,7,2476,73,46,70
449,280,1,450,5,2481,87,87,50
450,280,1,451,9,2490,106,72,90
451,280,1,452,8,2498,109,109,80
452,280,1,453,7,2505,60,60,70
453,280,1,454,2,2507,19,19,20
454,280,1,455,4,2511,39,39,40
455,280,1,456,6,2517,64,44,60
456,280,1,457,6,2523,70,70,60
457,280,1,458,9,2532,99,99,90
458,280,1,459,3,2535,31,31,30
459,280,1,460,6,2541,50,50,60
460,280,1,461,3,2544,21,21,30
461,280,1,462,3,2547,29,29,30
462,280,1,463,5,2552,42,42,50
463,280,1,464,8,2560,83,83,80
464,280,1,465,8,2568,98,98,80
465,280,1,466,2,2570,18,18,20
466,280,1,467,3,2573,30,30,30
467,280,1,468,6,2579,69,69,60
468,280,1,469,2,2581,22,22,20
469,280,1,470,6,2587,59,43,60
470,280,1,471,7,2594,100,100,70
471,280,1,472,4,2598,36,36,40
472,280,1,473,6,2604,64,42,60
473,280,1,474,5,2609,83,63,50
474,280,1,475,4,2613,55,55,40
475,280,1,476,3,2616,28,28,30
476,280,1,477,4,2620,38,23,40
477,280,1,478,4,2624,45,45,40
478,280,1,479,9,2633,86,86,90
479,280,1,480,9,2642,68,68,90
480,280,1,481,3,2645,31,19,30
481,280,1,482,2,2647,36,36,20
482,280,1,483,6,2653,61,61,60
483,280,1,484,2,2655,17,13,20
484,280,1,485,4,2659,35,35,40
485,280,1,486,9,2668,84,84,90
486,280,1,487,4,2672,49,49,40
487,280,1,488,8,2680,72,72,80
488,280,1,489,9,2689,88,88,90
489,280,1,490,7,2696,66,43,70
490,280,1,491,5,2701,81,54,50
491,280,1,492,5,2706,77,77,50
492,280,1,493,5,2711,63,63,50
493,280,1,494,3,2714,26,26,30
494,280,1,495,7,2721,63,43,70
495,280,1,496,3,2724,50,29,30
496,280,1,497,7,2731,96,64,70
497,280,1,498,4,2735,65,43,40
498,280,1,499,6,2741,81,81,60
499,280,1,500,6,2747,59,59,60
500,280,1,501,2,2749,21,15,20
501,280,1,502,7,2756,61,61,70
502,280,1,503,2,2758,18,10,20
503,280,1,504,3,2761,34,34,30
504,280,1,505,4,2765,44,44,40
505,280,1,506,4,2769,43,26,40
506,280,1,507,9,2778,97,65,90
507,280,1,508,8,2786,99,77,80
508,280,1,509,7,2793,94,61,70
509,280,1,510,6,2799,95,95,60
510,280,1,511,9,2808,73,73,90
511,280,1,512,8,2816,73,73,80
512,280,1,513,5,2821,61,61,50
513,280,1,514,6,2827,59,59,60
514,280,1,515,3,2830,31,31,30
515,280,1,516,7,2837,84,84,70
516,280,1,517,2,2839,17,17,20
517,280,1,518,2,2841,17,17,20
518,280,1,519,9,2850,74,50,90
519,280,1,520,2,2852,42,42,20
520,280,1,521,6,2858,58,58,60
521,280,1,522,3,2861,28,28,30
522,280,1,523,6,2867,62,35,60
523,280,1,524,3,2870,57,57,30
524,280,1,525,3,2873,28,28,30
525,280,1,526,2,2875,23,23,20
526,280,1,527,2,2877,19,19,20
527,280,1,528,3,2880,28,28,30
528,280,1,529,6,2886,62,62,60
529,280,1,530,3,2889,29,29,30
530,280,1,531,9,2898,85,55,90
531,280,1,532,5,2903,74,74,50
532,280,1,533,5,2908,56,56,50
533,280,1,534,3,2911,29,29,30
534,280,1,535,4,2915,42,30,40
535,280,1,536,6,2921,79,79,60
536,280,1,537,2,2923,13,13,20
537,280,1,538,7,2930,79,79,70
538,280,1,539,5,2935,45,45,50
539,280,1,540,6,2941,50,50,60
540,280,1,541,3,2944,27,27,30
541,280,1,542,2,2946,21,21,20
542,280,1,543,5,2951,48,48,50
543,280,1,544,2,2953,27,27,20
544,280,1,545,9,2962,98,98,90
545,280,1,546,2,2964,22,22,20
546,280,1,547,5,2969,54,54,50
547,280,1,548,5,2974,46,46,50
548,280,1,549,7,2981,81,81,70
549,280,1,550,8,2989,75,75,80
550,280,1,551,8,2997,89,89,80
551,280,1,552,2,2999,13,13,20
552,280,1,553,3,3002,33,33,30
553,280,1,554,7,3009,84,54,70
554,280,1,555,4,3013,83,57,40
555,280,1,556,9,3022,107,107,90
556,280,1,557,3,3025,29,22,30
557,280,1,558,9,3034,93,93,90
558,280,1,559,8,3042,92,92,80
559,280,1,560,7,3049,64,46,70
560,280,1,561,2,3051,32,32,20
561,280,1,562,8,3059,75,75,80
562,280,1,563,3,3062,24,24,30
563,280,1,564,2,3064,27,27,20
564,280,1,565,7,3071,64,40,70
565,280,1,566,4,3075,72,72,40
566,280,1,567,6,3081,57,57,60
567,280,1,568,9,3090,75,75,90
568,280,1,569,3,3093,24,24,30
569,280,1,570,7,3100,53,53,70
570,280,1,571,7,3107,58,58,70
571,280,1,572,4,3111,37,37,40
572,280,1,573,2,3113,17,17,20
573,280,1,574,5,3118,51,51,50
574,280,1,575,4,3122,30,30,40
575,280,1,576,6,3128,56,56,60
576,280,1,577,5,3133,44,23,50
577,280,1,578,3,3136,46,46,30
578,280,1,579,6,3142,58,58,60
579,280,1,580,5,3147,55,55,50
580,280,1,581,7,3154,67,67,70
581,280,1,582,2,3156,25,12,20
582,280,1,583,2,3158,33,33,20
583,280,1,584,2,3160,21,21,20
584,280,1,585,7,3167,75,75,70
585,280,1,586,9,3176,94,94,90
586,280,1,587,3,3179,27,27,30
587,280,1,588,7,3186,77,77,70
588,280,1,589,5,3191,53,36,50
589,280,1,590,4,3195,63,63,40
590,280,1,591,7,3202,67,67,70
591,280,1,592,4,3206,46,46,40
592,280,1,593,2,3208,17,17,20
593,280,1,594,2,3210,24,24,20
594,280,1,595,4,3214,40,40,40
595,280,1,596,7,3221,83,83,70
596,280,1,597,9,3230,77,50,90
597,280,1,598,7,3237,118,118,70
598,280,1,599,3,3240,30,30,30
599,280,1,600,5,3245,48,48,50
600,280,1,601,9,3254,80,80,90
601,280,1,602,9,3263,100,100,90
602,280,1,603,5,3268,47,47,50
603,280,1,604,9,3277,76,76,90
604,280,1,605,4,3281,40,40,40
605,280,1,606,7,3288,65,65,70
606,280,1,607,3,3291,28,19,30
607,280,1,608,4,3295,59,59,40
608,280,1,609,2,3297,19,19,20
609,280,1,610,9,3306,103,103,90
610,280,1,611,5,3311,53,53,50
611,280,1,612,9,3320,103,103,90
612,280,1,613,9,3329,86,63,90
613,280,1,614,4,3333,77,47,40
614,280,1,615,9,3342,135,135,90
615,280,1,616,9,3351,85,85,90
616,280,1,617,4,3355,53,53,40
617,280,1,618,4,3359,39,39,40
618,280,1,619,7,3366,55,55,70
619,280,1,620,5,3371,59,59,50
620,280,1,621,3,3374,34,34,30
621,280,1,622,9,3383,89,64,90
622,280,1,623,7,3390,98,98,70
623,280,1,624,4,3394,39,39,40
624,280,1,625,9,3403,88,64,90
625,280,1,626,6,3409,65,65,60
626,280,1,627,6,3415,70,70,60
627,280,1,628,8,3423,85,85,80
628,280,1,629,8,3431,73,73,80
629,280,1,630,9,3440,100,65,90
630,280,1,631,6,3446,98,98,60
631,280,1,632,4,3450,48,48,40
632,280,1,633,2,3452,19,10,20
633,280,1,634,9,3461,96,96,90
634,280,1,635,6,3467,50,50,60
635,280,1,636,2,3469,24,24,20
636,280,1,637,3,3472,34,34,30
637,280,1,638,3,3475,32,32,30
638,280,1,639,5,3480,66,66,50
639,280,1,640,8,3488,81,81,80
640,280,1,641,2,3490,20,20,20
641,280,1,642,9,3499,75,53,90
642,280,1,643,5,3504,76,76,50
643,280,1,644,9,3513,83,83,90
644,280,1,645,9,3522,85,85,90
645,280,1,646,6,3528,75,75,60
646,280,1,647,2,3530,16,16,20
647,280,1,648,9,3539,80,56,90
648,280,1,649,2,3541,40,40,20
649,280,1,650,8,3549,89,68,80
650,280,1,651,8,3557,101,101,80
651,280,1,652,6,3563,56,56,60
652,280,1,653,9,3572,94,94,90
653,280,1,654,5,3577,44,34,50
654,280,1,655,2,3579,24,24,20
655,280,1,656,4,3583,36,36,40
656,280,1,657,5,3588,55,55,50
657,280,1,658,6,3594,59,44,60
658,280,1,659,6,3600,76,76,60
659,280,1,660,8,3608,79,79,80
660,280,1,661,8,3616,90,90,80
661,280,1,662,9,3625,88,88,90
662,280,1,663,2,3627,20,20,20
663,280,1,664,9,3636,93,93,90
664,280,1,665,6,3642,54,37,60
665,280,1,666,5,3647,76,76,50
666,280,1,667,7,3654,76,51,70
667,280,1,668,6,3660,99,99,60
668,280,1,669,2,3662,22,13,20
669,280,1,670,4,3666,51,51,40
670,280,1,671,7,3673,79,79,70
671,280,1,672,5,3678,53,53,50
672,280,1,673,6,3684,52,52,60
673,280,1,674,3,3687,32,32,30
674,280,1,675,2,3689,15,15,20
675,280,1,676,7,3696,70,70,70
676,280,1,677,4,3700,46,32,40
677,280,1,678,3,3703,49,49,30
678,280,1,679,7,3710,69,49,70
679,280,1,680,2,3712,44,25,20
680,280,1,681,6,3718,66,66,60
681,280,1,682,5,3723,52,52,50
682,280,1,683,6,3729,72,54,60
683,280,1,684,3,3732,43,28,30
684,280,1,685,3,3735,46,46,30
685,280,1,686,5,3740,45,45,50
686,280,1,687,5,3745,46,46,50
687,280,1,688,9,3754,95,95,90
688,280,1,689,6,3760,54,54,60
689,280,1,690,9,3769,108,108,90
690,280,1,691,7,3776,76,76,70
691,280,1,692,9,3785,106,63,90
692,280,1,693,3,3788,68,68,30
693,280,1,694,9,3797,89,89,90
694,280,1,695,8,3805,75,75,80
695,280,1,696,4,3809,47,47,40
696,280,1,697,2,3811,17,17,20
697,280,1,698,6,3817,68,68,60
698,280,1,699,2,3819,16,16,20
699,280,1,700,8,3827,70,70,80
700,280,1,701,5,3832,38,38,50
701,280,1,702,9,3841,100,100,90
702,280,1,703,7,3848,63,45,70
703,280,1,704,6,3854,71,71,60
704,280,1,705,7,3861,78,78,70
705,280,1,706,2,3863,14,14,20
706,280,1,707,6,3869,61,40,60
707,280,1,708,4,3873,50,50,40
708,280,1,709,5,3878,43,43,50
709,280,1,710,4,3882,41,41,40
710,280,1,711,7,3889,79,79,70
711,280,1,712,6,3895,62,62,60
712,280,1,713,6,3901,53,37,60
713,280,1,714,2,3903,38,38,20
714,280,1,715,8,3911,86,61,80
715,280,1,716,7,3918,83,83,70
716,280,1,717,9,3927,84,84,90
717,280,1,718,2,3929,23,23,20
718,280,1,719,8,3937,109,64,80
719,280,1,720,5,3942,93,93,50
720,280,1,721,2,3944,21,21,20
721,280,1,722,5,3949,43,43,50
722,280,1,723,6,3955,64,45,60
723,280,1,724,2,3957,38,38,20
724,280,1,725,3,3960,32,32,30
725,280,1,726,3,3963,27,27,30
726,280,1,727,2,3965,14,14,20
727,280,1,728,8,3973,77,77,80
728,280,1,729,7,3980,71,71,70
729,280,1,730,4,3984,26,26,40
730,280,1,731,2,3986,24,16,20
731,280,1,732,9,3995,92,92,90
732,280,1,733,4,3999,34,34,40
733,280,1,734,3,4002,34,23,30
734,280,1,735,5,4007,60,47,50
735,280,1,736,7,4014,86,86,70
736,280,1,737,3,4017,27,18,30
737,280,1,738,9,4026,105,81,90
738,280,1,739,5,4031,52,52,50
739,280,1,740,8,4039,77,77,80
740,280,1,741,4,4043,35,35,40
741,280,1,742,5,4048,31,31,50
742,280,1,743,3,4051,28,28,30
743,280,1,744,6,4057,67,67,60
744,280,1,745,6,4063,71,50,60
745,280,1,746,7,4070,88,88,70
746,280,1,747,5,4075,54,54,50
747,280,1,748,7,4082,66,48,70
748,280,1,749,9,4091,110,110,90
749,280,1,750,7,4098,80,80,70
750,280,1,751,3,4101,32,32,30
751,280,1,752,4,4105,40,40,40
752,280,1,753,4,4109,47,47,40
753,280,1,754,8,4117,88,88,80
754,280,1,755,3,4120,24,24,30
755,280,1,756,7,4127,93,93,70
756,280,1,757,8,4135,84,84,80
757,280,1,758,3,4138,33,33,30
758,280,1,759,4,4142,39,39,40
759,280,1,760,6,4148,71,71,60
760,280,1,761,9,4157,98,98,90
761,280,1,762,5,4162,41,41,50
762,280,1,763,8,4170,88,88,80
763,280,1,764,8,4178,91,91,80
764,280,1,765,5,4183,58,58,50
765,280,1,766,2,4185,18,18,20
766,280,1,767,6,4191,65,65,60
767,280,1,768,3,4194,25,25,30
768,280,1,769,3,4197,22,22,30
769,280,1,770,2,4199,20,20,20
770,280,1,771,8,4207,88,52,80
771,280,1,772,8,4215,114,114,80
772,280,1,773,2,4217,22,22,20
773,280,1,774,5,4222,52,37,50
774,280,1,775,7,4229,102,102,70
775,280,1,776,6,4235,70,70,60
776,280,1,777,8,4243,70,70,80
777,280,1,778,8,4251,67,50,80
778,280,1,779,3,4254,58,58,30
779,280,1,780,9,4263,94,94,90
780,280,1,781,7,4270,77,51,70
781,280,1,782,3,4273,61,61,30
782,280,1,783,3,4276,25,18,30
783,280,1,784,6,4282,68,43,60
784,280,1,785,8,4290,102,102,80
785,280,1,786,5,4295,44,30,50
786,280,1,787,8,4303,87,87,80
787,280,1,788,5,4308,56,36,50
788,280,1,789,8,4316,102,66,80
789,280,1,790,7,4323,107,107,70
790,280,1,791,2,4325,20,20,20
791,280,1,792,3,4328,31,31,30
792,280,1,793,2,4330,13,10,20
793,280,1,794,2,4332,30,30,20
794,280,1,795,5,4337,57,57,50
795,280,1,796,2,4339,24,24,20
796,280,1,797,2,4341,15,15,20
797,280,1,798,6,4347,60,60,60
798,280,1,799,5,4352,49,30,50
799,280,1,800,9,4361,107,107,90
800,280,1,801,4,4365,33,33,40
801,280,1,802,6,4371,60,60,60
802,280,1,803,5,4376,56,56,50
803,280,1,804,5,4381,59,59,50
804,280,1,805,3,4384,31,20,30
805,280,1,806,8,4392,96,96,80
806,280,1,807,7,4399,76,76,70
807,280,1,808,8,4407,91,91,80
808,280,1,809,8,4415,84,84,80
809,280,1,810,4,4419,35,35,40
810,280,1,811,5,4424,66,42,50
811,280,1,812,6,4430,76,76,60
812,280,1,813,7,4437,77,77,70
813,280,1,814,4,4441,40,29,40
814,280,1,815,5,4446,67,67,50
815,280,1,816,4,4450,44,30,40
816,280,1,817,2,4452,30,30,20
817,280,1,818,2,4454,19,19,20
818,280,1,819,2,4456,14,14,20
819,280,1,820,8,4464,90,90,80
820,280,1,821,5,4469,55,55,50
821,280,1,822,9,4478,110,110,90
822,280,1,823,4,4482,43,43,40
823,280,1,824,4,4486,37,24,40
824,280,1,825,2,4488,28,28,20
825,280,1,826,3,4491,33,21,30
826,280,1,827,4,4495,51,33,40
827,280,1,828,7,4502,98,98,70
828,280,1,829,2,4504,26,13,20
829,280,1,830,9,4513,99,68,90
830,280,1,831,3,4516,62,62,30
831,280,1,832,8,4524,68,46,80
832,280,1,833,2,4526,38,25,20
833,280,1,834,2,4528,31,31,20
834,280,1,835,9,4537,90,68,90
835,280,1,836,2,4539,39,39,20
836,280,1,837,8,4547,84,84,80
837,280,1,838,7,4554,81,81,70
838,280,1,839,6,4560,69,69,60
839,280,1,840,8,4568,93,93,80
840,280,1,841,7,4575,73,49,70
841,280,1,842,8,4583,104,104,80
842,280,1,843,4,4587,35,35,40
843,280,1,844,6,4593,60,60,60
844,280,1,845,2,4595,15,15,20
845,280,1,846,9,4604,82,82,90
846,280,1,847,5,4609,58,58,50
847,280,1,848,4,4613,41,32,40
848,280,1,849,7,4620,91,91,70
849,280,1,850,3,4623,24,19,30
850,280,1,851,9,4632,83,83,90
851,280,1,852,3,4635,27,27,30
852,280,1,853,8,4643,90,90,80
853,280,1,854,6,4649,76,76,60
854,280,1,855,9,4658,91,91,90
855,280,1,856,6,4664,39,39,60
856,280,1,857,4,4668,43,43,40
857,280,1,858,3,4671,32,32,30
858,280,1,859,9,4680,104,66,90
859,280,1,860,2,4682,57,38,20
860,280,1,861,2,4684,43,43,20
861,280,1,862,3,4687,27,16,30
862,280,1,863,6,4693,71,71,60
863,280,1,864,4,4697,37,37,40
864,280,1,865,2,4699,20,20,20
865,280,1,866,6,4705,65,65,60
866,280,1,867,5,4710,36,36,50
867,280,1,868,4,4714,42,42,40
868,280,1,869,8,4722,83,63,80
869,280,1,870,2,4724,31,31,20
870,280,1,871,2,4726,20,20,20
871,280,1,872,3,4729,43,43,30
872,280,1,873,5,4734,52,52,50
873,280,1,874,6,4740,58,58,60
874,280,1,875,3,4743,38,38,30
875,280,1,876,9,4752,90,90,90
876,280,1,877,5,4757,49,49,50
877,280,1,878,4,4761,48,36,40
878,280,1,879,3,4764,49,49,30
879,280,1,880,8,4772,77,77,80
880,280,1,881,3,4775,22,22,30
881,280,1,882,5,4780,52,52,50
882,280,1,883,7,4787,67,67,70
883,280,1,884,3,4790,28,28,30
884,280,1,885,3,4793,23,23,30
885,280,1,886,7,4800,73,53,70
886,280,1,887,6,4806,74,74,60
887,280,1,888,7,4813,68,68,70
888,280,1,889,6,4819,41,41,60
889,280,1,890,8,4827,77,77,80
890,280,1,891,5,4832,59,59,50
891,280,1,892,3,4835,31,31,30
892,280,1,893,9,4844,86,86,90
893,280,1,894,5,4849,53,53,50
894,280,1,895,4,4853,39,39,40
895,280,1,896,6,4859,59,59,60
896,280,1,897,9,4868,93,93,90
897,280,1,898,8,4876,83,83,80
898,280,1,899,2,4878,24,24,20
899,280,1,900,9,4887,95,95,90
900,280,1,901,3,4890,32,32,30
901,280,1,902,3,4893,34,34,30
902,280,1,903,8,4901,72,45,80
903,280,1,904,9,4910,126,126,90
904,280,1,905,6,4916,66,66,60
905,280,1,906,7,4923,62,47,70
906,280,1,907,9,4932,92,92,90
907,280,1,908,2,4934,26,26,20
908,280,1,909,2,4936,21,21,20
909,280,1,910,6,4942,74,74,60
910,280,1,911,4,4946,39,39,40
911,280,1,912,4,4950,44,44,40
912,280,1,913,6,4956,61,61,60
913,280,1,914,3,4959,38,38,30
914,280,1,915,9,4968,84,84,90
915,280,1,916,7,4975,73,56,70
916,280,1,917,6,4981,78,78,60
917,280,1,918,5,4986,51,51,50
918,280,1,919,3,4989,37,28,30
919,280,1,920,7,4996,81,56,70
920,280,2,1,4,4,39,25,40
921,280,2,2,9,13,105,105,90
922,280,2,3,2,15,17,17,20
923,280,2,4,6,21,58,58,60
924,280,2,5,7,28,64,48,70
925,280,2,6,5,33,56,56,50
926,280,2,7,3,36,25,17,30
927,280,2,8,4,40,58,58,40
928,280,2,9,5,45,46,46,50
929,280,2,10,9,54,91,91,90
930,280,2,11,8,62,72,72,80
931,280,2,12,2,64,30,30,20
932,280,2,13,6,70,42,32,60
933,280,2,14,9,79,105,71,90
934,280,2,15,2,81,53,41,20
935,280,2,16,7,88,71,71,70
936,280,2,17,7,95,65,65,70
937,280,2,18,8,103,71,71,80
938,280,2,19,9,112,90,90,90
939,280,2,20,9,121,82,55,90
940,280,2,21,4,125,67,42,40
941,280,2,22,5,130,79,57,50
942,280,2,23,2,132,47,47,20
943,280,2,24,8,140,76,76,80
944,280,2,25,9,149,97,97,90
945,280,2,26,7,156,71,71,70
946,280,2,27,9,165,68,48,90
947,280,2,28,8,173,101,101,80
948,280,2,29,9,182,98,98,90
949,280,2,30,6,188,55,55,60
950,280,2,31,7,195,50,50,70
951,280,2,32,5,200,41,41,50
952,280,2,33,5,205,61,61,50
953,280,2,34,4,209,50,50,40
954,280,2,35,7,216,71,54,70
955,280,2,36,9,225,104,69,90
956,280,2,37,8,233,120,120,80
957,280,2,38,6,239,58,39,60
958,280,2,39,4,243,54,54,40
959,280,2,40,7,250,63,63,70
960,280,2,41,4,254,40,40,40
961,280,2,42,2,256,16,13,20
962,280,2,43,9,265,95,95,90
963,280,2,44,3,268,32,32,30
964,280,2,45,7,275,77,77,70
965,280,2,46,9,284,89,89,90
966,280,2,47,7,291,76,59,70
967,280,2,48,2,293,38,38,20
968,280,2,49,3,296,28,28,30
969,280,2,50,5,301,51,51,50
970,280,2,51,9,310,95,95,90
971,280,2,52,2,312,17,17,20
972,280,2,53,3,315,34,34,30
973,280,2,54,2,317,18,18,20
974,280,2,55,7,324,78,78,70
975,280,2,56,9,333,93,72,90
976,280,2,57,5,338,71,49,50
977,280,2,58,9,347,113,113,90
978,280,2,59,8,355,70,50,80
979,280,2,60,5,360,63,63,50
980,280,2,61,2,362,26,26,20
981,280,2,62,8,370,70,70,80
982,280,2,63,8,378,76,49,80
983,280,2,64,4,382,60,41,40
984,280,2,65,5,387,72,72,50
985,280,2,66,3,390,36,36,30
986,280,2,67,5,395,43,43,50
987,280,2,68,3,398,34,34,30
988,280,2,69,8,406,67,67,80
989,280,2,70,4,410,34,25,40
990,280,2,71,2,412,33,33,20
991,280,2,72,3,415,31,31,30
992,280,2,73,3,418,28,28,30
993,280,2,74,3,421,28,21,30
994,280,2,75,9,430,101,101,90
995,280,2,76,5,435,57,57,50
996,280,2,77,4,439,47,47,40
997,280,2,78,9,448,93,93,90
998,280,2,79,7,455,80,80,70
999,280,2,80,2,457,24,24,20
1000,280,2,81,8,465,76,76,80
1001,280,2,82,2,467,21,21,20
1002,280,2,83,9,476,95,95,90
1003,280,2,84,9,485,83,83,90
1004,280,2,85,8,493,93,93,80
1005,280,2,86,4,497,48,48,40
1006,280,2,87,4,501,42,42,40
1007,280,2,88,9,510,108,108,90
1008,280,2,89,2,512,22,22,20
1009,280,2,90,4,516,49,49,40
1010,280,2,91,6,522,48,48,60
1011,280,2,92,6,528,66,47,60
1012,280,2,93,8,536,90,90,80
1013,280,2,94,6,542,44,28,60
1014,280,2,95,4,546,55,55,40
1015,280,2,96,4,550,40,40,40
1016,280,2,97,5,555,53,53,50
1017,280,2,98,3,558,31,31,30
1018,280,2,99,6,564,64,64,60
1019,280,2,100,3,567,23,23,30
1020,280,2,101,7,574,63,63,70
1021,280,2,102,7,581,68,68,70
1022,280,2,103,3,584,28,28,30
1023,280,2,104,4,588,32,32,40
1024,280,2,105,9,597,97,97,90
1025,280,2,106,6,603,60,60,60
1026,280,2,107,2,605,19,19,20
1027,280,2,108,4,609,43,43,40
1028,280,2,109,5,614,58,58,50
1029,280,2,110,8,622,91,59,80
1030,280,2,111,9,631,121,121,90
1031,280,2,112,8,639,80,80,80
1032,280,2,113,2,641,10,3,20
1033,280,2,114,6,647,64,64,60
1034,280,2,115,2,649,18,18,20
1035,280,2,116,6,655,63,63,60
1036,280,2,117,6,661,63,63,60
1037,280,2,118,6,667,60,60,60
1038,280,2,119,4,671,45,45,40
1039,280,2,120,7,678,66,49,70
1040,280,2,121,7,685,86,63,70
1041,280,2,122,9,694,117,117,90
1042,280,2,123,5,699,53,34,50
1043,280,2,124,9,708,120,120,90
1044,280,2,125,6,714,63,63,60
1045,280,2,126,2,716,24,15,20
1046,280,2,127,5,721,61,61,50
1047,280,2,128,2,723,28,28,20
1048,280,2,129,7,730,78,78,70
1049,280,2,130,8,738,78,78,80
1050,280,2,131,7,745,70,47,70
1051,280,2,132,6,751,88,88,60
1052,280,2,133,2,753,17,17,20
1053,280,2,134,4,757,36,36,40
1054,280,2,135,7,764,85,85,70
1055,280,2,136,5,769,57,39,50
1056,280,2,137,9,778,117,117,90
1057,280,2,138,8,786,85,85,80
1058,280,2,139,2,788,13,13,20
1059,280,2,140,4,792,44,35,40
1060,280,2,141,7,799,58,58,70
1061,280,2,142,5,804,50,50,50
1062,280,2,143,6,810,65,65,60
1063,280,2,144,5,815,43,43,50
1064,280,2,145,8,823,73,73,80
1065,280,2,146,7,830,70,70,70
1066,280,2,147,3,833,25,25,30
1067,280,2,148,3,836,29,23,30
1068,280,2,149,4,840,43,27,40
1069,280,2,150,3,843,49,49,30
1070,280,2,151,5,848,40,40,50
1071,280,2,152,2,850,11,11,20
1072,280,2,153,5,855,45,45,50
1073,280,2,154,6,861,71,71,60
1074,280,2,155,3,864,27,24,30
1075,280,2,156,7,871,92,92,70
1076,280,2,157,7,878,55,36,70
1077,280,2,158,4,882,52,52,40
1078,280,2,159,9,891,102,102,90
1079,280,2,160,9,900,93,93,90
1080,280,2,161,5,905,47,47,50
1081,280,2,162,7,912,73,73,70
1082,280,2,163,6,918,52,35,60
1083,280,2,164,2,920,40,40,20
1084,280,2,165,2,922,28,28,20
1085,280,2,166,8,930,94,94,80
1086,280,2,167,6,936,61,61,60
1087,280,2,168,8,944,87,87,80
1088,280,2,169,9,953,77,77,90
1089,280,2,170,2,955,18,10,20
1090,280,2,171,2,957,25,25,20
1091,280,2,172,6,963,60,60,60
1092,280,2,173,3,966,27,27,30
1093,280,2,174,2,968,17,17,20
1094,280,2,175,3,971,30,22,30
1095,280,2,176,4,975,56,56,40
1096,280,2,177,2,977,10,10,20
1097,280,2,178,4,981,45,29,40
1098,280,2,179,2,983,29,29,20
1099,280,2,180,6,989,66,66,60
1100,280,2,181,8,997,83,83,80
1101,280,2,182,4,1001,42,42,40
1102,280,2,183,6,1007,58,58,60
1103,280,2,184,6,1013,57,57,60
1104,280,2,185,8,1021,75,75,80
1105,280,2,186,2,1023,19,19,20
1106,280,2,187,6,1029,57,57,60
1107,280,2,188,9,1038,81,81,90
1108,280,2,189,8,1046,74,52,80
1109,280,2,190,7,1053,91,91,70
1110,280,2,191,8,1061,87,57,80
1111,280,2,192,6,1067,88,88,60
1112,280,2,193,9,1076,79,79,90
1113,280,2,194,2,1078,20,20,20
1114,280,2,195,5,1083,53,53,50
1115,280,2,196,8,1091,85,85,80
1116,280,2,197,7,1098,88,88,70
1117,280,2,198,6,1104,55,55,60
1118,280,2,199,9,1113,81,55,90
1119,280,2,200,4,1117,64,64,40
1120,280,2,201,6,1123,65,65,60
1121,280,2,202,2,1125,17,17,20
1122,280,2,203,6,1131,68,68,60
1123,280,2,204,5,1136,48,48,50
1124,280,2,205,2,1138,28,17,20
1125,280,2,206,8,1146,92,92,80
1126,280,2,207,2,1148,27,27,20
1127,280,2,208,4,1152,35,35,40
1128,280,2,209,6,1158,61,61,60
1129,280,2,210,4,1162,34,24,40
1130,280,2,211,3,1165,35,35,30
1131,280,2,212,7,1172,59,59,70
1132,280,2,213,5,1177,39,39,50
1133,280,2,214,2,1179,20,20,20
1134,280,2,215,9,1188,92,69,90
1135,280,2,216,7,1195,105,105,70
1136,280,2,217,8,1203,72,72,80
1137,280,2,218,3,1206,26,26,30
1138,280,2,219,6,1212,71,47,60
1139,280,2,220,5,1217,67,67,50
1140,280,2,221,9,1226,77,77,90
1141,280,2,222,4,1230,39,39,40
1142,280,2,223,5,1235,49,49,50
1143,280,2,224,2,1237,18,18,20
1144,280,2,225,8,1245,96,69,80
1145,280,2,226,2,1247,42,42,20
1146,280,2,227,8,1255,97,97,80
1147,280,2,228,6,1261,65,65,60
1148,280,2,229,9,1270,95,63,90
1149,280,2,230,5,1275,84,84,50
1150,280,2,231,2,1277,21,13,20
1151,280,2,232,2,1279,29,18,20
1152,280,2,233,6,1285,79,79,60
1153,280,2,234,7,1292,56,56,70
1154,280,2,235,9,1301,95,95,90
1155,280,2,236,8,1309,95,95,80
1156,280,2,237,9,1318,83,57,90
1157,280,2,238,5,1323,67,43,50
1158,280,2,239,5,1328,80,80,50
1159,280,2,240,5,1333,47,47,50
1160,280,2,241,2,1335,22,13,20
1161,280,2,242,5,1340,65,65,50
1162,280,2,243,9,1349,82,82,90
1163,280,2,244,6,1355,57,57,60
1164,280,2,245,5,1360,51,51,50
1165,280,2,246,8,1368,75,75,80
1166,280,2,247,5,1373,45,36,50
1167,280,2,248,9,1382,93,93,90
1168,280,2,249,3,1385,32,32,30
1169,280,2,250,3,1388,34,34,30
1170,280,2,251,7,1395,71,71,70
1171,280,2,252,2,1397,19,19,20
1172,280,2,253,6,1403,71,71,60
1173,280,2,254,5,1408,49,49,50
1174,280,2,255,5,1413,42,42,50
1175,280,2,256,3,1416,31,31,30
1176,280,2,257,3,1419,33,33,30
1177,280,2,258,5,1424,38,38,50
1178,280,2,259,9,1433,83,83,90
1179,280,2,260,5,1438,44,44,50
1180,280,2,261,6,1444,51,31,60
1181,280,2,262,7,1451,101,101,70
1182,280,2,263,5,1456,48,48,50
1183,280,2,264,4,1460,41,41,40
1184,280,2,265,2,1462,19,19,20
1185,280,2,266,7,1469,70,52,70
1186,280,2,267,4,1473,56,56,40
1187,280,2,268,4,1477,41,41,40
1188,280,2,269,6,1483,59,59,60
1189,280,2,270,9,1492,111,111,90
1190,280,2,271,4,1496,30,18,40
1191,280,2,272,9,1505,99,99,90
1192,280,2,273,4,1509,51,51,40
1193,280,2,274,6,1515,56,56,60
1194,280,2,275,8,1523,79,79,80
1195,280,2,276,3,1526,24,24,30
1196,280,2,277,3,1529,30,30,30
1197,280,2,278,2,1531,13,13,20
1198,280,2,279,3,1534,28,28,30
1199,280,2,280,8,1542,80,54,80
1200,280,2,281,9,1551,118,118,90
1201,280,2,282,5,1556,46,46,50
1202,280,2,283,9,1565,96,64,90
1203,280,2,284,5,1570,78,78,50
1204,280,2,285,9,1579,88,88,90
1205,280,2,286,6,1585,58,42,60
1206,280,2,287,4,1589,58,47,40
1207,280,2,288,2,1591,28,20,20
1208,280,2,289,6,1597,99,99,60
1209,280,2,290,6,1603,42,25,60
1210,280,2,291,2,1605,43,43,20
1211,280,2,292,6,1611,61,46,60
1212,280,2,293,7,1618,91,91,70
1213,280,2,294,9,1627,75,75,90
1214,280,2,295,7,1634,71,71,70
1215,280,2,296,7,1641,76,76,70
1216,280,2,297,3,1644,25,25,30
1217,280,2,298,7,1651,64,64,70
1218,280,2,299,6,1657,67,67,60
1219,280,2,300,7,1664,66,66,70
1220,280,2,301,3,1667,27,27,30
1221,280,2,302,3,1670,28,28,30
1222,280,2,303,4,1674,39,29,40
1223,280,2,304,2,1676,26,26,20
1224,280,2,305,9,1685,98,98,90
1225,280,2,306,2,1687,22,15,20
1226,280,2,307,4,1691,43,26,40
1227,280,2,308,6,1697,76,76,60
1228,280,2,309,8,1705,65,65,80
1229,280,2,310,7,1712,76,76,70
1230,280,2,311,4,1716,41,30,40
1231,280,2,312,7,1723,73,73,70
1232,280,2,313,2,1725,15,15,20
1233,280,2,314,5,1730,55,55,50
1234,280,2,315,9,1739,84,59,90
1235,280,2,316,9,1748,126,126,90
1236,280,2,317,6,1754,51,33,60
1237,280,2,318,7,1761,90,90,70
1238,280,2,319,3,1764,30,30,30
1239,280,2,320,2,1766,19,19,20
1240,280,2,321,7,1773,81,81,70
1241,280,2,322,2,1775,22,22,20
1242,280,2,323,9,1784,77,77,90
1243,280,2,324,3,1787,37,37,30
1244,280,2,325,2,1789,19,19,20
1245,280,2,326,2,1791,17,17,20
1246,280,2,327,7,1798,69,53,70
1247,280,2,328,4,1802,51,36,40
1248,280,2,329,5,1807,66,43,50
1249,280,2,330,9,1816,105,105,90
1250,280,2,331,7,1823,73,73,70
1251,280,2,332,6,1829,72,50,60
1252,280,2,333,3,1832,52,52,30
1253,280,2,334,6,1838,59,59,60
1254,280,2,335,9,1847,92,92,90
1255,280,2,336,7,1854,65,65,70
1256,280,2,337,7,1861,65,65,70
1257,280,2,338,3,1864,31,31,30
1258,280,2,339,2,1866,16,16,20
1259,280,2,340,7,1873,84,84,70
1260,280,2,341,2,1875,19,19,20
1261,280,2,342,8,1883,94,94,80
1262,280,2,343,6,1889,75,75,60
1263,280,2,344,4,1893,46,36,40
1264,280,2,345,5,1898,54,54,50
1265,280,2,346,2,1900,19,19,20
1266,280,2,347,8,1908,90,90,80
1267,280,2,348,4,1912,38,32,40
1268,280,2,349,9,1921,92,92,90
1269,280,2,350,6,1927,72,72,60
1270,280,2,351,4,1931,35,35,40
1271,280,2,352,6,1937,63,43,60
1272,280,2,353,6,1943,79,79,60
1273,280,2,354,7,1950,67,67,70
1274,280,2,355,7,1957,67,46,70
1275,280,2,356,7,1964,86,86,70
1276,280,2,357,2,1966,24,24,20
1277,280,2,358,2,1968,30,30,20
1278,280,2,359,8,1976,81,81,80
1279,280,2,360,6,1982,66,66,60
1280,280,2,361,3,1985,28,28,30
1281,280,2,362,4,1989,44,44,40
1282,280,2,363,8,1997,69,52,80
1283,280,2,364,2,1999,38,25,20
1284,280,2,365,4,2003,46,46,40
1285,280,2,366,8,2011,95,67,80
1286,280,2,367,5,2016,93,93,50
1287,280,2,368,7,2023,64,41,70
1288,280,2,369,4,2027,65,65,40
1289,280,2,370,8,2035,77,77,80
1290,280,2,371,4,2039,40,40,40
1291,280,2,372,8,2047,71,71,80
1292,280,2,373,4,2051,43,43,40
1293,280,2,374,5,2056,52,52,50
1294,280,2,375,5,2061,50,29,50
1295,280,2,376,8,2069,110,110,80
1296,280,2,377,7,2076,66,44,70
1297,280,2,378,3,2079,57,57,30
1298,280,2,379,7,2086,64,64,70
1299,280,2,380,7,2093,69,69,70
1300,280,2,381,2,2095,18,18,20
1301,280,2,382,2,2097,22,22,20
1302,280,2,383,2,2099,17,17,20
1303,280,2,384,5,2104,55,55,50
1304,280,2,385,7,2111,85,56,70
1305,280,2,386,8,2119,109,109,80
1306,280,2,387,9,2128,101,101,90
1307,280,2,388,7,2135,70,70,70
1308,280,2,389,3,2138,29,29,30
1309,280,2,390,4,2142,49,49,40
1310,280,2,391,8,2150,104,68,80
1311,280,2,392,9,2159,119,119,90
1312,280,2,393,3,2162,35,35,30
1313,280,2,394,3,2165,32,32,30
1314,280,2,395,2,2167,23,23,20
1315,280,2,396,3,2170,26,26,30
1316,280,2,397,9,2179,87,87,90
1317,280,2,398,9,2188,88,88,90
1318,280,2,399,4,2192,42,30,40
1319,280,2,400,8,2200,90,58,80
1320,280,2,401,2,2202,44,44,20
1321,280,2,402,4,2206,32,32,40
1322,280,2,403,4,2210,41,41,40
1323,280,2,404,8,2218,83,83,80
1324,280,2,405,2,2220,29,17,20
1325,280,2,406,2,2222,32,23,20
1326,280,2,407,2,2224,29,23,20
1327,280,2,408,8,2232,84,66,80
1328,280,2,409,2,2234,38,38,20
1329,280,2,410,3,2237,41,41,30
1330,280,2,411,8,2245,70,70,80
1331,280,2,412,5,2250,39,39,50
1332,280,2,413,2,2252,20,20,20
1333,280,2,414,3,2255,20,20,30
1334,280,2,415,3,2258,31,31,30
1335,280,2,416,6,2264,52,52,60
1336,280,2,417,3,2267,25,25,30
1337,280,2,418,4,2271,42,27,40
1338,280,2,419,4,2275,51,51,40
1339,280,2,420,4,2279,31,31,40
1340,280,2,421,5,2284,57,57,50
1341,280,2,422,9,2293,109,77,90
1342,280,2,423,9,2302,117,117,90
1343,280,2,424,2,2304,20,20,20
1344,280,2,425,9,2313,101,101,90
1345,280,2,426,7,2320,85,85,70
1346,280,2,427,5,2325,48,48,50
1347,280,2,428,7,2332,70,45,70
1348,280,2,429,4,2336,72,72,40
1349,280,2,430,2,2338,19,19,20
1350,280,2,431,6,2344,60,60,60
1351,280,2,432,5,2349,53,53,50
1352,280,2,433,8,2357,63,63,80
1353,280,2,434,5,2362,44,44,50
1354,280,2,435,9,2371,84,54,90
1355,280,2,436,6,2377,105,105,60
1356,280,2,437,9,2386,101,101,90
1357,280,2,438,8,2394,93,93,80
1358,280,2,439,6,2400,53,53,60
1359,280,2,440,8,2408,70,70,80
1360,280,2,441,4,2412,45,45,40
1361,280,2,442,6,2418,85,85,60
1362,280,2,443,5,2423,48,48,50
1363,280,2,444,3,2426,26,26,30
1364,280,2,445,6,2432,61,61,60
1365,280,2,446,3,2435,28,28,30
1366,280,2,447,8,2443,82,82,80
1367,280,2,448,9,2452,80,57,90
1368,280,2,449,2,2454,38,38,20
1369,280,2,450,4,2458,49,49,40
1370,280,2,451,6,2464,50,50,60
1371,280,2,452,5,2469,38,38,50
1372,280,2,453,3,2472,28,28,30
1373,280,2,454,8,2480,78,78,80
1374,280,2,455,8,2488,72,72,80
1375,280,2,456,9,2497,105,74,90
1376,280,2,457,7,2504,104,104,70
1377,280,2,458,4,2508,35,35,40
1378,280,2,459,7,2515,71,71,70
1379,280,2,460,2,2517,11,11,20
1380,280,2,461,8,2525,72,72,80
1381,280,2,462,5,2530,55,55,50
1382,280,2,463,5,2535,50,50,50
1383,280,2,464,9,2544,93,93,90
1384,280,2,465,3,2547,37,24,30
1385,280,2,466,9,2556,87,87,90
1386,280,2,467,2,2558,15,9,20
1387,280,2,468,9,2567,100,100,90
1388,280,2,469,7,2574,62,62,70
1389,280,2,470,3,2577,28,28,30
1390,280,2,471,7,2584,66,66,70
1391,280,2,472,6,2590,55,55,60
1392,280,2,473,4,2594,25,25,40
1393,280,2,474,4,2598,37,37,40
1394,280,2,475,6,2604,66,66,60
1395,280,2,476,6,2610,53,53,60
1396,280,2,477,6,2616,50,34,60
1397,280,2,478,4,2620,53,53,40
1398,280,2,479,2,2622,16,16,20
1399,280,2,480,2,2624,10,10,20
1400,280,2,481,6,2630,58,58,60
1401,280,2,482,8,2638,72,72,80
1402,280,2,483,2,2640,15,15,20
1403,280,2,484,6,2646,58,58,60
1404,280,2,485,6,2652,45,45,60
1405,280,2,486,5,2657,48,48,50
1406,280,2,487,4,2661,44,25,40
1407,280,2,488,9,2670,110,110,90
1408,280,2,489,9,2679,87,87,90
1409,280,2,490,3,2682,23,23,30
1410,280,2,491,3,2685,33,33,30
1411,280,2,492,3,2688,30,30,30
1412,280,2,493,2,2690,15,15,20
1413,280,2,494,5,2695,41,41,50
1414,280,2,495,5,2700,49,49,50
1415,280,2,496,8,2708,97,97,80
1416,280,2,497,9,2717,92,92,90
1417,280,2,498,7,2724,67,67,70
1418,280,2,499,4,2728,43,43,40
1419,280,2,500,6,2734,69,49,60
1420,280,2,501,7,2741,94,94,70
1421,280,2,502,4,2745,43,43,40
1422,280,2,503,3,2748,34,23,30
1423,280,2,504,6,2754,73,73,60
1424,280,2,505,3,2757,27,27,30
1425,280,2,506,2,2759,19,19,20
1426,280,2,507,5,2764,50,35,50
1427,280,2,508,4,2768,54,54,40
1428,280,2,509,2,2770,18,12,20
1429,280,2,510,5,2775,49,49,50
1430,280,2,511,4,2779,28,19,40
1431,280,2,512,8,2787,93,93,80
1432,280,2,513,8,2795,79,51,80
1433,280,2,514,8,2803,113,113,80
1434,280,2,515,9,2812,85,64,90
1435,280,2,516,7,2819,84,84,70
1436,280,2,517,6,2825,56,40,60
1437,280,2,518,9,2834,116,116,90
1438,280,2,519,8,2842,71,71,80
1439,280,2,520,8,2850,82,58,80
1440,280,2,521,8,2858,95,95,80
1441,280,2,522,5,2863,50,50,50
1442,280,2,523,6,2869,49,49,60
1443,280,2,524,5,2874,49,49,50
1444,280,2,525,5,2879,43,27,50
1445,280,2,526,2,2881,35,35,20
1446,280,2,527,3,2884,21,21,30
1447,280,2,528,9,2893,92,92,90
1448,280,2,529,9,2902,100,100,90
1449,280,2,530,4,2906,45,45,40
1450,280,2,531,9,2915,80,80,90
1451,280,2,532,8,2923,71,71,80
1452,280,2,533,5,2928,40,40,50
1453,280,2,534,8,2936,85,58,80
1454,280,2,535,7,2943,94,59,70
1455,280,2,536,4,2947,65,65,40
1456,280,2,537,5,2952,43,43,50
1457,280,2,538,6,2958,68,68,60
1458,280,2,539,2,2960,20,20,20
1459,280,2,540,3,2963,36,27,30
1460,280,2,541,9,2972,114,114,90
1461,280,2,542,7,2979,80,80,70
1462,280,2,543,7,2986,70,70,70
1463,280,2,544,3,2989,45,45,30
1464,280,2,545,5,2994,42,42,50
1465,280,2,546,6,3000,67,67,60
1466,280,2,547,3,3003,32,32,30
1467,280,2,548,9,3012,79,79,90
1468,280,2,549,2,3014,17,17,20
1469,280,2,550,9,3023,98,98,90
1470,280,2,551,4,3027,44,44,40
1471,280,2,552,4,3031,36,36,40
1472,280,2,553,5,3036,60,60,50
1473,280,2,554,3,3039,40,40,30
1474,280,2,555,4,3043,43,31,40
1475,280,2,556,8,3051,101,70,80
1476,280,2,557,7,3058,107,107,70
1477,280,2,558,2,3060,17,17,20
1478,280,2,559,7,3067,65,65,70
1479,280,2,560,5,3072,56,56,50
1480,280,2,561,5,3077,61,61,50
1481,280,2,562,3,3080,29,21,30
1482,280,2,563,6,3086,66,66,60
1483,280,2,564,4,3090,41,25,40
1484,280,2,565,2,3092,33,24,20
1485,280,2,566,3,3095,41,41,30
1486,280,2,567,5,3100,38,38,50
1487,280,2,568,5,3105,51,51,50
1488,280,2,569,8,3113,70,70,80
1489,280,2,570,5,3118,50,50,50
1490,280,2,571,8,3126,84,61,80
1491,280,2,572,4,3130,61,61,40
1492,280,2,573,6,3136,55,39,60
1493,280,2,574,7,3143,94,62,70
1494,280,2,575,3,3146,61,37,30
1495,280,2,576,4,3150,54,36,40
1496,280,2,577,3,3153,48,48,30
1497,280,2,578,8,3161,79,79,80
1498,280,2,579,6,3167,65,43,60
1499,280,2,580,5,3172,80,59,50
1500,280,2,581,9,3181,91,91,90
1501,280,2,582,2,3183,23,14,20
1502,280,2,583,5,3188,55,55,50
1503,280,2,584,7,3195,57,57,70
1504,280,2,585,8,3203,94,66,80
1505,280,2,586,7,3210,96,64,70
1506,280,2,587,2,3212,45,45,20
1507,280,2,588,3,3215,32,32,30
1508,280,2,589,5,3220,51,51,50
1509,280,2,590,6,3226,54,38,60
1510,280,2,591,2,3228,39,39,20
1511,280,2,592,9,3237,84,84,90
1512,280,2,593,7,3244,82,82,70
1513,280,2,594,6,3250,56,35,60
1514,280,2,595,8,3258,99,99,80
1515,280,2,596,8,3266,79,79,80
1516,280,2,597,9,3275,95,95,90
1517,280,2,598,8,3283,83,83,80
1518,280,2,599,4,3287,33,33,40
1519,280,2,600,2,3289,13,13,20
1520,280,2,601,4,3293,32,32,40
1521,280,2,602,3,3296,31,31,30
1522,280,2,603,7,3303,60,60,70
1523,280,2,604,8,3311,75,57,80
1524,280,2,605,6,3317,85,59,60
1525,280,2,606,9,3326,104,104,90
1526,280,2,607,6,3332,70,70,60
1527,280,2,608,6,3338,65,47,60
1528,280,2,609,9,3347,115,115,90
1529,280,2,610,8,3355,91,91,80
1530,280,2,611,8,3363,88,88,80
1531,280,2,612,6,3369,64,64,60
1532,280,2,613,2,3371,23,23,20
1533,280,2,614,2,3373,22,22,20
1534,280,2,615,6,3379,55,55,60
1535,280,2,616,7,3386,64,64,70
1536,280,2,617,5,3391,38,38,50
1537,280,2,618,5,3396,45,34,50
1538,280,2,619,8,3404,89,89,80
1539,280,2,620,2,3406,32,32,20
1540,280,2,621,2,3408,27,27,20
1541,280,2,622,9,3417,81,50,90
1542,280,2,623,8,3425,114,114,80
1543,280,2,624,5,3430,47,47,50
1544,280,2,625,8,3438,92,92,80
1545,280,2,626,4,3442,32,32,40
1546,280,2,627,4,3446,42,42,40
1547,280,2,628,6,3452,69,69,60
1548,280,2,629,7,3459,58,58,70
1549,280,2,630,3,3462,30,30,30
1550,280,2,631,8,3470,75,75,80
1551,280,2,632,7,3477,85,85,70
1552,280,2,633,8,3485,62,62,80
1553,280,2,634,7,3492,73,51,70
1554,280,2,635,8,3500,96,96,80
1555,280,2,636,6,3506,64,64,60
1556,280,2,637,3,3509,32,24,30
1557,280,2,638,3,3512,40,28,30
1558,280,2,639,8,3520,98,98,80
1559,280,2,640,4,3524,46,29,40
1560,280,2,641,3,3527,48,48,30
1561,280,2,642,7,3534,70,70,70
1562,280,2,643,7,3541,68,68,70
1563,280,2,644,2,3543,15,10,20
1564,280,2,645,8,3551,86,86,80
1565,280,2,646,8,3559,93,93,80
1566,280,2,647,2,3561,20,15,20
1567,280,2,648,6,3567,47,33,60
1568,280,2,649,6,3573,73,73,60
1569,280,2,650,8,3581,90,90,80
1570,280,2,651,5,3586,56,56,50
1571,280,2,652,7,3593,82,82,70
1572,280,2,653,3,3596,26,26,30
1573,280,2,654,9,3605,92,92,90
1574,280,2,655,5,3610,37,37,50
1575,280,2,656,5,3615,42,29,50
1576,280,2,657,8,3623,88,88,80
1577,280,2,658,6,3629,62,38,60
1578,280,2,659,9,3638,121,121,90
1579,280,2,660,6,3644,70,70,60
1580,280,2,661,2,3646,20,20,20
1581,280,2,662,6,3652,65,65,60
1582,280,2,663,2,3654,24,22,20
1583,280,2,664,7,3661,78,78,70
1584,280,2,665,6,3667,60,60,60
1585,280,2,666,3,3670,28,28,30
1586,280,2,667,7,3677,82,82,70
1587,280,2,668,5,3682,33,33,50
1588,280,2,669,5,3687,56,56,50
1589,280,2,670,3,3690,28,21,30
1590,280,2,671,4,3694,50,50,40
1591,280,2,672,7,3701,92,92,70
1592,280,2,673,8,3709,71,71,80
1593,280,2,674,7,3716,69,69,70
1594,280,2,675,5,3721,56,56,50
1595,280,2,676,9,3730,93,93,90
1596,280,2,677,7,3737,66,41,70
1597,280,2,678,8,3745,90,63,80
1598,280,2,679,3,3748,47,47,30
1599,280,2,680,7,3755,58,58,70
1600,280,2,681,4,3759,47,31,40
1601,280,2,682,3,3762,41,26,30
1602,280,2,683,5,3767,69,69,50
1603,280,2,684,7,3774,73,57,70
1604,280,2,685,6,3780,73,73,60
1605,280,2,686,2,3782,15,15,20
1606,280,2,687,5,3787,55,55,50
1607,280,2,688,6,3793,61,61,60
1608,280,2,689,7,3800,78,78,70
1609,280,2,690,4,3804,33,33,40
1610,280,2,691,4,3808,37,37,40
1611,280,2,692,5,3813,41,41,50
1612,280,2,693,4,3817,37,37,40
1613,280,2,694,4,3821,42,42,40
1614,280,2,695,2,3823,14,14,20
1615,280,2,696,8,3831,73,54,80
1616,280,2,697,8,3839,98,72,80
1617,280,2,698,2,3841,46,32,20
1618,280,2,699,7,3848,86,86,70
1619,280,2,700,6,3854,54,54,60
1620,280,2,701,8,3862,82,82,80
1621,280,2,702,7,3869,63,63,70
1622,280,2,703,2,3871,24,24,20
1623,280,2,704,2,3873,18,18,20
1624,280,2,705,3,3876,28,28,30
1625,280,2,706,6,3882,47,47,60
1626,280,2,707,8,3890,89,64,80
1627,280,2,708,7,3897,108,108,70
1628,280,2,709,9,3906,95,59,90
1629,280,2,710,3,3909,72,72,30
1630,280,2,711,5,3914,43,43,50
1631,280,2,712,4,3918,43,27,40
1632,280,2,713,2,3920,38,38,20
1633,280,2,714,7,3927,72,72,70
1634,280,2,715,2,3929,20,20,20
1635,280,2,716,2,3931,16,16,20
1636,280,2,717,5,3936,50,50,50
1637,280,2,718,9,3945,85,85,90
1638,280,2,719,6,3951,72,50,60
1639,280,2,720,5,3956,68,68,50
1640,280,2,721,6,3962,56,56,60
1641,280,2,722,8,3970,76,48,80
1642,280,2,723,9,3979,120,120,90
1643,280,2,724,4,3983,38,38,40
1644,280,2,725,4,3987,47,47,40
1645,280,2,726,2,3989,15,10,20
1646,280,2,727,8,3997,98,98,80
1647,280,2,728,9,4006,103,103,90
1648,280,2,729,5,4011,42,42,50
1649,280,2,730,6,4017,59,59,60
1650,280,2,731,4,4021,47,47,40
1651,280,2,732,3,4024,32,32,30
1652,280,2,733,6,4030,72,72,60
1653,280,2,734,7,4037,60,60,70
1654,280,2,735,6,4043,54,54,60
1655,280,2,736,5,4048,47,33,50
1656,280,2,737,3,4051,42,42,30
1657,280,2,738,4,4055,32,32,40
1658,280,2,739,3,4058,30,30,30
1659,280,2,740,2,4060,20,20,20
1660,280,2,741,2,4062,24,24,20
1661,280,2,742,5,4067,55,41,50
1662,280,2,743,9,4076,115,115,90
1663,280,2,744,6,4082,48,48,60
1664,280,2,745,2,4084,22,22,20
1665,280,2,746,2,4086,21,13,20
1666,280,2,747,7,4093,80,80,70
1667,280,2,748,7,4100,67,67,70
1668,280,2,749,2,4102,22,15,20
1669,280,2,750,9,4111,104,76,90
1670,280,2,751,6,4117,98,98,60
1671,280,2,752,4,4121,39,39,40
1672,280,2,753,8,4129,79,79,80
1673,280,2,754,2,4131,20,20,20
1674,280,2,755,9,4140,78,78,90
1675,280,2,756,9,4149,83,83,90
1676,280,2,757,6,4155,53,35,60
1677,280,2,758,2,4157,35,20,20
1678,280,2,759,5,4162,76,76,50
1679,280,2,760,6,4168,64,42,60
1680,280,2,761,8,4176,101,101,80
1681,280,2,762,3,4179,24,24,30
1682,280,2,763,9,4188,102,102,90
1683,280,2,764,5,4193,50,33,50
1684,280,2,765,9,4202,115,115,90
1685,280,2,766,5,4207,53,53,50
1686,280,2,767,3,4210,28,16,30
1687,280,2,768,4,4214,45,45,40
1688,280,2,769,8,4222,92,92,80
1689,280,2,770,6,4228,53,53,60
1690,280,2,771,2,4230,12,12,20
1691,280,2,772,6,4236,66,66,60
1692,280,2,773,3,4239,28,28,30
1693,280,2,774,8,4247,59,43,80
1694,280,2,775,2,4249,40,23,20
1695,280,2,776,5,4254,74,74,50
1696,280,2,777,3,4257,26,26,30
1697,280,2,778,2,4259,15,15,20
1698,280,2,779,8,4267,90,90,80
1699,280,2,780,8,4275,63,63,80
1700,280,2,781,6,4281,62,62,60
1701,280,2,782,8,4289,73,73,80
1702,280,2,783,2,4291,22,13,20
1703,280,2,784,4,4295,45,45,40
1704,280,2,785,8,4303,88,88,80
1705,280,2,786,9,4312,80,80,90
1706,280,2,787,7,4319,52,52,70
1707,280,2,788,7,4326,64,64,70
1708,280,2,789,9,4335,81,81,90
1709,280,2,790,8,4343,69,69,80
1710,280,2,791,6,4349,59,59,60
1711,280,2,792,3,4352,34,34,30
1712,280,2,793,7,4359,61,43,70
1713,280,2,794,8,4367,99,99,80
1714,280,2,795,8,4375,75,75,80
1715,280,2,796,9,4384,93,93,90
1716,280,2,797,9,4393,81,81,90
1717,280,2,798,9,4402,91,91,90
1718,280,2,799,9,4411,105,105,90
1719,280,2,800,5,4416,57,57,50
1720,280,2,801,5,4421,49,49,50
1721,280,2,802,8,4429,71,71,80
1722,280,2,803,3,4432,20,15,30
1723,280,2,804,6,4438,69,69,60
1724,280,2,805,7,4445,71,48,70
1725,280,2,806,3,4448,55,55,30
1726,280,2,807,9,4457,105,105,90
1727,280,2,808,9,4466,103,103,90
1728,280,2,809,6,4472,57,57,60
1729,280,2,810,2,4474,23,23,20
1730,280,2,811,7,4481,66,66,70
1731,280,2,812,2,4483,13,13,20
1732,280,2,813,5,4488,39,24,50
1733,280,2,814,8,4496,92,92,80
1734,280,2,815,7,4503,73,54,70
1735,280,2,816,8,4511,111,80,80
1736,280,2,817,9,4520,127,127,90
1737,280,2,818,2,4522,14,14,20
1738,280,2,819,2,4524,19,19,20
1739,280,2,820,6,4530,53,34,60
1740,280,2,821,9,4539,114,114,90
1741,280,2,822,6,4545,44,44,60
1742,280,2,823,7,4552,74,74,70
1743,280,2,824,6,4558,65,65,60
1744,280,2,825,9,4567,76,76,90
1745,280,2,826,4,4571,26,26,40
1746,280,2,827,6,4577,51,51,60
1747,280,2,828,4,4581,38,28,40
1748,280,2,829,7,4588,79,57,70
1749,280,2,830,8,4596,111,111,80
1750,280,2,831,5,4601,56,34,50
1751,280,2,832,8,4609,113,80,80
1752,280,2,833,2,4611,55,55,20
1753,280,2,834,2,4613,15,11,20
1754,280,2,835,4,4617,43,28,40
1755,280,2,836,5,4622,58,38,50
1756,280,2,837,9,4631,104,104,90
1757,280,2,838,3,4634,27,21,30
1758,280,2,839,6,4640,64,64,60
1759,280,2,840,8,4648,92,63,80
1760,280,2,841,4,4652,69,69,40
1761,280,2,842,4,4656,34,23,40
1762,280,2,843,8,4664,89,89,80
1763,280,2,844,5,4669,49,49,50
1764,280,2,845,3,4672,40,40,30
1765,280,2,846,3,4675,31,31,30
1766,280,2,847,2,4677,21,21,20
1767,280,2,848,4,4681,39,39,40
1768,280,2,849,4,4685,42,42,40
1769,280,2,850,2,4687,21,21,20
1770,280,2,851,9,4696,103,103,90
1771,280,2,852,2,4698,27,15,20
1772,280,2,853,2,4700,31,21,20
1773,280,2,854,9,4709,98,98,90
1774,280,2,855,7,4716,86,61,70
1775,280,2,856,8,4724,116,116,80
1776,280,2,857,9,4733,90,90,90
1777,280,2,858,9,4742,108,108,90
1778,280,2,859,8,4750,84,84,80
1779,280,2,860,8,4758,78,78,80
1780,280,2,861,5,4763,40,40,50
1781,280,2,862,8,4771,77,77,80
1782,280,2,863,6,4777,56,33,60
1783,280,2,864,4,4781,64,50,40
1784,280,2,865,8,4789,95,95,80
1785,280,2,866,9,4798,99,99,90
1786,280,2,867,9,4807,77,77,90
1787,280,2,868,8,4815,87,87,80
1788,280,2,869,9,4824,91,91,90
1789,280,2,870,7,4831,86,86,70
1790,280,2,871,2,4833,16,16,20
1791,280,2,872,2,4835,26,26,20
1792,280,2,873,2,4837,21,21,20
1793,280,2,874,7,4844,68,68,70
1794,280,2,875,3,4847,26,26,30
1795,280,2,876,5,4852,61,61,50
1796,280,2,877,9,4861,81,47,90
1797,280,2,878,2,4863,53,35,20
1798,280,2,879,2,4865,43,43,20
1799,280,2,880,3,4868,26,26,30
1800,280,2,881,3,4871,32,32,30
1801,280,2,882,8,4879,73,73,80
1802,280,2,883,4,4883,28,20,40
1803,280,2,884,6,4889,68,68,60
1804,280,2,885,2,4891,16,16,20
1805,280,2,886,7,4898,61,37,70
1806,280,2,887,6,4904,83,60,60
1807,280,2,888,7,4911,87,64,70
1808,280,2,889,5,4916,64,64,50
1809,280,2,890,4,4920,41,41,40
1810,280,2,891,3,4923,29,20,30
1811,280,2,892,3,4926,30,30,30
1812,280,2,893,5,4931,60,60,50
1813,280,2,894,4,4935,39,39,40
1814,280,2,895,6,4941,64,64,60
1815,280,2,896,2,4943,22,22,20
1816,280,2,897,6,4949,51,35,60
1817,280,2,898,7,4956,87,87,70
1818,280,2,899,6,4962,47,47,60
1819,280,2,900,3,4965,40,27,30
1820,280,2,901,6,4971,74,74,60
1821,280,2,902,6,4977,59,59,60
1822,280,2,903,8,4985,77,77,80
1823,280,2,904,6,4991,60,60,60
1824,280,2,905,7,4998,51,32,70
1825,280,3,1,5,5,55,41,50
1826,280,3,2,4,9,44,44,40
1827,280,3,3,8,17,74,74,80
1828,280,3,4,3,20,26,26,30
1829,280,3,5,9,29,93,93,90
1830,280,3,6,4,33,36,36,40
1831,280,3,7,3,36,35,35,30
1832,280,3,8,4,40,35,35,40
1833,280,3,9,3,43,18,18,30
1834,280,3,10,8,51,80,62,80
1835,280,3,11,9,60,110,80,90
1836,280,3,12,3,63,53,53,30
1837,280,3,13,6,69,72,72,60
1838,280,3,14,4,73,43,43,40
1839,280,3,15,6,79,72,72,60
1840,280,3,16,9,88,121,121,90
1841,280,3,17,9,97,93,69,90
1842,280,3,18,3,100,48,32,30
1843,280,3,19,2,102,41,41,20
1844,280,3,20,8,110,88,62,80
1845,280,3,21,3,113,59,59,30
1846,280,3,22,3,116,27,27,30
1847,280,3,23,6,122,52,52,60
1848,280,3,24,7,129,61,61,70
1849,280,3,25,6,135,54,54,60
1850,280,3,26,5,140,51,51,50
1851,280,3,27,8,148,66,49,80
1852,280,3,28,7,155,81,81,70
1853,280,3,29,6,161,47,47,60
1854,280,3,30,9,170,92,92,90
1855,280,3,31,8,178,54,54,80
1856,280,3,32,2,180,23,23,20
1857,280,3,33,9,189,86,86,90
1858,280,3,34,3,192,31,31,30
1859,280,3,35,8,200,64,41,80
1860,280,3,36,5,205,82,82,50
1861,280,3,37,7,212,62,62,70
1862,280,3,38,5,217,48,48,50
1863,280,3,39,3,220,34,34,30
1864,280,3,40,9,229,95,95,90
1865,280,3,41,6,235,57,57,60
1866,280,3,42,5,240,43,33,50
1867,280,3,43,2,242,33,33,20
1868,280,3,44,8,250,79,79,80
1869,280,3,45,6,256,54,38,60
1870,280,3,46,4,260,58,58,40
1871,280,3,47,8,268,71,52,80
1872,280,3,48,2,270,43,43,20
1873,280,3,49,6,276,75,75,60
1874,280,3,50,7,283,73,45,70
1875,280,3,51,4,287,73,73,40
1876,280,3,52,2,289,21,12,20
1877,280,3,53,6,295,62,62,60
1878,280,3,54,2,297,16,16,20
1879,280,3,55,8,305,81,51,80
1880,280,3,56,2,307,51,51,20
1881,280,3,57,8,315,80,80,80
1882,280,3,58,8,323,75,75,80
1883,280,3,59,4,327,32,32,40
1884,280,3,60,9,336,82,60,90
1885,280,3,61,2,338,44,44,20
1886,280,3,62,4,342,39,39,40
1887,280,3,63,3,345,32,21,30
1888,280,3,64,6,351,84,84,60
1889,280,3,65,3,354,32,32,30
1890,280,3,66,9,363,86,86,90
1891,280,3,67,5,368,47,47,50
1892,280,3,68,6,374,50,50,60
1893,280,3,69,2,376,13,9,20
1894,280,3,70,9,385,92,92,90
1895,280,3,71,9,394,80,80,90
1896,280,3,72,3,397,29,29,30
1897,280,3,73,8,405,73,73,80
1898,280,3,74,4,409,45,45,40
1899,280,3,75,7,416,68,68,70
1900,280,3,76,3,419,32,32,30
1901,280,3,77,3,422,31,31,30
1902,280,3,78,4,426,32,32,40
1903,280,3,79,6,432,60,60,60
1904,280,3,80,5,437,49,49,50
1905,280,3,81,4,441,37,27,40
1906,280,3,82,3,444,38,38,30
1907,280,3,83,3,447,38,38,30
1908,280,3,84,8,455,78,78,80
1909,280,3,85,7,462,72,72,70
1910,280,3,86,3,465,20,20,30
1911,280,3,87,9,474,84,84,90
1912,280,3,88,2,476,21,13,20
1913,280,3,89,7,483,78,78,70
1914,280,3,90,9,492,91,91,90
1915,280,3,91,3,495,34,34,30
1916,280,3,92,3,498,20,20,30
1917,280,3,93,5,503,46,46,50
1918,280,3,94,4,507,45,45,40
1919,280,3,95,7,514,57,57,70
1920,280,3,96,4,518,51,51,40
1921,280,3,97,7,525,66,66,70
1922,280,3,98,7,532,66,66,70
1923,280,3,99,3,535,27,27,30
1924,280,3,100,8,543,72,72,80
1925,280,3,101,4,547,39,39,40
1926,280,3,102,9,556,102,70,90
1927,280,3,103,3,559,62,42,30
1928,280,3,104,8,567,97,76,80
1929,280,3,105,8,575,101,101,80
1930,280,3,106,3,578,34,34,30
1931,280,3,107,4,582,41,27,40
1932,280,3,108,5,587,64,48,50
1933,280,3,109,5,592,59,59,50
1934,280,3,110,6,598,42,42,60
1935,280,3,111,4,602,44,44,40
1936,280,3,112,6,608,48,48,60
1937,280,3,113,8,616,75,75,80
1938,280,3,114,7,623,57,57,70
1939,280,3,115,9,632,79,79,90
1940,280,3,116,8,640,68,68,80
1941,280,3,117,8,648,62,47,80
1942,280,3,118,4,652,60,60,40
1943,280,3,119,2,654,29,29,20
1944,280,3,120,7,661,75,57,70
1945,280,3,121,9,670,102,68,90
1946,280,3,122,6,676,87,54,60
1947,280,3,123,2,678,50,50,20
1948,280,3,124,7,685,65,39,70
1949,280,3,125,5,690,73,73,50
1950,280,3,126,7,697,72,50,70
1951,280,3,127,7,704,101,101,70
1952,280,3,128,3,707,31,31,30
1953,280,3,129,9,716,84,84,90
1954,280,3,130,8,724,77,77,80
1955,280,3,131,5,729,55,55,50
1956,280,3,132,9,738,82,82,90
1957,280,3,133,5,743,54,54,50
1958,280,3,134,2,745,18,18,20
1959,280,3,135,9,754,103,103,90
1960,280,3,136,7,761,80,80,70
1961,280,3,137,7,768,71,71,70
1962,280,3,138,9,777,88,88,90
1963,280,3,139,8,785,79,79,80
1964,280,3,140,8,793,62,45,80
1965,280,3,141,7,800,93,93,70
1966,280,3,142,6,806,69,50,60
1967,280,3,143,5,811,67,67,50
1968,280,3,144,5,816,64,64,50
1969,280,3,145,4,820,45,45,40
1970,280,3,146,6,826,58,41,60
1971,280,3,147,6,832,77,77,60
1972,280,3,148,8,840,75,75,80
1973,280,3,149,4,844,44,44,40
1974,280,3,150,3,847,31,19,30
1975,280,3,151,7,854,86,86,70
1976,280,3,152,6,860,80,80,60
1977,280,3,153,6,866,57,38,60
1978,280,3,154,9,875,107,107,90
1979,280,3,155,8,883,87,87,80
1980,280,3,156,9,892,105,74,90
1981,280,3,157,2,894,49,49,20
1982,280,3,158,2,896,14,14,20
1983,280,3,159,8,904,79,79,80
1984,280,3,160,8,912,94,94,80
1985,280,3,161,9,921,74,74,90
1986,280,3,162,2,923,21,14,20
1987,280,3,163,7,930,88,88,70
1988,280,3,164,7,937,62,41,70
1989,280,3,165,5,942,67,45,50
1990,280,3,166,2,944,44,44,20
1991,280,3,167,3,947,21,21,30
1992,280,3,168,2,949,22,22,20
1993,280,3,169,8,957,75,52,80
1994,280,3,170,6,963,74,74,60
1995,280,3,171,4,967,44,44,40
1996,280,3,172,4,971,35,20,40
1997,280,3,173,5,976,69,69,50
1998,280,3,174,5,981,52,52,50
1999,280,3,175,9,990,86,86,90
2000,280,3,176,8,998,83,83,80
2001,280,3,177,4,1002,36,36,40
2002,280,3,178,8,1010,81,81,80
2003,280,3,179,9,1019,101,101,90
2004,280,3,180,4,1023,41,41,40
2005,280,3,181,4,1027,54,54,40
2006,280,3,182,7,1034,49,49,70
2007,280,3,183,2,1036,23,23,20
2008,280,3,184,4,1040,32,21,40
2009,280,3,185,5,1045,73,46,50
2010,280,3,186,7,1052,113,113,70
2011,280,3,187,7,1059,72,72,70
2012,280,3,188,6,1065,49,49,60
2013,280,3,189,2,1067,17,17,20
2014,280,3,190,2,1069,16,16,20
2015,280,3,191,9,1078,87,87,90
2016,280,3,192,3,1081,24,24,30
2017,280,3,193,3,1084,28,28,30
2018,280,3,194,8,1092,101,101,80
2019,280,3,195,9,1101,83,57,90
2020,280,3,196,5,1106,81,49,50
2021,280,3,197,2,1108,63,63,20
2022,280,3,198,9,1117,116,116,90
2023,280,3,199,7,1124,67,67,70
2024,280,3,200,6,1130,58,44,60
2025,280,3,201,9,1139,107,107,90
2026,280,3,202,2,1141,16,16,20
2027,280,3,203,7,1148,59,59,70
2028,280,3,204,2,1150,28,28,20
2029,280,3,205,7,1157,74,74,70
2030,280,3,206,3,1160,36,36,30
2031,280,3,207,5,1165,59,59,50
2032,280,3,208,8,1173,81,81,80
2033,280,3,209,7,1180,83,54,70
2034,280,3,210,9,1189,110,74,90
2035,280,3,211,5,1194,82,82,50
2036,280,3,212,2,1196,18,18,20
2037,280,3,213,9,1205,88,53,90
2038,280,3,214,6,1211,92,66,60
2039,280,3,215,9,1220,107,107,90
2040,280,3,216,5,1225,43,43,50
2041,280,3,217,4,1229,52,52,40
2042,280,3,218,3,1232,36,28,30
2043,280,3,219,3,1235,31,25,30
2044,280,3,220,6,1241,75,75,60
2045,280,3,221,4,1245,40,40,40
2046,280,3,222,7,1252,72,52,70
2047,280,3,223,7,1259,84,58,70
2048,280,3,224,7,1266,108,108,70
2049,280,3,225,6,1272,59,59,60
2050,280,3,226,9,1281,100,100,90
2051,280,3,227,9,1290,104,70,90
2052,280,3,228,9,1299,126,87,90
2053,280,3,229,8,1307,112,112,80
2054,280,3,230,3,1310,23,23,30
2055,280,3,231,7,1317,65,65,70
2056,280,3,232,7,1324,74,54,70
2057,280,3,233,2,1326,40,40,20
2058,280,3,234,4,1330,36,36,40
2059,280,3,235,9,1339,95,95,90
2060,280,3,236,3,1342,34,28,30
2061,280,3,237,8,1350,82,63,80
2062,280,3,238,5,1355,69,69,50
2063,280,3,239,9,1364,97,97,90
2064,280,3,240,8,1372,67,67,80
2065,280,3,241,8,1380,87,87,80
2066,280,3,242,2,1382,24,24,20
2067,280,3,243,9,1391,90,61,90
2068,280,3,244,9,1400,122,82,90
2069,280,3,245,6,1406,103,103,60
2070,280,3,246,7,1413,75,75,70
2071,280,3,247,7,1420,85,46,70
2072,280,3,248,4,1424,81,64,40
2073,280,3,249,5,1429,70,70,50
2074,280,3,250,4,1433,37,37,40
2075,280,3,251,8,1441,63,63,80
2076,280,3,252,6,1447,71,71,60
2077,280,3,253,5,1452,42,42,50
2078,280,3,254,3,1455,30,30,30
2079,280,3,255,8,1463,93,93,80
2080,280,3,256,4,1467,35,35,40
2081,280,3,257,3,1470,32,32,30
2082,280,3,258,3,1473,31,31,30
2083,280,3,259,3,1476,28,28,30
2084,280,3,260,7,1483,69,69,70
2085,280,3,261,7,1490,63,63,70
2086,280,3,262,7,1497,58,58,70
2087,280,3,263,9,1506,108,108,90
2088,280,3,264,7,1513,76,76,70
2089,280,3,265,5,1518,56,38,50
2090,280,3,266,6,1524,71,55,60
2091,280,3,267,5,1529,78,78,50
2092,280,3,268,5,1534,48,35,50
2093,280,3,269,3,1537,46,46,30
2094,280,3,270,6,1543,52,52,60
2095,280,3,271,3,1546,34,34,30
2096,280,3,272,9,1555,99,99,90
2097,280,3,273,3,1558,30,30,30
2098,280,3,274,4,1562,38,22,40
2099,280,3,275,2,1564,41,30,20
2100,280,3,276,7,1571,82,82,70
2101,280,3,277,3,1574,27,27,30
2102,280,3,278,9,1583,93,93,90
2103,280,3,279,4,1587,36,36,40
2104,280,3,280,2,1589,21,21,20
2105,280,3,281,4,1593,47,47,40
2106,280,3,282,6,1599,57,57,60
2107,280,3,283,7,1606,78,78,70
2108,280,3,284,4,1610,43,43,40
2109,280,3,285,6,1616,56,56,60
2110,280,3,286,5,1621,45,45,50
2111,280,3,287,9,1630,89,57,90
2112,280,3,288,3,1633,73,73,30
2113,280,3,289,7,1640,67,67,70
2114,280,3,290,2,1642,24,24,20
2115,280,3,291,2,1644,18,18,20
2116,280,3,292,6,1650,61,61,60
2117,280,3,293,6,1656,60,60,60
2118,280,3,294,4,1660,34,34,40
2119,280,3,295,8,1668,82,61,80
2120,280,3,296,3,1671,51,33,30
2121,280,3,297,9,1680,112,112,90
2122,280,3,298,6,1686,68,43,60
2123,280,3,299,4,1690,60,60,40
2124,280,3,300,6,1696,60,42,60
2125,280,3,301,3,1699,47,47,30
2126,280,3,302,5,1704,48,48,50
2127,280,3,303,5,1709,45,45,50
2128,280,3,304,7,1716,69,69,70
2129,280,3,305,2,1718,16,12,20
2130,280,3,306,6,1724,55,55,60
2131,280,3,307,6,1730,56,56,60
2132,280,3,308,7,1737,65,65,70
2133,280,3,309,7,1744,65,46,70
2134,280,3,310,7,1751,80,80,70
2135,280,3,311,5,1756,57,57,50
2136,280,3,312,5,1761,47,34,50
2137,280,3,313,4,1765,63,43,40
2138,280,3,314,6,1771,91,91,60
2139,280,3,315,6,1777,49,49,60
2140,280,3,316,7,1784,75,75,70
2141,280,3,317,3,1787,34,25,30
2142,280,3,318,8,1795,89,89,80
2143,280,3,319,6,1801,61,61,60
2144,280,3,320,4,1805,51,51,40
2145,280,3,321,3,1808,21,13,30
2146,280,3,322,7,1815,87,59,70
2147,280,3,323,8,1823,119,82,80
2148,280,3,324,3,1826,75,75,30
2149,280,3,325,3,1829,41,41,30
2150,280,3,326,9,1838,97,56,90
2151,280,3,327,6,1844,102,102,60
2152,280,3,328,3,1847,27,27,30
2153,280,3,329,6,1853,43,43,60
2154,280,3,330,6,1859,58,58,60
2155,280,3,331,2,1861,23,23,20
2156,280,3,332,3,1864,27,27,30
2157,280,3,333,2,1866,14,14,20
2158,280,3,334,5,1871,44,44,50
2159,280,3,335,3,1874,25,17,30
2160,280,3,336,8,1882,87,87,80
2161,280,3,337,9,1891,106,106,90
2162,280,3,338,5,1896,63,63,50
2163,280,3,339,9,1905,92,92,90
2164,280,3,340,4,1909,36,20,40
2165,280,3,341,7,1916,84,84,70
2166,280,3,342,2,1918,16,16,20
2167,280,3,343,6,1924,67,45,60
2168,280,3,344,6,1930,84,84,60
2169,280,3,345,5,1935,63,40,50
2170,280,3,346,2,1937,45,45,20
2171,280,3,347,6,1943,65,65,60
2172,280,3,348,8,1951,89,89,80
2173,280,3,349,4,1955,45,45,40
2174,280,3,350,4,1959,52,52,40
2175,280,3,351,2,1961,19,19,20
2176,280,3,352,2,1963,12,12,20
2177,280,3,353,3,1966,30,30,30
2178,280,3,354,9,1975,98,98,90
2179,280,3,355,2,1977,18,18,20
2180,280,3,356,2,1979,22,22,20
2181,280,3,357,5,1984,43,43,50
2182,280,3,358,4,1988,35,35,40
2183,280,3,359,4,1992,40,25,40
2184,280,3,360,2,1994,38,38,20
2185,280,3,361,5,1999,49,28,50
2186,280,3,362,5,2004,65,44,50
2187,280,3,363,7,2011,93,93,70
2188,280,3,364,7,2018,62,62,70
2189,280,3,365,4,2022,36,36,40
2190,280,3,366,5,2027,39,28,50
2191,280,3,367,7,2034,82,82,70
2192,280,3,368,9,2043,98,98,90
2193,280,3,369,8,2051,85,85,80
2194,280,3,370,8,2059,70,70,80
2195,280,3,371,8,2067,74,74,80
2196,280,3,372,6,2073,64,64,60
2197,280,3,373,9,2082,98,98,90
2198,280,3,374,5,2087,63,63,50
2199,280,3,375,7,2094,65,65,70
2200,280,3,376,4,2098,41,27,40
2201,280,3,377,7,2105,80,80,70
2202,280,3,378,6,2111,41,41,60
2203,280,3,379,3,2114,28,16,30
2204,280,3,380,8,2122,88,56,80
2205,280,3,381,8,2130,121,84,80
2206,280,3,382,4,2134,81,81,40
2207,280,3,383,6,2140,58,41,60
2208,280,3,384,5,2145,60,60,50
2209,280,3,385,3,2148,26,26,30
2210,280,3,386,4,2152,30,20,40
2211,280,3,387,3,2155,34,25,30
2212,280,3,388,2,2157,33,33,20
2213,280,3,389,4,2161,44,44,40
2214,280,3,390,7,2168,81,81,70
2215,280,3,391,6,2174,51,51,60
2216,280,3,392,7,2181,69,69,70
2217,280,3,393,9,2190,94,94,90
2218,280,3,394,9,2199,105,105,90
2219,280,3,395,4,2203,35,24,40
2220,280,3,396,9,2212,121,121,90
2221,280,3,397,9,2221,77,77,90
2222,280,3,398,6,2227,57,43,60
2223,280,3,399,5,2232,65,49,50
2224,280,3,400,9,2241,97,97,90
2225,280,3,401,3,2244,21,21,30
2226,280,3,402,9,2253,84,84,90
2227,280,3,403,3,2256,34,23,30
2228,280,3,404,8,2264,87,87,80
2229,280,3,405,2,2266,33,33,20
2230,280,3,406,9,2275,80,80,90
2231,280,3,407,2,2277,16,16,20
2232,280,3,408,2,2279,12,12,20
2233,280,3,409,6,2285,59,41,60
2234,280,3,410,2,2287,41,41,20
2235,280,3,411,8,2295,81,49,80
2236,280,3,412,8,2303,116,81,80
2237,280,3,413,7,2310,98,98,70
2238,280,3,414,8,2318,80,52,80
2239,280,3,415,5,2323,74,58,50
2240,280,3,416,7,2330,80,80,70
2241,280,3,417,6,2336,60,45,60
2242,280,3,418,8,2344,101,101,80
2243,280,3,419,9,2353,79,79,90
2244,280,3,420,2,2355,13,13,20
2245,280,3,421,7,2362,63,63,70
2246,280,3,422,6,2368,60,43,60
2247,280,3,423,5,2373,54,54,50
2248,280,3,424,6,2379,54,54,60
2249,280,3,425,9,2388,90,66,90
2250,280,3,426,7,2395,77,77,70
2251,280,3,427,3,2398,26,16,30
2252,280,3,428,7,2405,65,65,70
2253,280,3,429,2,2407,20,20,20
2254,280,3,430,5,2412,56,56,50
2255,280,3,431,4,2416,46,46,40
2256,280,3,432,5,2421,50,50,50
2257,280,3,433,3,2424,33,22,30
2258,280,3,434,7,2431,91,60,70
2259,280,3,435,6,2437,98,70,60
2260,280,3,436,7,2444,116,116,70
2261,280,3,437,3,2447,31,31,30
2262,280,3,438,7,2454,67,67,70
2263,280,3,439,8,2462,88,88,80
2264,280,3,440,9,2471,88,88,90
2265,280,3,441,7,2478,79,61,70
2266,280,3,442,9,2487,120,120,90
2267,280,3,443,6,2493,72,72,60
2268,280,3,444,5,2498,30,21,50
2269,280,3,445,8,2506,77,77,80
2270,280,3,446,8,2514,76,76,80
2271,280,3,447,7,2521,77,49,70
2272,280,3,448,8,2529,89,89,80
2273,280,3,449,4,2533,38,38,40
2274,280,3,450,2,2535,20,8,20
2275,280,3,451,7,2542,87,87,70
2276,280,3,452,3,2545,35,35,30
2277,280,3,453,6,2551,61,61,60
2278,280,3,454,4,2555,38,38,40
2279,280,3,455,9,2564,74,74,90
2280,280,3,456,4,2568,28,20,40
2281,280,3,457,4,2572,45,30,40
2282,280,3,458,2,2574,27,27,20
2283,280,3,459,9,2583,102,102,90
2284,280,3,460,7,2590,66,66,70
2285,280,3,461,7,2597,75,75,70
2286,280,3,462,8,2605,76,49,80
2287,280,3,463,5,2610,83,83,50
2288,280,3,464,5,2615,44,44,50
2289,280,3,465,9,2624,83,83,90
2290,280,3,466,2,2626,24,24,20
2291,280,3,467,5,2631,54,36,50
2292,280,3,468,5,2636,71,71,50
2293,280,3,469,6,2642,59,59,60
2294,280,3,470,5,2647,59,59,50
2295,280,3,471,8,2655,77,77,80
2296,280,3,472,4,2659,37,37,40
2297,280,3,473,8,2667,72,49,80
2298,280,3,474,4,2671,63,45,40
2299,280,3,475,6,2677,71,54,60
2300,280,3,476,4,2681,64,64,40
2301,280,3,477,2,2683,19,19,20
2302,280,3,478,8,2691,72,72,80
2303,280,3,479,9,2700,80,80,90
2304,280,3,480,7,2707,57,37,70
2305,280,3,481,4,2711,58,42,40
2306,280,3,482,3,2714,47,47,30
2307,280,3,483,7,2721,63,43,70
2308,280,3,484,7,2728,74,54,70
2309,280,3,485,3,2731,52,52,30
2310,280,3,486,3,2734,41,41,30
2311,280,3,487,2,2736,29,29,20
2312,280,3,488,4,2740,41,41,40
2313,280,3,489,2,2742,29,29,20
2314,280,3,490,8,2750,85,85,80
2315,280,3,491,4,2754,42,42,40
2316,280,3,492,6,2760,68,68,60
2317,280,3,493,4,2764,33,33,40
2318,280,3,494,9,2773,81,81,90
2319,280,3,495,4,2777,44,44,40
2320,280,3,496,7,2784,38,38,70
2321,280,3,497,5,2789,49,32,50
2322,280,3,498,7,2796,75,75,70
2323,280,3,499,7,2803,66,66,70
2324,280,3,500,3,2806,26,26,30
2325,280,3,501,8,2814,73,73,80
2326,280,3,502,9,2823,88,88,90
2327,280,3,503,6,2829,58,58,60
2328,280,3,504,2,2831,21,21,20
2329,280,3,505,4,2835,39,39,40
2330,280,3,506,5,2840,49,49,50
2331,280,3,507,6,2846,58,58,60
2332,280,3,508,5,2851,58,38,50
2333,280,3,509,8,2859,97,73,80
2334,280,3,510,5,2864,76,53,50
2335,280,3,511,7,2871,98,98,70
2336,280,3,512,5,2876,49,49,50
2337,280,3,513,4,2880,46,46,40
2338,280,3,514,4,2884,37,28,40
2339,280,3,515,6,2890,72,72,60
2340,280,3,516,9,2899,81,81,90
2341,280,3,517,6,2905,58,58,60
2342,280,3,518,2,2907,29,29,20
2343,280,3,519,4,2911,43,32,40
2344,280,3,520,6,2917,88,88,60
2345,280,3,521,2,2919,19,19,20
2346,280,3,522,5,2924,55,55,50
2347,280,3,523,3,2927,29,29,30
2348,280,3,524,6,2933,57,57,60
2349,280,3,525,6,2939,62,44,60
2350,280,3,526,9,2948,103,103,90
2351,280,3,527,6,2954,53,53,60
2352,280,3,528,3,2957,28,28,30
2353,280,3,529,4,2961,40,30,40
2354,280,3,530,8,2969,77,77,80
2355,280,3,531,2,2971,20,20,20
2356,280,3,532,9,2980,103,103,90
2357,280,3,533,2,2982,27,27,20
2358,280,3,534,5,2987,51,51,50
2359,280,3,535,8,2995,79,79,80
2360,280,3,536,3,2998,22,22,30
2361,280,3,537,3,3001,33,20,30
2362,280,3,538,6,3007,71,71,60
2363,280,3,539,9,3016,102,102,90
2364,280,3,540,6,3022,59,59,60
2365,280,3,541,3,3025,31,31,30
2366,280,3,542,6,3031,57,41,60
2367,280,3,543,5,3036,72,72,50
2368,280,3,544,6,3042,51,27,60
2369,280,3,545,5,3047,81,81,50
2370,280,3,546,9,3056,94,94,90
2371,280,3,547,9,3065,83,56,90
2372,280,3,548,8,3073,114,114,80
2373,280,3,549,9,3082,92,92,90
2374,280,3,550,7,3089,77,77,70
2375,280,3,551,2,3091,17,17,20
2376,280,3,552,6,3097,76,76,60
2377,280,3,553,9,3106,88,67,90
2378,280,3,554,2,3108,39,39,20
2379,280,3,555,5,3113,45,33,50
2380,280,3,556,4,3117,49,49,40
2381,280,3,557,9,3126,103,71,90
2382,280,3,558,3,3129,54,54,30
2383,280,3,559,9,3138,91,91,90
2384,280,3,560,4,3142,37,26,40
2385,280,3,561,2,3144,31,31,20
2386,280,3,562,2,3146,23,23,20
2387,280,3,563,6,3152,61,61,60
2388,280,3,564,3,3155,37,37,30
2389,280,3,565,4,3159,32,15,40
2390,280,3,566,3,3162,45,32,30
2391,280,3,567,5,3167,65,65,50
2392,280,3,568,9,3176,84,59,90
2393,280,3,569,7,3183,98,98,70
2394,280,3,570,8,3191,81,81,80
2395,280,3,571,5,3196,47,31,50
2396,280,3,572,5,3201,76,50,50
2397,280,3,573,5,3206,62,62,50
2398,280,3,574,6,3212,68,68,60
2399,280,3,575,9,3221,101,101,90
2400,280,3,576,2,3223,24,24,20
2401,280,3,577,3,3226,28,28,30
2402,280,3,578,6,3232,57,57,60
2403,280,3,579,5,3237,44,32,50
2404,280,3,580,4,3241,41,27,40
2405,280,3,581,6,3247,76,76,60
2406,280,3,582,7,3254,76,56,70
2407,280,3,583,5,3259,85,85,50
2408,280,3,584,6,3265,51,39,60
2409,280,3,585,8,3273,103,103,80
2410,280,3,586,3,3276,25,25,30
2411,280,3,587,4,3280,42,42,40
2412,280,3,588,6,3286,52,52,60
2413,280,3,589,5,3291,58,58,50
2414,280,3,590,4,3295,32,32,40
2415,280,3,591,5,3300,57,57,50
2416,280,3,592,8,3308,70,70,80
2417,280,3,593,9,3317,88,88,90
2418,280,3,594,9,3326,75,50,90
2419,280,3,595,5,3331,75,75,50
2420,280,3,596,7,3338,68,68,70
2421,280,3,597,6,3344,62,62,60
2422,280,3,598,4,3348,45,45,40
2423,280,3,599,9,3357,102,77,90
2424,280,3,600,8,3365,127,127,80
2425,280,3,601,9,3374,84,84,90
2426,280,3,602,7,3381,56,56,70
2427,280,3,603,9,3390,92,92,90
2428,280,3,604,7,3397,54,54,70
2429,280,3,605,8,3405,82,82,80
2430,280,3,606,9,3414,86,86,90
2431,280,3,607,5,3419,45,45,50
2432,280,3,608,5,3424,45,45,50
2433,280,3,609,2,3426,16,16,20
2434,280,3,610,4,3430,45,45,40
2435,280,3,611,5,3435,45,45,50
2436,280,3,612,3,3438,26,26,30
2437,280,3,613,6,3444,62,62,60
2438,280,3,614,7,3451,61,45,70
2439,280,3,615,3,3454,46,46,30
2440,280,3,616,4,3458,57,57,40
2441,280,3,617,8,3466,87,68,80
2442,280,3,618,2,3468,37,20,20
2443,280,3,619,2,3470,31,31,20
2444,280,3,620,6,3476,56,56,60
2445,280,3,621,9,3485,98,75,90
2446,280,3,622,2,3487,51,51,20
2447,280,3,623,8,3495,81,81,80
2448,280,3,624,9,3504,85,85,90
2449,280,3,625,6,3510,73,54,60
2450,280,3,626,2,3512,46,46,20
2451,280,3,627,5,3517,50,50,50
2452,280,3,628,7,3524,72,72,70
2453,280,3,629,3,3527,35,35,30
2454,280,3,630,4,3531,57,57,40
2455,280,3,631,2,3533,15,15,20
2456,280,3,632,9,3542,86,86,90
2457,280,3,633,7,3549,80,54,70
2458,280,3,634,5,3554,77,77,50
2459,280,3,635,8,3562,95,95,80
2460,280,3,636,7,3569,53,53,70
2461,280,3,637,3,3572,28,28,30
2462,280,3,638,7,3579,74,74,70
2463,280,3,639,4,3583,35,35,40
2464,280,3,640,3,3586,23,23,30
2465,280,3,641,2,3588,18,11,20
2466,280,3,642,9,3597,108,108,90
2467,280,3,643,8,3605,82,82,80
2468,280,3,644,9,3614,95,66,90
2469,280,3,645,3,3617,52,32,30
2470,280,3,646,3,3620,38,38,30
2471,280,3,647,6,3626,52,52,60
2472,280,3,648,7,3633,85,85,70
2473,280,3,649,7,3640,73,73,70
2474,280,3,650,3,3643,32,32,30
2475,280,3,651,3,3646,15,15,30
2476,280,3,652,2,3648,16,16,20
2477,280,3,653,9,3657,84,63,90
2478,280,3,654,4,3661,72,72,40
2479,280,3,655,9,3670,76,76,90
2480,280,3,656,5,3675,50,50,50
2481,280,3,657,2,3677,26,26,20
2482,280,3,658,7,3684,70,70,70
2483,280,3,659,9,3693,111,111,90
2484,280,3,660,2,3695,18,11,20
2485,280,3,661,8,3703,89,89,80
2486,280,3,662,7,3710,75,55,70
2487,280,3,663,4,3714,61,36,40
2488,280,3,664,3,3717,54,54,30
2489,280,3,665,3,3720,38,38,30
2490,280,3,666,2,3722,21,21,20
2491,280,3,667,9,3731,89,89,90
2492,280,3,668,7,3738,71,46,70
2493,280,3,669,6,3744,90,90,60
2494,280,3,670,9,3753,79,79,90
2495,280,3,671,7,3760,72,72,70
2496,280,3,672,3,3763,32,32,30
2497,280,3,673,5,3768,53,53,50
2498,280,3,674,6,3774,63,38,60
2499,280,3,675,4,3778,61,61,40
2500,280,3,676,9,3787,84,62,90
2501,280,3,677,9,3796,97,67,90
2502,280,3,678,9,3805,133,133,90
2503,280,3,679,5,3810,49,49,50
2504,280,3,680,8,3818,84,84,80
2505,280,3,681,7,3825,78,78,70
2506,280,3,682,8,3833,96,96,80
2507,280,3,683,9,3842,98,98,90
2508,280,3,684,5,3847,53,53,50
2509,280,3,685,7,3854,65,65,70
2510,280,3,686,8,3862,72,72,80
2511,280,3,687,5,3867,51,51,50
2512,280,3,688,6,3873,50,50,60
2513,280,3,689,9,3882,78,50,90
2514,280,3,690,2,3884,48,48,20
2515,280,3,691,7,3891,82,57,70
2516,280,3,692,5,3896,74,74,50
2517,280,3,693,8,3904,71,71,80
2518,280,3,694,3,3907,24,24,30
2519,280,3,695,7,3914,89,89,70
2520,280,3,696,4,3918,38,38,40
2521,280,3,697,8,3926,86,86,80
2522,280,3,698,2,3928,26,16,20
2523,280,3,699,7,3935,75,75,70
2524,280,3,700,8,3943,74,74,80
2525,280,3,701,2,3945,17,17,20
2526,280,3,702,8,3953,93,93,80
2527,280,3,703,8,3961,76,54,80
2528,280,3,704,3,3964,56,56,30
2529,280,3,705,5,3969,39,39,50
2530,280,3,706,6,3975,61,61,60
2531,280,3,707,6,3981,52,52,60
2532,280,3,708,8,3989,72,72,80
2533,280,3,709,8,3997,80,80,80
2534,280,3,710,7,4004,71,71,70
2535,280,3,711,2,4006,22,22,20
2536,280,3,712,9,4015,90,65,90
2537,280,3,713,8,4023,101,101,80
2538,280,3,714,6,4029,56,56,60
2539,280,3,715,4,4033,40,40,40
2540,280,3,716,6,4039,60,60,60
2541,280,3,717,7,4046,69,69,70
2542,280,3,718,2,4048,21,21,20
2543,280,3,719,3,4051,24,24,30
2544,280,3,720,3,4054,29,29,30
2545,280,3,721,4,4058,37,37,40
2546,280,3,722,2,4060,16,16,20
2547,280,3,723,2,4062,11,5,20
2548,280,3,724,7,4069,62,43,70
2549,280,3,725,2,4071,47,37,20
2550,280,3,726,3,4074,40,40,30
2551,280,3,727,2,4076,25,25,20
2552,280,3,728,4,4080,45,45,40
2553,280,3,729,3,4083,29,29,30
2554,280,3,730,6,4089,58,44,60
2555,280,3,731,8,4097,91,91,80
2556,280,3,732,3,4100,33,33,30
2557,280,3,733,4,4104,43,43,40
2558,280,3,734,2,4106,15,15,20
2559,280,3,735,4,4110,27,27,40
2560,280,3,736,8,4118,82,82,80
2561,280,3,737,8,4126,76,76,80
2562,280,3,738,8,4134,82,82,80
2563,280,3,739,7,4141,79,79,70
2564,280,3,740,7,4148,67,67,70
2565,280,3,741,8,4156,74,48,80
2566,280,3,742,7,4163,89,89,70
2567,280,3,743,3,4166,31,24,30
2568,280,3,744,8,4174,73,73,80
2569,280,3,745,3,4177,33,33,30
2570,280,3,746,3,4180,38,26,30
2571,280,3,747,9,4189,95,95,90
2572,280,3,748,3,4192,41,41,30
2573,280,3,749,7,4199,64,64,70
2574,280,3,750,6,4205,65,65,60
2575,280,3,751,8,4213,78,58,80
2576,280,3,752,3,4216,49,35,30
2577,280,3,753,8,4224,95,95,80
2578,280,3,754,9,4233,89,89,90
2579,280,3,755,8,4241,98,98,80
2580,280,3,756,9,4250,89,89,90
2581,280,3,757,5,4255,48,48,50
2582,280,3,758,9,4264,105,105,90
2583,280,3,759,8,4272,79,79,80
2584,280,3,760,3,4275,25,25,30
2585,280,3,761,8,4283,79,79,80
2586,280,3,762,9,4292,78,78,90
2587,280,3,763,2,4294,19,13,20
2588,280,3,764,4,4298,34,34,40
2589,280,3,765,7,4305,61,61,70
2590,280,3,766,6,4311,69,50,60
2591,280,3,767,4,4315,57,57,40
2592,280,3,768,6,4321,69,48,60
2593,280,3,769,4,4325,55,55,40
2594,280,3,770,3,4328,35,20,30
2595,280,3,771,8,4336,91,91,80
2596,280,3,772,5,4341,50,35,50
2597,280,3,773,7,4348,86,86,70
2598,280,3,774,4,4352,24,24,40
2599,280,3,775,8,4360,84,84,80
2600,280,3,776,4,4364,38,38,40
2601,280,3,777,9,4373,97,97,90
2602,280,3,778,6,4379,65,65,60
2603,280,3,779,5,4384,54,37,50
2604,280,3,780,5,4389,66,66,50
2605,280,3,781,6,4395,65,65,60
2606,280,3,782,5,4400,54,54,50
2607,280,3,783,9,4409,100,100,90
2608,280,3,784,8,4417,86,86,80
2609,280,3,785,5,4422,53,53,50
2610,280,3,786,6,4428,71,71,60
2611,280,3,787,7,4435,73,57,70
2612,280,3,788,5,4440,76,76,50
2613,280,3,789,7,4447,83,83,70
2614,280,3,790,8,4455,90,90,80
2615,280,3,791,9,4464,67,67,90
2616,280,3,792,2,4466,19,19,20
2617,280,3,793,6,4472,57,57,60
2618,280,3,794,3,4475,40,29,30
2619,280,3,795,9,4484,107,107,90
2620,280,3,796,6,4490,64,64,60
2621,280,3,797,8,4498,74,74,80
2622,280,3,798,9,4507,87,87,90
2623,280,3,799,3,4510,27,27,30
2624,280,3,800,4,4514,43,43,40
2625,280,3,801,2,4516,23,15,20
2626,280,3,802,8,4524,86,57,80
2627,280,3,803,8,4532,119,119,80
2628,280,3,804,4,4536,41,41,40
2629,280,3,805,9,4545,98,66,90
2630,280,3,806,6,4551,100,71,60
2631,280,3,807,2,4553,45,45,20
2632,280,3,808,9,4562,77,77,90
2633,280,3,809,7,4569,82,82,70
2634,280,3,810,9,4578,101,70,90
2635,280,3,811,8,4586,112,112,80
2636,280,3,812,3,4589,28,28,30
2637,280,3,813,3,4592,32,20,30
2638,280,3,814,2,4594,39,39,20
2639,280,3,815,9,4603,84,84,90
2640,280,3,816,7,4610,70,70,70
2641,280,3,817,8,4618,79,79,80
2642,280,3,818,3,4621,30,30,30
2643,280,3,819,6,4627,53,37,60
2644,280,3,820,5,4632,74,46,50
2645,280,3,821,9,4641,121,88,90
2646,280,3,822,2,4643,51,37,20
2647,280,3,823,9,4652,100,100,90
2648,280,3,824,2,4654,21,21,20
2649,280,3,825,8,4662,67,48,80
2650,280,3,826,2,4664,35,27,20
2651,280,3,827,2,4666,26,14,20
2652,280,3,828,6,4672,65,65,60
2653,280,3,829,5,4677,53,53,50
2654,280,3,830,8,4685,73,73,80
2655,280,3,831,2,4687,24,24,20
2656,280,3,832,5,4692,57,40,50
2657,280,3,833,6,4698,72,72,60
2658,280,3,834,8,4706,101,101,80
2659,280,3,835,5,4711,53,31,50
2660,280,3,836,3,4714,49,49,30
2661,280,3,837,3,4717,30,30,30
2662,280,3,838,7,4724,59,59,70
2663,280,3,839,8,4732,81,81,80
2664,280,3,840,2,4734,24,24,20
2665,280,3,841,9,4743,80,80,90
2666,280,3,842,5,4748,45,26,50
2667,280,3,843,4,4752,58,58,40
2668,280,3,844,9,4761,99,99,90
2669,280,3,845,7,4768,98,67,70
2670,280,3,846,4,4772,74,74,40
2671,280,3,847,3,4775,25,25,30
2672,280,3,848,8,4783,82,82,80
2673,280,3,849,2,4785,17,17,20
2674,280,3,850,6,4791,65,65,60
2675,280,3,851,9,4800,92,53,90
2676,280,3,852,2,4802,66,66,20
2677,280,3,853,4,4806,42,42,40
2678,280,3,854,8,4814,77,77,80
2679,280,3,855,8,4822,67,67,80
2680,280,3,856,2,4824,34,34,20
2681,280,3,857,5,4829,53,39,50
2682,280,3,858,8,4837,75,75,80
2683,280,3,859,2,4839,21,17,20
2684,280,3,860,5,4844,50,50,50
2685,280,3,861,7,4851,58,58,70
2686,280,3,862,3,4854,33,33,30
2687,280,3,863,2,4856,23,23,20
2688,280,3,864,3,4859,22,13,30
2689,280,3,865,5,4864,79,79,50
2690,280,3,866,4,4868,46,46,40
2691,280,3,867,4,4872,41,41,40
2692,280,3,868,9,4881,78,78,90
2693,280,3,869,9,4890,93,93,90
2694,280,3,870,5,4895,43,43,50
2695,280,3,871,3,4898,35,25,30
2696,280,3,872,7,4905,77,77,70
2697,280,3,873,6,4911,63,63,60
2698,280,3,874,4,4915,40,40,40
2699,280,3,875,2,4917,27,21,20
2700,280,3,876,3,4920,31,25,30
2701,280,3,877,8,4928,86,86,80
2702,280,3,878,7,4935,72,72,70
2703,280,3,879,4,4939,41,26,40
2704,280,3,880,7,4946,86,86,70
2705,280,3,881,9,4955,87,51,90
2706,280,3,882,4,4959,70,70,40
2707,280,3,883,5,4964,59,59,50
2708,280,3,884,4,4968,51,34,40
2709,280,3,885,7,4975,87,87,70
2710,280,3,886,5,4980,45,45,50
2711,280,3,887,5,4985,41,41,50
2712,280,3,888,8,4993,89,89,80
2713,280,3,889,2,4995,25,25,20
2714,280,3,890,3,4998,27,27,30
