,Scenario,Trial,Inspection,Interval,Time,Defects,Rate
0,69,1,1,2,2,13,20
1,69,1,2,5,7,39,50
2,69,1,3,8,15,72,80
3,69,1,4,6,21,69,60
4,69,1,5,3,24,41,30
5,69,1,6,6,30,57,60
6,69,1,7,4,34,1,40
7,69,1,8,9,43,83,90
8,69,1,9,9,52,1,90
9,69,1,10,9,61,128,90
10,69,1,11,9,70,117,90
11,69,1,12,2,72,47,20
12,69,1,13,5,77,53,50
13,69,1,14,9,86,82,90
14,69,1,15,2,88,37,20
15,69,1,16,9,97,66,90
16,69,1,17,6,103,69,60
17,69,1,18,6,109,1,60
18,69,1,19,7,116,104,70
19,69,1,20,9,125,85,90
20,69,1,21,9,134,99,90
21,69,1,22,5,139,67,50
22,69,1,23,8,147,74,80
23,69,1,24,3,150,51,30
24,69,1,25,3,153,41,30
25,69,1,26,7,160,52,70
26,69,1,27,2,162,30,20
27,69,1,28,4,166,43,40
28,69,1,29,8,174,72,80
29,69,1,30,5,179,55,50
30,69,1,31,5,184,61,50
31,69,1,32,4,188,52,40
32,69,1,33,8,196,65,80
33,69,1,34,8,204,54,80
34,69,1,35,4,208,48,40
35,69,1,36,8,216,64,80
36,69,1,37,5,221,57,50
37,69,1,38,7,228,53,70
38,69,1,39,3,231,45,30
39,69,1,40,5,236,52,50
40,69,1,41,7,243,1,70
41,69,1,42,3,246,82,30
42,69,1,43,2,248,43,20
43,69,1,44,9,257,1,90
44,69,1,45,2,259,1,20
45,69,1,46,3,262,84,30
46,69,1,47,5,267,80,50
47,69,1,48,5,272,55,50
48,69,1,49,7,279,78,70
49,69,1,50,2,281,1,20
50,69,1,51,4,285,61,40
51,69,1,52,2,287,34,20
52,69,1,53,5,292,1,50
53,69,1,54,8,300,94,80
54,69,1,55,9,309,90,90
55,69,1,56,3,312,58,30
56,69,1,57,5,317,1,50
57,69,1,58,6,323,85,60
58,69,1,59,5,328,56,50
59,69,1,60,3,331,54,30
60,69,1,61,2,333,1,20
61,69,1,62,7,340,1,70
62,69,1,63,6,346,111,60
63,69,1,64,7,353,73,70
64,69,1,65,8,361,1,80
65,69,1,66,4,365,97,40
66,69,1,67,3,368,56,30
67,69,1,68,6,374,68,60
68,69,1,69,6,380,60,60
69,69,1,70,6,386,65,60
70,69,1,71,4,390,56,40
71,69,1,72,6,396,46,60
72,69,1,73,7,403,68,70
73,69,1,74,5,408,49,50
74,69,1,75,4,412,38,40
75,69,1,76,2,414,1,20
76,69,1,77,3,417,1,30
77,69,1,78,5,422,75,50
78,69,1,79,5,427,52,50
79,69,1,80,4,431,1,40
80,69,1,81,9,440,106,90
81,69,1,82,9,449,102,90
82,69,1,83,7,456,89,70
83,69,1,84,2,458,1,20
84,69,1,85,4,462,76,40
85,69,1,86,9,471,70,90
86,69,1,87,3,474,1,30
87,69,1,88,9,483,98,90
88,69,1,89,5,488,66,50
89,69,1,90,3,491,1,30
90,69,1,91,5,496,73,50
91,69,1,92,9,505,84,90
92,69,1,93,2,507,53,20
93,69,1,94,3,510,1,30
94,69,1,95,6,516,1,60
95,69,1,96,3,519,86,30
96,69,1,97,2,521,58,20
97,69,1,98,3,524,34,30
98,69,1,99,3,527,40,30
99,69,1,100,4,531,41,40
100,69,1,101,5,536,53,50
101,69,1,102,8,544,1,80
102,69,1,103,7,551,1,70
103,69,1,104,6,557,135,60
104,69,1,105,5,562,83,50
105,69,1,106,7,569,79,70
106,69,1,107,3,572,60,30
107,69,1,108,6,578,55,60
108,69,1,109,5,583,1,50
109,69,1,110,5,588,76,50
110,69,1,111,9,597,82,90
111,69,1,112,3,600,55,30
112,69,1,113,7,607,55,70
113,69,1,114,7,614,68,70
114,69,1,115,3,617,43,30
115,69,1,116,2,619,40,20
116,69,1,117,7,626,51,70
117,69,1,118,7,633,1,70
118,69,1,119,8,641,110,80
119,69,1,120,9,650,106,90
120,69,1,121,6,656,80,60
121,69,1,122,7,663,70,70
122,69,1,123,9,672,72,90
123,69,1,124,8,680,94,80
124,69,1,125,7,687,75,70
125,69,1,126,2,689,1,20
126,69,1,127,9,698,108,90
127,69,1,128,9,707,1,90
128,69,1,129,7,714,125,70
129,69,1,130,9,723,1,90
130,69,1,131,5,728,1,50
131,69,1,132,7,735,169,70
132,69,1,133,2,737,67,20
133,69,1,134,2,739,51,20
134,69,1,135,4,743,36,40
135,69,1,136,3,746,35,30
136,69,1,137,5,751,51,50
137,69,1,138,3,754,35,30
138,69,1,139,8,762,1,80
139,69,1,140,2,764,81,20
140,69,1,141,2,766,48,20
141,69,1,142,2,768,29,20
142,69,1,143,5,773,1,50
143,69,1,144,6,779,75,60
144,69,1,145,6,785,58,60
145,69,1,146,9,794,60,90
146,69,1,147,5,799,63,50
147,69,1,148,5,804,63,50
148,69,1,149,7,811,61,70
149,69,1,150,7,818,67,70
150,69,1,151,2,820,41,20
151,69,1,152,2,822,19,20
152,69,1,153,4,826,23,40
153,69,1,154,7,833,59,70
154,69,1,155,2,835,41,20
155,69,1,156,8,843,69,80
156,69,1,157,5,848,54,50
157,69,1,158,4,852,51,40
158,69,1,159,4,856,43,40
159,69,1,160,5,861,1,50
160,69,1,161,4,865,56,40
161,69,1,162,9,874,93,90
162,69,1,163,3,877,53,30
163,69,1,164,9,886,76,90
164,69,1,165,3,889,45,30
165,69,1,166,4,893,33,40
166,69,1,167,6,899,1,60
167,69,1,168,7,906,1,70
168,69,1,169,8,914,1,80
169,69,1,170,2,916,168,20
170,69,1,171,9,925,110,90
171,69,1,172,7,932,1,70
172,69,1,173,9,941,147,90
173,69,1,174,6,947,88,60
174,69,1,175,2,949,55,20
175,69,1,176,6,955,1,60
176,69,1,177,8,963,1,80
177,69,1,178,5,968,1,50
178,69,1,179,8,976,202,80
179,69,1,180,4,980,90,40
180,69,1,181,7,987,75,70
181,69,1,182,4,991,60,40
182,69,1,183,9,1000,71,90
183,69,1,184,9,1009,91,90
184,69,1,185,5,1014,78,50
185,69,1,186,9,1023,85,90
186,69,1,187,4,1027,61,40
187,69,1,188,3,1030,35,30
188,69,1,189,4,1034,44,40
189,69,1,190,8,1042,61,80
190,69,1,191,7,1049,73,70
191,69,1,192,3,1052,47,30
192,69,1,193,7,1059,1,70
193,69,1,194,6,1065,98,60
194,69,1,195,7,1072,1,70
195,69,1,196,9,1081,132,90
196,69,1,197,5,1086,68,50
197,69,1,198,9,1095,85,90
198,69,1,199,2,1097,44,20
199,69,1,200,3,1100,30,30
200,69,1,201,9,1109,76,90
201,69,1,202,9,1118,1,90
202,69,1,203,6,1124,109,60
203,69,1,204,3,1127,57,30
204,69,1,205,4,1131,41,40
205,69,1,206,4,1135,1,40
206,69,1,207,2,1137,64,20
207,69,1,208,3,1140,1,30
208,69,1,209,2,1142,49,20
209,69,1,210,2,1144,32,20
210,69,1,211,8,1152,1,80
211,69,1,212,4,1156,1,40
212,69,1,213,2,1158,103,20
213,69,1,214,3,1161,55,30
214,69,1,215,2,1163,1,20
215,69,1,216,2,1165,37,20
216,69,1,217,7,1172,51,70
217,69,1,218,2,1174,33,20
218,69,1,219,2,1176,25,20
219,69,1,220,6,1182,42,60
220,69,1,221,9,1191,78,90
221,69,1,222,6,1197,68,60
222,69,1,223,8,1205,73,80
223,69,1,224,3,1208,39,30
224,69,1,225,7,1215,1,70
225,69,1,226,8,1223,114,80
226,69,1,227,6,1229,74,60
227,69,1,228,6,1235,71,60
228,69,1,229,3,1238,53,30
229,69,1,230,7,1245,58,70
230,69,1,231,8,1253,81,80
231,69,1,232,3,1256,50,30
232,69,1,233,8,1264,67,80
233,69,1,234,8,1272,1,80
234,69,1,235,7,1279,1,70
235,69,1,236,8,1287,1,80
236,69,1,237,6,1293,204,60
237,69,1,238,3,1296,90,30
238,69,1,239,8,1304,89,80
239,69,1,240,3,1307,52,30
240,69,1,241,6,1313,49,60
241,69,1,242,7,1320,75,70
242,69,1,243,8,1328,86,80
243,69,1,244,4,1332,1,40
244,69,1,245,8,1340,90,80
245,69,1,246,9,1349,1,90
246,69,1,247,8,1357,1,80
247,69,1,248,7,1364,164,70
248,69,1,249,2,1366,80,20
249,69,1,250,8,1374,72,80
250,69,1,251,2,1376,39,20
251,69,1,252,5,1381,1,50
252,69,1,253,7,1388,84,70
253,69,1,254,3,1391,46,30
254,69,1,255,3,1394,42,30
255,69,1,256,6,1400,47,60
256,69,1,257,7,1407,61,70
257,69,1,258,6,1413,54,60
258,69,1,259,5,1418,45,50
259,69,1,260,5,1423,50,50
260,69,1,261,4,1427,42,40
261,69,1,262,6,1433,64,60
262,69,1,263,9,1442,1,90
263,69,1,264,6,1448,111,60
264,69,1,265,7,1455,1,70
265,69,1,266,2,1457,96,20
266,69,1,267,6,1463,82,60
267,69,1,268,8,1471,1,80
268,69,1,269,8,1479,155,80
269,69,1,270,9,1488,103,90
270,69,1,271,8,1496,96,80
271,69,1,272,7,1503,1,70
272,69,1,273,5,1508,106,50
273,69,1,274,6,1514,1,60
274,69,1,275,2,1516,85,20
275,69,1,276,5,1521,53,50
276,69,1,277,7,1528,57,70
277,69,1,278,5,1533,63,50
278,69,1,279,3,1536,44,30
279,69,1,280,3,1539,29,30
280,69,1,281,2,1541,28,20
281,69,1,282,9,1550,67,90
282,69,1,283,3,1553,43,30
283,69,1,284,7,1560,1,70
284,69,1,285,8,1568,118,80
285,69,1,286,6,1574,1,60
286,69,1,287,5,1579,1,50
287,69,1,288,4,1583,145,40
288,69,1,289,9,1592,1,90
289,69,1,290,2,1594,105,20
290,69,1,291,8,1602,90,80
291,69,1,292,6,1608,78,60
292,69,1,293,8,1616,1,80
293,69,1,294,2,1618,106,20
294,69,1,295,6,1624,68,60
295,69,1,296,2,1626,48,20
296,69,1,297,9,1635,1,90
297,69,1,298,8,1643,117,80
298,69,1,299,4,1647,81,40
299,69,1,300,9,1656,1,90
300,69,1,301,2,1658,88,20
301,69,1,302,9,1667,78,90
302,69,1,303,5,1672,79,50
303,69,1,304,2,1674,40,20
304,69,1,305,9,1683,1,90
305,69,1,306,6,1689,96,60
306,69,1,307,2,1691,68,20
307,69,1,308,6,1697,49,60
308,69,1,309,8,1705,68,80
309,69,1,310,4,1709,52,40
310,69,1,311,3,1712,41,30
311,69,1,312,2,1714,22,20
312,69,1,313,6,1720,1,60
313,69,1,314,7,1727,92,70
314,69,1,315,7,1734,61,70
315,69,1,316,6,1740,1,60
316,69,1,317,6,1746,103,60
317,69,1,318,9,1755,104,90
318,69,1,319,7,1762,86,70
319,69,1,320,6,1768,66,60
320,69,1,321,6,1774,62,60
321,69,1,322,6,1780,60,60
322,69,1,323,8,1788,1,80
323,69,1,324,4,1792,114,40
324,69,1,325,7,1799,93,70
325,69,1,326,4,1803,46,40
326,69,1,327,7,1810,65,70
327,69,1,328,2,1812,46,20
328,69,1,329,7,1819,1,70
329,69,1,330,6,1825,1,60
330,69,1,331,4,1829,97,40
331,69,1,332,8,1837,90,80
332,69,1,333,2,1839,59,20
333,69,1,334,8,1847,79,80
334,69,1,335,8,1855,80,80
335,69,1,336,7,1862,68,70
336,69,1,337,9,1871,82,90
337,69,1,338,9,1880,100,90
338,69,1,339,8,1888,77,80
339,69,1,340,2,1890,1,20
340,69,1,341,8,1898,104,80
341,69,1,342,2,1900,1,20
342,69,1,343,2,1902,61,20
343,69,1,344,5,1907,49,50
344,69,1,345,3,1910,41,30
345,69,1,346,7,1917,1,70
346,69,1,347,2,1919,1,20
347,69,1,348,8,1927,104,80
348,69,1,349,2,1929,51,20
349,69,1,350,9,1938,78,90
350,69,1,351,3,1941,45,30
351,69,1,352,2,1943,27,20
352,69,1,353,5,1948,42,50
353,69,1,354,6,1954,57,60
354,69,1,355,4,1958,1,40
355,69,1,356,8,1966,1,80
356,69,1,357,3,1969,132,30
357,69,1,358,9,1978,87,90
358,69,1,359,8,1986,82,80
359,69,1,360,2,1988,39,20
360,69,1,361,7,1995,1,70
361,69,1,362,2,1997,71,20
362,69,1,363,9,2006,1,90
363,69,1,364,8,2014,116,80
364,69,1,365,9,2023,98,90
365,69,1,366,9,2032,1,90
366,69,1,367,6,2038,1,60
367,69,1,368,2,2040,1,20
368,69,1,369,2,2042,1,20
369,69,1,370,7,2049,1,70
370,69,1,371,2,2051,1,20
371,69,1,372,2,2053,217,20
372,69,1,373,6,2059,107,60
373,69,1,374,6,2065,1,60
374,69,1,375,9,2074,1,90
375,69,1,376,2,2076,1,20
376,69,1,377,6,2082,1,60
377,69,1,378,9,2091,1,90
378,69,1,379,4,2095,274,40
379,69,1,380,2,2097,105,20
380,69,1,381,6,2103,1,60
381,69,1,382,2,2105,1,20
382,69,1,383,8,2113,141,80
383,69,1,384,5,2118,77,50
384,69,1,385,8,2126,1,80
385,69,1,386,6,2132,1,60
386,69,1,387,9,2141,190,90
387,69,1,388,2,2143,93,20
388,69,1,389,4,2147,48,40
389,69,1,390,7,2154,67,70
390,69,1,391,3,2157,51,30
391,69,1,392,8,2165,1,80
392,69,1,393,8,2173,127,80
393,69,1,394,5,2178,72,50
394,69,1,395,3,2181,54,30
395,69,1,396,3,2184,48,30
396,69,1,397,7,2191,1,70
397,69,1,398,2,2193,56,20
398,69,1,399,3,2196,48,30
399,69,1,400,4,2200,1,40
400,69,1,401,4,2204,77,40
401,69,1,402,8,2212,66,80
402,69,1,403,6,2218,61,60
403,69,1,404,7,2225,66,70
404,69,1,405,5,2230,59,50
405,69,1,406,7,2237,50,70
406,69,1,407,5,2242,59,50
407,69,1,408,8,2250,74,80
408,69,1,409,4,2254,62,40
409,69,1,410,5,2259,58,50
410,69,1,411,5,2264,49,50
411,69,1,412,4,2268,44,40
412,69,1,413,4,2272,1,40
413,69,1,414,5,2277,66,50
414,69,1,415,6,2283,66,60
415,69,1,416,6,2289,53,60
416,69,1,417,6,2295,60,60
417,69,1,418,9,2304,69,90
418,69,1,419,5,2309,61,50
419,69,1,420,8,2317,88,80
420,69,1,421,6,2323,70,60
421,69,1,422,6,2329,48,60
422,69,1,423,7,2336,50,70
423,69,1,424,5,2341,58,50
424,69,1,425,6,2347,70,60
425,69,1,426,8,2355,75,80
426,69,1,427,2,2357,37,20
427,69,1,428,9,2366,1,90
428,69,1,429,6,2372,113,60
429,69,1,430,5,2377,89,50
430,69,1,431,9,2386,88,90
431,69,1,432,2,2388,35,20
432,69,1,433,3,2391,1,30
433,69,1,434,3,2394,43,30
434,69,1,435,6,2400,69,60
435,69,1,436,3,2403,54,30
436,69,1,437,9,2412,68,90
437,69,1,438,6,2418,71,60
438,69,1,439,8,2426,71,80
439,69,1,440,2,2428,43,20
440,69,1,441,8,2436,51,80
441,69,1,442,4,2440,55,40
442,69,1,443,4,2444,1,40
443,69,1,444,3,2447,1,30
444,69,1,445,3,2450,93,30
445,69,1,446,9,2459,83,90
446,69,1,447,9,2468,98,90
447,69,1,448,6,2474,80,60
448,69,1,449,7,2481,85,70
449,69,1,450,2,2483,1,20
450,69,1,451,3,2486,1,30
451,69,1,452,9,2495,104,90
452,69,1,453,2,2497,59,20
453,69,1,454,4,2501,48,40
454,69,1,455,8,2509,63,80
455,69,1,456,4,2513,62,40
456,69,1,457,6,2519,49,60
457,69,1,458,7,2526,55,70
458,69,1,459,6,2532,1,60
459,69,1,460,5,2537,97,50
460,69,1,461,3,2540,62,30
461,69,1,462,5,2545,49,50
462,69,1,463,4,2549,36,40
463,69,1,464,7,2556,1,70
464,69,1,465,9,2565,1,90
465,69,1,466,3,2568,122,30
466,69,1,467,7,2575,96,70
467,69,1,468,4,2579,58,40
468,69,1,469,4,2583,58,40
469,69,1,470,6,2589,51,60
470,69,1,471,3,2592,45,30
471,69,1,472,6,2598,54,60
472,69,1,473,9,2607,87,90
473,69,1,474,9,2616,1,90
474,69,1,475,7,2623,1,70
475,69,1,476,7,2630,184,70
476,69,1,477,9,2639,101,90
477,69,1,478,3,2642,1,30
478,69,1,479,2,2644,82,20
479,69,1,480,2,2646,26,20
480,69,1,481,9,2655,87,90
481,69,1,482,4,2659,66,40
482,69,1,483,4,2663,1,40
483,69,1,484,3,2666,75,30
484,69,1,485,5,2671,47,50
485,69,1,486,6,2677,43,60
486,69,1,487,2,2679,1,20
487,69,1,488,2,2681,1,20
488,69,1,489,5,2686,64,50
489,69,1,490,3,2689,51,30
490,69,1,491,9,2698,65,90
491,69,1,492,9,2707,69,90
492,69,1,493,9,2716,1,90
493,69,1,494,8,2724,127,80
494,69,1,495,8,2732,1,80
495,69,1,496,6,2738,114,60
496,69,1,497,2,2740,75,20
497,69,1,498,2,2742,40,20
498,69,1,499,6,2748,1,60
499,69,1,500,3,2751,71,30
500,69,1,501,3,2754,59,30
501,69,1,502,3,2757,27,30
502,69,1,503,3,2760,32,30
503,69,1,504,4,2764,1,40
504,69,1,505,7,2771,79,70
505,69,1,506,7,2778,71,70
506,69,1,507,2,2780,40,20
507,69,1,508,6,2786,1,60
508,69,1,509,9,2795,91,90
509,69,1,510,5,2800,81,50
510,69,1,511,3,2803,1,30
511,69,1,512,6,2809,93,60
512,69,1,513,2,2811,63,20
513,69,1,514,2,2813,1,20
514,69,1,515,9,2822,92,90
515,69,1,516,9,2831,92,90
516,69,1,517,4,2835,69,40
517,69,1,518,2,2837,35,20
518,69,1,519,9,2846,61,90
519,69,1,520,7,2853,64,70
520,69,1,521,9,2862,81,90
521,69,1,522,6,2868,59,60
522,69,1,523,8,2876,86,80
523,69,1,524,6,2882,57,60
524,69,1,525,3,2885,52,30
525,69,1,526,2,2887,28,20
526,69,1,527,9,2896,68,90
527,69,1,528,4,2900,1,40
528,69,1,529,3,2903,1,30
529,69,1,530,6,2909,101,60
530,69,1,531,5,2914,57,50
531,69,1,532,9,2923,75,90
532,69,1,533,4,2927,52,40
533,69,1,534,6,2933,51,60
534,69,1,535,5,2938,37,50
535,69,1,536,5,2943,1,50
536,69,1,537,7,2950,1,70
537,69,1,538,8,2958,152,80
538,69,1,539,3,2961,79,30
539,69,1,540,6,2967,64,60
540,69,1,541,4,2971,57,40
541,69,1,542,3,2974,44,30
542,69,1,543,4,2978,42,40
543,69,1,544,6,2984,65,60
544,69,1,545,2,2986,32,20
545,69,1,546,4,2990,25,40
546,69,1,547,3,2993,28,30
547,69,1,548,6,2999,70,60
548,69,1,549,6,3005,1,60
549,69,1,550,3,3008,62,30
550,69,1,551,5,3013,61,50
551,69,1,552,3,3016,1,30
552,69,1,553,3,3019,56,30
553,69,1,554,8,3027,76,80
554,69,1,555,7,3034,64,70
555,69,1,556,7,3041,76,70
556,69,1,557,5,3046,56,50
557,69,1,558,3,3049,50,30
558,69,1,559,4,3053,1,40
559,69,1,560,5,3058,58,50
560,69,1,561,4,3062,51,40
561,69,1,562,6,3068,59,60
562,69,1,563,7,3075,57,70
563,69,1,564,3,3078,53,30
564,69,1,565,3,3081,35,30
565,69,1,566,2,3083,23,20
566,69,1,567,8,3091,74,80
567,69,1,568,6,3097,62,60
568,69,1,569,7,3104,63,70
569,69,1,570,9,3113,86,90
570,69,1,571,4,3117,58,40
571,69,1,572,8,3125,89,80
572,69,1,573,4,3129,1,40
573,69,1,574,3,3132,66,30
574,69,1,575,4,3136,49,40
575,69,1,576,8,3144,63,80
576,69,1,577,9,3153,1,90
577,69,1,578,8,3161,134,80
578,69,1,579,5,3166,98,50
579,69,1,580,6,3172,72,60
580,69,1,581,9,3181,85,90
581,69,1,582,3,3184,58,30
582,69,1,583,6,3190,58,60
583,69,1,584,3,3193,1,30
584,69,1,585,6,3199,65,60
585,69,1,586,2,3201,48,20
586,69,1,587,5,3206,52,50
587,69,1,588,8,3214,65,80
588,69,1,589,2,3216,47,20
589,69,1,590,2,3218,31,20
590,69,1,591,9,3227,76,90
591,69,1,592,8,3235,1,80
592,69,1,593,4,3239,95,40
593,69,1,594,5,3244,63,50
594,69,1,595,7,3251,1,70
595,69,1,596,2,3253,86,20
596,69,1,597,8,3261,86,80
597,69,1,598,8,3269,80,80
598,69,1,599,8,3277,76,80
599,69,1,600,8,3285,63,80
600,69,1,601,9,3294,84,90
601,69,1,602,6,3300,66,60
602,69,1,603,5,3305,66,50
603,69,1,604,7,3312,63,70
604,69,1,605,2,3314,33,20
605,69,1,606,6,3320,51,60
606,69,1,607,2,3322,35,20
607,69,1,608,3,3325,34,30
608,69,1,609,8,3333,56,80
609,69,1,610,9,3342,1,90
610,69,1,611,7,3349,118,70
611,69,1,612,6,3355,86,60
612,69,1,613,3,3358,59,30
613,69,1,614,7,3365,67,70
614,69,1,615,4,3369,42,40
615,69,1,616,8,3377,66,80
616,69,1,617,5,3382,56,50
617,69,1,618,4,3386,40,40
618,69,1,619,7,3393,62,70
619,69,1,620,8,3401,86,80
620,69,1,621,5,3406,70,50
621,69,1,622,4,3410,1,40
622,69,1,623,9,3419,95,90
623,69,1,624,5,3424,56,50
624,69,1,625,2,3426,38,20
625,69,1,626,5,3431,43,50
626,69,1,627,4,3435,44,40
627,69,1,628,2,3437,40,20
628,69,1,629,6,3443,50,60
629,69,1,630,6,3449,1,60
630,69,1,631,2,3451,1,20
631,69,1,632,2,3453,89,20
632,69,1,633,3,3456,1,30
633,69,1,634,8,3464,81,80
634,69,1,635,5,3469,63,50
635,69,1,636,8,3477,75,80
636,69,1,637,5,3482,1,50
637,69,1,638,2,3484,75,20
638,69,1,639,2,3486,39,20
639,69,1,640,4,3490,50,40
640,69,1,641,2,3492,28,20
641,69,1,642,9,3501,1,90
642,69,1,643,4,3505,88,40
643,69,1,644,9,3514,85,90
644,69,1,645,2,3516,51,20
645,69,1,646,8,3524,52,80
646,69,1,647,2,3526,35,20
647,69,1,648,6,3532,1,60
648,69,1,649,2,3534,66,20
649,69,1,650,3,3537,43,30
650,69,1,651,2,3539,21,20
651,69,1,652,7,3546,50,70
652,69,1,653,2,3548,1,20
653,69,1,654,5,3553,1,50
654,69,1,655,6,3559,109,60
655,69,1,656,4,3563,75,40
656,69,1,657,9,3572,98,90
657,69,1,658,7,3579,67,70
658,69,1,659,6,3585,53,60
659,69,1,660,8,3593,74,80
660,69,1,661,4,3597,59,40
661,69,1,662,4,3601,44,40
662,69,1,663,8,3609,78,80
663,69,1,664,3,3612,46,30
664,69,1,665,5,3617,1,50
665,69,1,666,9,3626,93,90
666,69,1,667,2,3628,57,20
667,69,1,668,9,3637,73,90
668,69,1,669,5,3642,54,50
669,69,1,670,7,3649,1,70
670,69,1,671,3,3652,82,30
671,69,1,672,7,3659,69,70
672,69,1,673,2,3661,41,20
673,69,1,674,3,3664,40,30
674,69,1,675,5,3669,43,50
675,69,1,676,8,3677,1,80
676,69,1,677,7,3684,110,70
677,69,1,678,6,3690,85,60
678,69,1,679,4,3694,63,40
679,69,1,680,7,3701,59,70
680,69,1,681,7,3708,63,70
681,69,1,682,6,3714,66,60
682,69,1,683,6,3720,63,60
683,69,1,684,5,3725,1,50
684,69,1,685,2,3727,56,20
685,69,1,686,4,3731,52,40
686,69,1,687,7,3738,53,70
687,69,1,688,7,3745,79,70
688,69,1,689,6,3751,70,60
689,69,1,690,5,3756,54,50
690,69,1,691,5,3761,43,50
691,69,1,692,4,3765,1,40
692,69,1,693,8,3773,1,80
693,69,1,694,3,3776,89,30
694,69,1,695,2,3778,58,20
695,69,1,696,8,3786,78,80
696,69,1,697,3,3789,52,30
697,69,1,698,3,3792,1,30
698,69,1,699,7,3799,88,70
699,69,1,700,7,3806,69,70
700,69,1,701,2,3808,41,20
701,69,1,702,6,3814,52,60
702,69,1,703,6,3820,48,60
703,69,1,704,4,3824,55,40
704,69,1,705,6,3830,71,60
705,69,1,706,2,3832,1,20
706,69,1,707,4,3836,48,40
707,69,1,708,5,3841,59,50
708,69,1,709,9,3850,84,90
709,69,1,710,9,3859,81,90
710,69,1,711,3,3862,54,30
711,69,1,712,6,3868,65,60
712,69,1,713,9,3877,69,90
713,69,1,714,6,3883,76,60
714,69,1,715,5,3888,62,50
715,69,1,716,3,3891,37,30
716,69,1,717,4,3895,1,40
717,69,1,718,9,3904,104,90
718,69,1,719,7,3911,71,70
719,69,1,720,8,3919,64,80
720,69,1,721,6,3925,63,60
721,69,1,722,7,3932,60,70
722,69,1,723,2,3934,42,20
723,69,1,724,9,3943,65,90
724,69,1,725,6,3949,51,60
725,69,1,726,5,3954,70,50
726,69,1,727,4,3958,49,40
727,69,1,728,3,3961,41,30
728,69,1,729,9,3970,61,90
729,69,1,730,4,3974,41,40
730,69,1,731,9,3983,70,90
731,69,1,732,6,3989,73,60
732,69,1,733,3,3992,40,30
733,69,1,734,4,3996,42,40
734,69,1,735,3,3999,30,30
735,69,1,736,2,4001,1,20
736,69,1,737,2,4003,1,20
737,69,1,738,8,4011,84,80
738,69,1,739,6,4017,67,60
739,69,1,740,2,4019,46,20
740,69,1,741,7,4026,67,70
741,69,1,742,7,4033,72,70
742,69,1,743,8,4041,70,80
743,69,1,744,8,4049,69,80
744,69,1,745,7,4056,84,70
745,69,1,746,8,4064,63,80
746,69,1,747,7,4071,83,70
747,69,1,748,6,4077,66,60
748,69,1,749,3,4080,38,30
749,69,1,750,4,4084,1,40
750,69,1,751,2,4086,52,20
751,69,1,752,9,4095,75,90
752,69,1,753,3,4098,40,30
753,69,1,754,4,4102,41,40
754,69,1,755,7,4109,66,70
755,69,1,756,7,4116,60,70
756,69,1,757,2,4118,35,20
757,69,1,758,5,4123,1,50
758,69,1,759,3,4126,65,30
759,69,1,760,2,4128,33,20
760,69,1,761,2,4130,21,20
761,69,1,762,4,4134,37,40
762,69,1,763,7,4141,57,70
763,69,1,764,3,4144,34,30
764,69,1,765,2,4146,26,20
765,69,1,766,3,4149,24,30
766,69,1,767,6,4155,41,60
767,69,1,768,2,4157,24,20
768,69,1,769,3,4160,23,30
769,69,1,770,4,4164,47,40
770,69,1,771,9,4173,80,90
771,69,1,772,7,4180,1,70
772,69,1,773,8,4188,126,80
773,69,1,774,8,4196,118,80
774,69,1,775,6,4202,70,60
775,69,1,776,6,4208,69,60
776,69,1,777,3,4211,43,30
777,69,1,778,2,4213,26,20
778,69,1,779,7,4220,61,70
779,69,1,780,5,4225,56,50
780,69,1,781,4,4229,35,40
781,69,1,782,6,4235,58,60
782,69,1,783,5,4240,53,50
783,69,1,784,5,4245,54,50
784,69,1,785,2,4247,34,20
785,69,1,786,6,4253,1,60
786,69,1,787,7,4260,96,70
787,69,1,788,9,4269,86,90
788,69,1,789,2,4271,45,20
789,69,1,790,2,4273,22,20
790,69,1,791,8,4281,1,80
791,69,1,792,9,4290,114,90
792,69,1,793,4,4294,62,40
793,69,1,794,6,4300,65,60
794,69,1,795,3,4303,44,30
795,69,1,796,8,4311,59,80
796,69,1,797,4,4315,52,40
797,69,1,798,5,4320,1,50
798,69,1,799,4,4324,101,40
799,69,1,800,4,4328,50,40
800,69,1,801,3,4331,26,30
801,69,1,802,4,4335,42,40
802,69,1,803,2,4337,37,20
803,69,1,804,2,4339,17,20
804,69,1,805,6,4345,39,60
805,69,1,806,2,4347,34,20
806,69,1,807,8,4355,49,80
807,69,1,808,9,4364,74,90
808,69,1,809,9,4373,75,90
809,69,1,810,7,4380,74,70
810,69,1,811,8,4388,1,80
811,69,1,812,6,4394,125,60
812,69,1,813,7,4401,85,70
813,69,1,814,4,4405,49,40
814,69,1,815,3,4408,42,30
815,69,1,816,4,4412,43,40
816,69,1,817,9,4421,79,90
817,69,1,818,6,4427,53,60
818,69,1,819,9,4436,65,90
819,69,1,820,4,4440,60,40
820,69,1,821,6,4446,58,60
821,69,1,822,7,4453,1,70
822,69,1,823,5,4458,98,50
823,69,1,824,7,4465,74,70
824,69,1,825,2,4467,35,20
825,69,1,826,7,4474,1,70
826,69,1,827,5,4479,92,50
827,69,1,828,6,4485,69,60
828,69,1,829,2,4487,1,20
829,69,1,830,9,4496,75,90
830,69,1,831,7,4503,95,70
831,69,1,832,8,4511,79,80
832,69,1,833,4,4515,1,40
833,69,1,834,7,4522,95,70
834,69,1,835,2,4524,1,20
835,69,1,836,6,4530,76,60
836,69,1,837,4,4534,67,40
837,69,1,838,4,4538,48,40
838,69,1,839,4,4542,42,40
839,69,1,840,5,4547,48,50
840,69,1,841,5,4552,43,50
841,69,1,842,7,4559,1,70
842,69,1,843,6,4565,101,60
843,69,1,844,5,4570,72,50
844,69,1,845,9,4579,82,90
845,69,1,846,9,4588,98,90
846,69,1,847,2,4590,49,20
847,69,1,848,2,4592,30,20
848,69,1,849,2,4594,25,20
849,69,1,850,9,4603,66,90
850,69,1,851,8,4611,68,80
851,69,1,852,2,4613,45,20
852,69,1,853,3,4616,28,30
853,69,1,854,9,4625,79,90
854,69,1,855,4,4629,1,40
855,69,1,856,5,4634,96,50
856,69,1,857,6,4640,64,60
857,69,1,858,7,4647,71,70
858,69,1,859,3,4650,43,30
859,69,1,860,4,4654,48,40
860,69,1,861,4,4658,57,40
861,69,1,862,5,4663,1,50
862,69,1,863,8,4671,1,80
863,69,1,864,2,4673,117,20
864,69,1,865,9,4682,90,90
865,69,1,866,9,4691,106,90
866,69,1,867,4,4695,69,40
867,69,1,868,6,4701,41,60
868,69,1,869,6,4707,53,60
869,69,1,870,8,4715,83,80
870,69,1,871,9,4724,75,90
871,69,1,872,9,4733,80,90
872,69,1,873,6,4739,78,60
873,69,1,874,2,4741,1,20
874,69,1,875,8,4749,1,80
875,69,1,876,9,4758,1,90
876,69,1,877,6,4764,181,60
877,69,1,878,5,4769,90,50
878,69,1,879,5,4774,64,50
879,69,1,880,2,4776,34,20
880,69,1,881,4,4780,1,40
881,69,1,882,2,4782,54,20
882,69,1,883,6,4788,52,60
883,69,1,884,9,4797,94,90
884,69,1,885,4,4801,49,40
885,69,1,886,9,4810,1,90
886,69,1,887,2,4812,88,20
887,69,1,888,9,4821,91,90
888,69,1,889,8,4829,84,80
889,69,1,890,4,4833,52,40
890,69,1,891,8,4841,85,80
891,69,1,892,6,4847,55,60
892,69,1,893,5,4852,61,50
893,69,1,894,3,4855,36,30
894,69,1,895,8,4863,1,80
895,69,1,896,6,4869,108,60
896,69,1,897,5,4874,1,50
897,69,1,898,8,4882,124,80
898,69,1,899,9,4891,120,90
899,69,1,900,3,4894,1,30
900,69,1,901,2,4896,60,20
901,69,1,902,8,4904,86,80
902,69,1,903,8,4912,80,80
903,69,1,904,9,4921,94,90
904,69,1,905,5,4926,76,50
905,69,1,906,7,4933,77,70
906,69,1,907,4,4937,53,40
907,69,1,908,4,4941,1,40
908,69,1,909,6,4947,70,60
909,69,1,910,9,4956,77,90
910,69,1,911,8,4964,1,80
911,69,1,912,3,4967,86,30
912,69,1,913,7,4974,92,70
913,69,1,914,2,4976,37,20
914,69,1,915,3,4979,30,30
915,69,1,916,8,4987,50,80
916,69,1,917,9,4996,80,90
917,69,2,1,2,2,4,20
918,69,2,2,8,10,42,80
919,69,2,3,6,16,1,60
920,69,2,4,9,25,119,90
921,69,2,5,4,29,66,40
922,69,2,6,2,31,41,20
923,69,2,7,9,40,84,90
924,69,2,8,7,47,69,70
925,69,2,9,8,55,70,80
926,69,2,10,6,61,73,60
927,69,2,11,6,67,1,60
928,69,2,12,7,74,1,70
929,69,2,13,2,76,118,20
930,69,2,14,7,83,96,70
931,69,2,15,3,86,52,30
932,69,2,16,7,93,65,70
933,69,2,17,7,100,57,70
934,69,2,18,7,107,72,70
935,69,2,19,2,109,41,20
936,69,2,20,3,112,35,30
937,69,2,21,8,120,67,80
938,69,2,22,4,124,1,40
939,69,2,23,7,131,84,70
940,69,2,24,5,136,74,50
941,69,2,25,6,142,66,60
942,69,2,26,2,144,1,20
943,69,2,27,7,151,69,70
944,69,2,28,6,157,75,60
945,69,2,29,7,164,74,70
946,69,2,30,3,167,45,30
947,69,2,31,9,176,1,90
948,69,2,32,5,181,100,50
949,69,2,33,7,188,1,70
950,69,2,34,3,191,97,30
951,69,2,35,8,199,84,80
952,69,2,36,8,207,1,80
953,69,2,37,8,215,128,80
954,69,2,38,4,219,69,40
955,69,2,39,5,224,1,50
956,69,2,40,5,229,89,50
957,69,2,41,6,235,1,60
958,69,2,42,7,242,119,70
959,69,2,43,3,245,74,30
960,69,2,44,9,254,90,90
961,69,2,45,7,261,77,70
962,69,2,46,7,268,63,70
963,69,2,47,4,272,1,40
964,69,2,48,3,275,58,30
965,69,2,49,7,282,1,70
966,69,2,50,7,289,104,70
967,69,2,51,8,297,100,80
968,69,2,52,5,302,1,50
969,69,2,53,3,305,85,30
970,69,2,54,7,312,65,70
971,69,2,55,9,321,86,90
972,69,2,56,5,326,61,50
973,69,2,57,3,329,39,30
974,69,2,58,2,331,28,20
975,69,2,59,6,337,47,60
976,69,2,60,6,343,44,60
977,69,2,61,4,347,1,40
978,69,2,62,3,350,1,30
979,69,2,63,3,353,1,30
980,69,2,64,9,362,130,90
981,69,2,65,9,371,1,90
982,69,2,66,5,376,1,50
983,69,2,67,4,380,161,40
984,69,2,68,2,382,87,20
985,69,2,69,6,388,79,60
986,69,2,70,8,396,1,80
987,69,2,71,7,403,113,70
988,69,2,72,2,405,1,20
989,69,2,73,7,412,105,70
990,69,2,74,7,419,73,70
991,69,2,75,5,424,59,50
992,69,2,76,4,428,57,40
993,69,2,77,6,434,44,60
994,69,2,78,9,443,86,90
995,69,2,79,2,445,40,20
996,69,2,80,2,447,23,20
997,69,2,81,5,452,1,50
998,69,2,82,9,461,96,90
999,69,2,83,8,469,85,80
1000,69,2,84,3,472,49,30
1001,69,2,85,4,476,1,40
1002,69,2,86,5,481,74,50
1003,69,2,87,2,483,60,20
1004,69,2,88,4,487,49,40
1005,69,2,89,9,496,76,90
1006,69,2,90,4,500,1,40
1007,69,2,91,4,504,79,40
1008,69,2,92,7,511,1,70
1009,69,2,93,9,520,1,90
1010,69,2,94,9,529,166,90
1011,69,2,95,8,537,128,80
1012,69,2,96,9,546,98,90
1013,69,2,97,9,555,83,90
1014,69,2,98,3,558,60,30
1015,69,2,99,2,560,37,20
1016,69,2,100,9,569,60,90
1017,69,2,101,6,575,63,60
1018,69,2,102,8,583,67,80
1019,69,2,103,7,590,68,70
1020,69,2,104,6,596,1,60
1021,69,2,105,8,604,120,80
1022,69,2,106,8,612,103,80
1023,69,2,107,5,617,66,50
1024,69,2,108,5,622,52,50
1025,69,2,109,5,627,53,50
1026,69,2,110,9,636,71,90
1027,69,2,111,7,643,80,70
1028,69,2,112,2,645,1,20
1029,69,2,113,3,648,55,30
1030,69,2,114,7,655,1,70
1031,69,2,115,9,664,95,90
1032,69,2,116,2,666,1,20
1033,69,2,117,3,669,1,30
1034,69,2,118,4,673,88,40
1035,69,2,119,2,675,47,20
1036,69,2,120,5,680,48,50
1037,69,2,121,3,683,33,30
1038,69,2,122,3,686,34,30
1039,69,2,123,8,694,59,80
1040,69,2,124,8,702,74,80
1041,69,2,125,9,711,1,90
1042,69,2,126,2,713,1,20
1043,69,2,127,2,715,94,20
1044,69,2,128,2,717,61,20
1045,69,2,129,5,722,54,50
1046,69,2,130,6,728,47,60
1047,69,2,131,4,732,45,40
1048,69,2,132,6,738,56,60
1049,69,2,133,7,745,70,70
1050,69,2,134,7,752,57,70
1051,69,2,135,3,755,48,30
1052,69,2,136,6,761,48,60
1053,69,2,137,8,769,60,80
1054,69,2,138,4,773,59,40
1055,69,2,139,6,779,62,60
1056,69,2,140,7,786,1,70
1057,69,2,141,6,792,1,60
1058,69,2,142,8,800,166,80
1059,69,2,143,9,809,1,90
1060,69,2,144,7,816,1,70
1061,69,2,145,3,819,182,30
1062,69,2,146,5,824,84,50
1063,69,2,147,2,826,55,20
1064,69,2,148,9,835,70,90
1065,69,2,149,8,843,1,80
1066,69,2,150,4,847,1,40
1067,69,2,151,4,851,117,40
1068,69,2,152,4,855,79,40
1069,69,2,153,3,858,40,30
1070,69,2,154,6,864,57,60
1071,69,2,155,7,871,58,70
1072,69,2,156,5,876,52,50
1073,69,2,157,9,885,71,90
1074,69,2,158,5,890,64,50
1075,69,2,159,9,899,79,90
1076,69,2,160,2,901,1,20
1077,69,2,161,7,908,84,70
1078,69,2,162,2,910,55,20
1079,69,2,163,6,916,59,60
1080,69,2,164,3,919,41,30
1081,69,2,165,7,926,1,70
1082,69,2,166,8,934,120,80
1083,69,2,167,3,937,59,30
1084,69,2,168,3,940,38,30
1085,69,2,169,8,948,1,80
1086,69,2,170,6,954,99,60
1087,69,2,171,6,960,76,60
1088,69,2,172,4,964,66,40
1089,69,2,173,5,969,52,50
1090,69,2,174,6,975,52,60
1091,69,2,175,5,980,1,50
1092,69,2,176,4,984,72,40
1093,69,2,177,2,986,44,20
1094,69,2,178,6,992,60,60
1095,69,2,179,4,996,44,40
1096,69,2,180,7,1003,1,70
1097,69,2,181,5,1008,83,50
1098,69,2,182,3,1011,50,30
1099,69,2,183,7,1018,62,70
1100,69,2,184,4,1022,57,40
1101,69,2,185,6,1028,55,60
1102,69,2,186,4,1032,1,40
1103,69,2,187,3,1035,57,30
1104,69,2,188,7,1042,80,70
1105,69,2,189,8,1050,1,80
1106,69,2,190,8,1058,105,80
1107,69,2,191,7,1065,95,70
1108,69,2,192,5,1070,63,50
1109,69,2,193,6,1076,58,60
1110,69,2,194,4,1080,40,40
1111,69,2,195,5,1085,38,50
1112,69,2,196,7,1092,1,70
1113,69,2,197,2,1094,66,20
1114,69,2,198,7,1101,69,70
1115,69,2,199,6,1107,83,60
1116,69,2,200,4,1111,65,40
1117,69,2,201,5,1116,42,50
1118,69,2,202,6,1122,51,60
1119,69,2,203,4,1126,38,40
1120,69,2,204,2,1128,31,20
1121,69,2,205,4,1132,50,40
1122,69,2,206,7,1139,62,70
1123,69,2,207,6,1145,69,60
1124,69,2,208,8,1153,65,80
1125,69,2,209,3,1156,43,30
1126,69,2,210,2,1158,23,20
1127,69,2,211,9,1167,57,90
1128,69,2,212,3,1170,43,30
1129,69,2,213,9,1179,68,90
1130,69,2,214,7,1186,64,70
1131,69,2,215,6,1192,68,60
1132,69,2,216,8,1200,81,80
1133,69,2,217,7,1207,64,70
1134,69,2,218,5,1212,66,50
1135,69,2,219,2,1214,34,20
1136,69,2,220,6,1220,61,60
1137,69,2,221,9,1229,65,90
1138,69,2,222,2,1231,40,20
1139,69,2,223,9,1240,73,90
1140,69,2,224,6,1246,67,60
1141,69,2,225,2,1248,35,20
1142,69,2,226,4,1252,1,40
1143,69,2,227,3,1255,62,30
1144,69,2,228,9,1264,72,90
1145,69,2,229,8,1272,70,80
1146,69,2,230,3,1275,40,30
1147,69,2,231,6,1281,39,60
1148,69,2,232,5,1286,40,50
1149,69,2,233,2,1288,38,20
1150,69,2,234,3,1291,34,30
1151,69,2,235,8,1299,62,80
1152,69,2,236,2,1301,1,20
1153,69,2,237,9,1310,80,90
1154,69,2,238,6,1316,1,60
1155,69,2,239,7,1323,118,70
1156,69,2,240,5,1328,1,50
1157,69,2,241,9,1337,145,90
1158,69,2,242,5,1342,83,50
1159,69,2,243,4,1346,51,40
1160,69,2,244,2,1348,39,20
1161,69,2,245,9,1357,61,90
1162,69,2,246,7,1364,78,70
1163,69,2,247,6,1370,63,60
1164,69,2,248,6,1376,44,60
1165,69,2,249,2,1378,38,20
1166,69,2,250,3,1381,24,30
1167,69,2,251,9,1390,63,90
1168,69,2,252,2,1392,33,20
1169,69,2,253,6,1398,50,60
1170,69,2,254,4,1402,1,40
1171,69,2,255,3,1405,66,30
1172,69,2,256,5,1410,62,50
1173,69,2,257,3,1413,1,30
1174,69,2,258,7,1420,97,70
1175,69,2,259,8,1428,75,80
1176,69,2,260,7,1435,74,70
1177,69,2,261,6,1441,68,60
1178,69,2,262,4,1445,52,40
1179,69,2,263,7,1452,1,70
1180,69,2,264,8,1460,99,80
1181,69,2,265,5,1465,78,50
1182,69,2,266,9,1474,93,90
1183,69,2,267,6,1480,61,60
1184,69,2,268,3,1483,47,30
1185,69,2,269,3,1486,30,30
1186,69,2,270,8,1494,63,80
1187,69,2,271,2,1496,45,20
1188,69,2,272,3,1499,25,30
1189,69,2,273,3,1502,44,30
1190,69,2,274,8,1510,1,80
1191,69,2,275,6,1516,1,60
1192,69,2,276,4,1520,1,40
1193,69,2,277,8,1528,159,80
1194,69,2,278,9,1537,111,90
1195,69,2,279,4,1541,68,40
1196,69,2,280,9,1550,78,90
1197,69,2,281,7,1557,75,70
1198,69,2,282,8,1565,76,80
1199,69,2,283,3,1568,48,30
1200,69,2,284,7,1575,1,70
1201,69,2,285,2,1577,70,20
1202,69,2,286,4,1581,46,40
1203,69,2,287,9,1590,1,90
1204,69,2,288,7,1597,124,70
1205,69,2,289,7,1604,106,70
1206,69,2,290,9,1613,98,90
1207,69,2,291,9,1622,1,90
1208,69,2,292,9,1631,138,90
1209,69,2,293,3,1634,1,30
1210,69,2,294,5,1639,111,50
1211,69,2,295,3,1642,55,30
1212,69,2,296,4,1646,50,40
1213,69,2,297,7,1653,54,70
1214,69,2,298,2,1655,37,20
1215,69,2,299,5,1660,50,50
1216,69,2,300,5,1665,45,50
1217,69,2,301,3,1668,43,30
1218,69,2,302,9,1677,73,90
1219,69,2,303,5,1682,57,50
1220,69,2,304,6,1688,48,60
1221,69,2,305,7,1695,67,70
1222,69,2,306,6,1701,68,60
1223,69,2,307,5,1706,57,50
1224,69,2,308,4,1710,37,40
1225,69,2,309,6,1716,50,60
1226,69,2,310,6,1722,1,60
1227,69,2,311,3,1725,75,30
1228,69,2,312,8,1733,94,80
1229,69,2,313,8,1741,77,80
1230,69,2,314,9,1750,76,90
1231,69,2,315,3,1753,58,30
1232,69,2,316,9,1762,73,90
1233,69,2,317,7,1769,75,70
1234,69,2,318,7,1776,1,70
1235,69,2,319,8,1784,108,80
1236,69,2,320,9,1793,105,90
1237,69,2,321,7,1800,89,70
1238,69,2,322,5,1805,65,50
1239,69,2,323,2,1807,37,20
1240,69,2,324,6,1813,59,60
1241,69,2,325,9,1822,64,90
1242,69,2,326,5,1827,56,50
1243,69,2,327,9,1836,69,90
1244,69,2,328,7,1843,77,70
1245,69,2,329,7,1850,70,70
1246,69,2,330,9,1859,83,90
1247,69,2,331,6,1865,1,60
1248,69,2,332,6,1871,102,60
1249,69,2,333,6,1877,73,60
1250,69,2,334,2,1879,46,20
1251,69,2,335,4,1883,43,40
1252,69,2,336,8,1891,62,80
1253,69,2,337,2,1893,36,20
1254,69,2,338,6,1899,59,60
1255,69,2,339,9,1908,62,90
1256,69,2,340,8,1916,1,80
1257,69,2,341,3,1919,94,30
1258,69,2,342,3,1922,1,30
1259,69,2,343,4,1926,1,40
1260,69,2,344,7,1933,109,70
1261,69,2,345,2,1935,51,20
1262,69,2,346,9,1944,1,90
1263,69,2,347,5,1949,1,50
1264,69,2,348,7,1956,141,70
1265,69,2,349,2,1958,71,20
1266,69,2,350,3,1961,45,30
1267,69,2,351,6,1967,52,60
1268,69,2,352,5,1972,45,50
1269,69,2,353,7,1979,1,70
1270,69,2,354,5,1984,86,50
1271,69,2,355,2,1986,52,20
1272,69,2,356,5,1991,1,50
1273,69,2,357,4,1995,73,40
1274,69,2,358,4,1999,42,40
1275,69,2,359,6,2005,56,60
1276,69,2,360,9,2014,74,90
1277,69,2,361,7,2021,1,70
1278,69,2,362,3,2024,80,30
1279,69,2,363,7,2031,79,70
1280,69,2,364,6,2037,73,60
1281,69,2,365,3,2040,44,30
1282,69,2,366,7,2047,65,70
1283,69,2,367,6,2053,50,60
1284,69,2,368,8,2061,65,80
1285,69,2,369,3,2064,45,30
1286,69,2,370,4,2068,42,40
1287,69,2,371,2,2070,1,20
1288,69,2,372,4,2074,1,40
1289,69,2,373,6,2080,100,60
1290,69,2,374,6,2086,76,60
1291,69,2,375,6,2092,67,60
1292,69,2,376,2,2094,29,20
1293,69,2,377,9,2103,56,90
1294,69,2,378,7,2110,1,70
1295,69,2,379,8,2118,123,80
1296,69,2,380,5,2123,87,50
1297,69,2,381,2,2125,36,20
1298,69,2,382,9,2134,74,90
1299,69,2,383,9,2143,72,90
1300,69,2,384,6,2149,67,60
1301,69,2,385,9,2158,72,90
1302,69,2,386,7,2165,1,70
1303,69,2,387,4,2169,92,40
1304,69,2,388,3,2172,1,30
1305,69,2,389,3,2175,84,30
1306,69,2,390,3,2178,46,30
1307,69,2,391,9,2187,88,90
1308,69,2,392,9,2196,83,90
1309,69,2,393,4,2200,57,40
1310,69,2,394,4,2204,44,40
1311,69,2,395,2,2206,29,20
1312,69,2,396,4,2210,46,40
1313,69,2,397,8,2218,62,80
1314,69,2,398,5,2223,49,50
1315,69,2,399,7,2230,64,70
1316,69,2,400,5,2235,55,50
1317,69,2,401,7,2242,72,70
1318,69,2,402,7,2249,58,70
1319,69,2,403,7,2256,75,70
1320,69,2,404,3,2259,53,30
1321,69,2,405,9,2268,66,90
1322,69,2,406,8,2276,85,80
1323,69,2,407,4,2280,40,40
1324,69,2,408,2,2282,33,20
1325,69,2,409,4,2286,1,40
1326,69,2,410,8,2294,109,80
1327,69,2,411,2,2296,46,20
1328,69,2,412,9,2305,67,90
1329,69,2,413,3,2308,49,30
1330,69,2,414,7,2315,59,70
1331,69,2,415,5,2320,1,50
1332,69,2,416,4,2324,74,40
1333,69,2,417,7,2331,83,70
1334,69,2,418,7,2338,64,70
1335,69,2,419,4,2342,48,40
1336,69,2,420,5,2347,1,50
1337,69,2,421,5,2352,89,50
1338,69,2,422,9,2361,101,90
1339,69,2,423,4,2365,67,40
1340,69,2,424,5,2370,1,50
1341,69,2,425,6,2376,97,60
1342,69,2,426,6,2382,1,60
1343,69,2,427,5,2387,85,50
1344,69,2,428,3,2390,58,30
1345,69,2,429,2,2392,38,20
1346,69,2,430,6,2398,49,60
1347,69,2,431,3,2401,33,30
1348,69,2,432,9,2410,66,90
1349,69,2,433,5,2415,54,50
1350,69,2,434,5,2420,57,50
1351,69,2,435,7,2427,60,70
1352,69,2,436,5,2432,1,50
1353,69,2,437,8,2440,105,80
1354,69,2,438,8,2448,1,80
1355,69,2,439,8,2456,121,80
1356,69,2,440,8,2464,1,80
1357,69,2,441,2,2466,112,20
1358,69,2,442,3,2469,69,30
1359,69,2,443,6,2475,57,60
1360,69,2,444,2,2477,32,20
1361,69,2,445,9,2486,1,90
1362,69,2,446,5,2491,100,50
1363,69,2,447,4,2495,1,40
1364,69,2,448,6,2501,99,60
1365,69,2,449,2,2503,1,20
1366,69,2,450,8,2511,92,80
1367,69,2,451,4,2515,53,40
1368,69,2,452,3,2518,26,30
1369,69,2,453,3,2521,26,30
1370,69,2,454,4,2525,43,40
1371,69,2,455,7,2532,67,70
1372,69,2,456,6,2538,1,60
1373,69,2,457,2,2540,71,20
1374,69,2,458,4,2544,1,40
1375,69,2,459,4,2548,87,40
1376,69,2,460,8,2556,1,80
1377,69,2,461,2,2558,88,20
1378,69,2,462,4,2562,1,40
1379,69,2,463,9,2571,97,90
1380,69,2,464,7,2578,79,70
1381,69,2,465,8,2586,77,80
1382,69,2,466,4,2590,62,40
1383,69,2,467,4,2594,1,40
1384,69,2,468,9,2603,95,90
1385,69,2,469,7,2610,81,70
1386,69,2,470,3,2613,61,30
1387,69,2,471,3,2616,34,30
1388,69,2,472,9,2625,70,90
1389,69,2,473,4,2629,52,40
1390,69,2,474,5,2634,1,50
1391,69,2,475,4,2638,1,40
1392,69,2,476,3,2641,83,30
1393,69,2,477,5,2646,1,50
1394,69,2,478,6,2652,1,60
1395,69,2,479,7,2659,152,70
1396,69,2,480,5,2664,69,50
1397,69,2,481,5,2669,72,50
1398,69,2,482,2,2671,34,20
1399,69,2,483,5,2676,40,50
1400,69,2,484,7,2683,54,70
1401,69,2,485,4,2687,1,40
1402,69,2,486,9,2696,108,90
1403,69,2,487,2,2698,1,20
1404,69,2,488,9,2707,1,90
1405,69,2,489,8,2715,131,80
1406,69,2,490,4,2719,79,40
1407,69,2,491,3,2722,55,30
1408,69,2,492,2,2724,26,20
1409,69,2,493,9,2733,66,90
1410,69,2,494,3,2736,1,30
1411,69,2,495,8,2744,94,80
1412,69,2,496,7,2751,73,70
1413,69,2,497,8,2759,80,80
1414,69,2,498,7,2766,94,70
1415,69,2,499,5,2771,1,50
1416,69,2,500,3,2774,70,30
1417,69,2,501,7,2781,87,70
1418,69,2,502,9,2790,76,90
1419,69,2,503,3,2793,54,30
1420,69,2,504,8,2801,1,80
1421,69,2,505,2,2803,70,20
1422,69,2,506,2,2805,49,20
1423,69,2,507,9,2814,70,90
1424,69,2,508,3,2817,45,30
1425,69,2,509,9,2826,58,90
1426,69,2,510,7,2833,81,70
1427,69,2,511,3,2836,36,30
1428,69,2,512,7,2843,58,70
1429,69,2,513,3,2846,47,30
1430,69,2,514,4,2850,32,40
1431,69,2,515,5,2855,46,50
1432,69,2,516,3,2858,26,30
1433,69,2,517,7,2865,1,70
1434,69,2,518,8,2873,111,80
1435,69,2,519,4,2877,54,40
1436,69,2,520,6,2883,66,60
1437,69,2,521,7,2890,77,70
1438,69,2,522,5,2895,1,50
1439,69,2,523,5,2900,1,50
1440,69,2,524,7,2907,123,70
1441,69,2,525,2,2909,1,20
1442,69,2,526,4,2913,89,40
1443,69,2,527,3,2916,49,30
1444,69,2,528,6,2922,47,60
1445,69,2,529,8,2930,71,80
1446,69,2,530,6,2936,78,60
1447,69,2,531,3,2939,56,30
1448,69,2,532,4,2943,1,40
1449,69,2,533,3,2946,1,30
1450,69,2,534,3,2949,62,30
1451,69,2,535,4,2953,57,40
1452,69,2,536,4,2957,51,40
1453,69,2,537,2,2959,24,20
1454,69,2,538,2,2961,27,20
1455,69,2,539,8,2969,46,80
1456,69,2,540,8,2977,76,80
1457,69,2,541,8,2985,96,80
1458,69,2,542,6,2991,68,60
1459,69,2,543,9,3000,75,90
1460,69,2,544,3,3003,1,30
1461,69,2,545,8,3011,1,80
1462,69,2,546,6,3017,131,60
1463,69,2,547,4,3021,76,40
1464,69,2,548,3,3024,1,30
1465,69,2,549,2,3026,67,20
1466,69,2,550,7,3033,73,70
1467,69,2,551,8,3041,83,80
1468,69,2,552,2,3043,1,20
1469,69,2,553,8,3051,83,80
1470,69,2,554,4,3055,57,40
1471,69,2,555,3,3058,35,30
1472,69,2,556,3,3061,37,30
1473,69,2,557,7,3068,1,70
1474,69,2,558,5,3073,69,50
1475,69,2,559,5,3078,1,50
1476,69,2,560,6,3084,92,60
1477,69,2,561,9,3093,75,90
1478,69,2,562,4,3097,1,40
1479,69,2,563,9,3106,114,90
1480,69,2,564,7,3113,76,70
1481,69,2,565,4,3117,65,40
1482,69,2,566,9,3126,83,90
1483,69,2,567,3,3129,47,30
1484,69,2,568,4,3133,40,40
1485,69,2,569,3,3136,1,30
1486,69,2,570,8,3144,1,80
1487,69,2,571,5,3149,114,50
1488,69,2,572,8,3157,86,80
1489,69,2,573,5,3162,68,50
1490,69,2,574,6,3168,65,60
1491,69,2,575,3,3171,37,30
1492,69,2,576,9,3180,1,90
1493,69,2,577,7,3187,1,70
1494,69,2,578,8,3195,175,80
1495,69,2,579,9,3204,91,90
1496,69,2,580,6,3210,90,60
1497,69,2,581,9,3219,1,90
1498,69,2,582,9,3228,1,90
1499,69,2,583,5,3233,139,50
1500,69,2,584,3,3236,1,30
1501,69,2,585,5,3241,99,50
1502,69,2,586,3,3244,80,30
1503,69,2,587,4,3248,1,40
1504,69,2,588,5,3253,87,50
1505,69,2,589,9,3262,77,90
1506,69,2,590,9,3271,97,90
1507,69,2,591,6,3277,79,60
1508,69,2,592,8,3285,76,80
1509,69,2,593,2,3287,1,20
1510,69,2,594,7,3294,72,70
1511,69,2,595,9,3303,90,90
1512,69,2,596,2,3305,43,20
1513,69,2,597,6,3311,1,60
1514,69,2,598,7,3318,95,70
1515,69,2,599,6,3324,1,60
1516,69,2,600,6,3330,101,60
1517,69,2,601,6,3336,71,60
1518,69,2,602,5,3341,64,50
1519,69,2,603,5,3346,1,50
1520,69,2,604,7,3353,74,70
1521,69,2,605,6,3359,79,60
1522,69,2,606,9,3368,1,90
1523,69,2,607,6,3374,108,60
1524,69,2,608,3,3377,72,30
1525,69,2,609,6,3383,65,60
1526,69,2,610,4,3387,53,40
1527,69,2,611,4,3391,37,40
1528,69,2,612,6,3397,48,60
1529,69,2,613,6,3403,57,60
1530,69,2,614,9,3412,91,90
1531,69,2,615,7,3419,58,70
1532,69,2,616,4,3423,57,40
1533,69,2,617,7,3430,68,70
1534,69,2,618,7,3437,66,70
1535,69,2,619,6,3443,57,60
1536,69,2,620,4,3447,1,40
1537,69,2,621,4,3451,58,40
1538,69,2,622,9,3460,91,90
1539,69,2,623,8,3468,81,80
1540,69,2,624,7,3475,76,70
1541,69,2,625,7,3482,72,70
1542,69,2,626,9,3491,1,90
1543,69,2,627,3,3494,90,30
1544,69,2,628,9,3503,96,90
1545,69,2,629,9,3512,96,90
1546,69,2,630,6,3518,1,60
1547,69,2,631,8,3526,1,80
1548,69,2,632,8,3534,164,80
1549,69,2,633,8,3542,106,80
1550,69,2,634,9,3551,101,90
1551,69,2,635,6,3557,89,60
1552,69,2,636,9,3566,90,90
1553,69,2,637,2,3568,44,20
1554,69,2,638,8,3576,65,80
1555,69,2,639,6,3582,67,60
1556,69,2,640,4,3586,52,40
1557,69,2,641,2,3588,33,20
1558,69,2,642,5,3593,38,50
1559,69,2,643,3,3596,41,30
1560,69,2,644,7,3603,57,70
1561,69,2,645,9,3612,77,90
1562,69,2,646,4,3616,55,40
1563,69,2,647,7,3623,1,70
1564,69,2,648,8,3631,108,80
1565,69,2,649,4,3635,1,40
1566,69,2,650,9,3644,126,90
1567,69,2,651,6,3650,92,60
1568,69,2,652,7,3657,73,70
1569,69,2,653,6,3663,76,60
1570,69,2,654,9,3672,1,90
1571,69,2,655,5,3677,107,50
1572,69,2,656,5,3682,63,50
1573,69,2,657,4,3686,51,40
1574,69,2,658,7,3693,56,70
1575,69,2,659,8,3701,79,80
1576,69,2,660,5,3706,56,50
1577,69,2,661,7,3713,72,70
1578,69,2,662,3,3716,49,30
1579,69,2,663,9,3725,65,90
1580,69,2,664,8,3733,76,80
1581,69,2,665,5,3738,1,50
1582,69,2,666,8,3746,98,80
1583,69,2,667,5,3751,80,50
1584,69,2,668,8,3759,65,80
1585,69,2,669,7,3766,63,70
1586,69,2,670,2,3768,40,20
1587,69,2,671,8,3776,1,80
1588,69,2,672,4,3780,108,40
1589,69,2,673,6,3786,61,60
1590,69,2,674,2,3788,46,20
1591,69,2,675,9,3797,87,90
1592,69,2,676,5,3802,69,50
1593,69,2,677,7,3809,62,70
1594,69,2,678,8,3817,74,80
1595,69,2,679,9,3826,93,90
1596,69,2,680,9,3835,99,90
1597,69,2,681,2,3837,1,20
1598,69,2,682,7,3844,1,70
1599,69,2,683,2,3846,92,20
1600,69,2,684,9,3855,1,90
1601,69,2,685,2,3857,108,20
1602,69,2,686,9,3866,91,90
1603,69,2,687,6,3872,76,60
1604,69,2,688,8,3880,69,80
1605,69,2,689,7,3887,54,70
1606,69,2,690,4,3891,55,40
1607,69,2,691,6,3897,60,60
1608,69,2,692,2,3899,30,20
1609,69,2,693,9,3908,69,90
1610,69,2,694,7,3915,72,70
1611,69,2,695,5,3920,52,50
1612,69,2,696,9,3929,77,90
1613,69,2,697,3,3932,42,30
1614,69,2,698,8,3940,57,80
1615,69,2,699,2,3942,40,20
1616,69,2,700,4,3946,1,40
1617,69,2,701,7,3953,1,70
1618,69,2,702,3,3956,86,30
1619,69,2,703,7,3963,87,70
1620,69,2,704,6,3969,71,60
1621,69,2,705,6,3975,75,60
1622,69,2,706,2,3977,28,20
1623,69,2,707,5,3982,39,50
1624,69,2,708,9,3991,74,90
1625,69,2,709,8,3999,85,80
1626,69,2,710,6,4005,1,60
1627,69,2,711,8,4013,1,80
1628,69,2,712,7,4020,153,70
1629,69,2,713,7,4027,99,70
1630,69,2,714,5,4032,69,50
1631,69,2,715,9,4041,83,90
1632,69,2,716,6,4047,81,60
1633,69,2,717,9,4056,73,90
1634,69,2,718,3,4059,49,30
1635,69,2,719,9,4068,76,90
1636,69,2,720,8,4076,78,80
1637,69,2,721,8,4084,82,80
1638,69,2,722,5,4089,72,50
1639,69,2,723,6,4095,58,60
1640,69,2,724,5,4100,55,50
1641,69,2,725,6,4106,61,60
1642,69,2,726,7,4113,83,70
1643,69,2,727,6,4119,1,60
1644,69,2,728,2,4121,55,20
1645,69,2,729,5,4126,70,50
1646,69,2,730,8,4134,1,80
1647,69,2,731,9,4143,128,90
1648,69,2,732,9,4152,1,90
1649,69,2,733,5,4157,1,50
1650,69,2,734,8,4165,167,80
1651,69,2,735,8,4173,127,80
1652,69,2,736,4,4177,75,40
1653,69,2,737,5,4182,67,50
1654,69,2,738,9,4191,1,90
1655,69,2,739,8,4199,117,80
1656,69,2,740,7,4206,1,70
1657,69,2,741,7,4213,136,70
1658,69,2,742,4,4217,1,40
1659,69,2,743,5,4222,123,50
1660,69,2,744,3,4225,1,30
1661,69,2,745,9,4234,119,90
1662,69,2,746,2,4236,51,20
1663,69,2,747,3,4239,33,30
1664,69,2,748,6,4245,59,60
1665,69,2,749,8,4253,1,80
1666,69,2,750,8,4261,119,80
1667,69,2,751,4,4265,52,40
1668,69,2,752,8,4273,76,80
1669,69,2,753,9,4282,1,90
1670,69,2,754,8,4290,130,80
1671,69,2,755,7,4297,1,70
1672,69,2,756,3,4300,104,30
1673,69,2,757,3,4303,1,30
1674,69,2,758,4,4307,94,40
1675,69,2,759,8,4315,73,80
1676,69,2,760,7,4322,79,70
1677,69,2,761,6,4328,71,60
1678,69,2,762,5,4333,51,50
1679,69,2,763,5,4338,63,50
1680,69,2,764,4,4342,51,40
1681,69,2,765,3,4345,1,30
1682,69,2,766,7,4352,62,70
1683,69,2,767,9,4361,90,90
1684,69,2,768,3,4364,61,30
1685,69,2,769,8,4372,1,80
1686,69,2,770,6,4378,1,60
1687,69,2,771,3,4381,112,30
1688,69,2,772,3,4384,82,30
1689,69,2,773,2,4386,46,20
1690,69,2,774,8,4394,76,80
1691,69,2,775,2,4396,32,20
1692,69,2,776,2,4398,30,20
1693,69,2,777,6,4404,48,60
1694,69,2,778,8,4412,57,80
1695,69,2,779,4,4416,1,40
1696,69,2,780,8,4424,109,80
1697,69,2,781,6,4430,86,60
1698,69,2,782,6,4436,76,60
1699,69,2,783,4,4440,1,40
1700,69,2,784,9,4449,95,90
1701,69,2,785,2,4451,55,20
1702,69,2,786,3,4454,46,30
1703,69,2,787,2,4456,24,20
1704,69,2,788,7,4463,53,70
1705,69,2,789,7,4470,1,70
1706,69,2,790,4,4474,88,40
1707,69,2,791,5,4479,55,50
1708,69,2,792,4,4483,1,40
1709,69,2,793,6,4489,88,60
1710,69,2,794,6,4495,79,60
1711,69,2,795,2,4497,35,20
1712,69,2,796,3,4500,1,30
1713,69,2,797,4,4504,1,40
1714,69,2,798,8,4512,113,80
1715,69,2,799,2,4514,50,20
1716,69,2,800,4,4518,1,40
1717,69,2,801,6,4524,89,60
1718,69,2,802,8,4532,90,80
1719,69,2,803,3,4535,49,30
1720,69,2,804,5,4540,1,50
1721,69,2,805,3,4543,69,30
1722,69,2,806,4,4547,40,40
1723,69,2,807,9,4556,1,90
1724,69,2,808,3,4559,97,30
1725,69,2,809,5,4564,65,50
1726,69,2,810,7,4571,77,70
1727,69,2,811,3,4574,1,30
1728,69,2,812,7,4581,81,70
1729,69,2,813,6,4587,76,60
1730,69,2,814,4,4591,45,40
1731,69,2,815,2,4593,25,20
1732,69,2,816,8,4601,49,80
1733,69,2,817,4,4605,45,40
1734,69,2,818,6,4611,59,60
1735,69,2,819,5,4616,61,50
1736,69,2,820,2,4618,42,20
1737,69,2,821,5,4623,45,50
1738,69,2,822,5,4628,44,50
1739,69,2,823,4,4632,34,40
1740,69,2,824,9,4641,58,90
1741,69,2,825,5,4646,53,50
1742,69,2,826,7,4653,65,70
1743,69,2,827,9,4662,1,90
1744,69,2,828,9,4671,135,90
1745,69,2,829,4,4675,1,40
1746,69,2,830,6,4681,115,60
1747,69,2,831,3,4684,54,30
1748,69,2,832,6,4690,65,60
1749,69,2,833,4,4694,1,40
1750,69,2,834,5,4699,68,50
1751,69,2,835,3,4702,53,30
1752,69,2,836,2,4704,37,20
1753,69,2,837,2,4706,28,20
1754,69,2,838,9,4715,64,90
1755,69,2,839,4,4719,55,40
1756,69,2,840,7,4726,60,70
1757,69,2,841,4,4730,47,40
1758,69,2,842,4,4734,47,40
1759,69,2,843,3,4737,43,30
1760,69,2,844,2,4739,26,20
1761,69,2,845,4,4743,24,40
1762,69,2,846,3,4746,1,30
1763,69,2,847,6,4752,69,60
1764,69,2,848,9,4761,83,90
1765,69,2,849,2,4763,1,20
1766,69,2,850,4,4767,63,40
1767,69,2,851,4,4771,44,40
1768,69,2,852,2,4773,27,20
1769,69,2,853,8,4781,62,80
1770,69,2,854,8,4789,1,80
1771,69,2,855,3,4792,1,30
1772,69,2,856,2,4794,105,20
1773,69,2,857,4,4798,75,40
1774,69,2,858,8,4806,80,80
1775,69,2,859,7,4813,65,70
1776,69,2,860,8,4821,61,80
1777,69,2,861,8,4829,81,80
1778,69,2,862,9,4838,74,90
1779,69,2,863,7,4845,71,70
1780,69,2,864,2,4847,46,20
1781,69,2,865,3,4850,41,30
1782,69,2,866,6,4856,49,60
1783,69,2,867,4,4860,43,40
1784,69,2,868,8,4868,1,80
1785,69,2,869,9,4877,1,90
1786,69,2,870,8,4885,139,80
1787,69,2,871,3,4888,71,30
1788,69,2,872,8,4896,71,80
1789,69,2,873,6,4902,68,60
1790,69,2,874,5,4907,51,50
1791,69,2,875,2,4909,42,20
1792,69,2,876,8,4917,75,80
1793,69,2,877,7,4924,79,70
1794,69,2,878,2,4926,32,20
1795,69,2,879,2,4928,26,20
1796,69,2,880,8,4936,1,80
1797,69,2,881,5,4941,104,50
1798,69,2,882,6,4947,61,60
1799,69,2,883,5,4952,79,50
1800,69,2,884,4,4956,41,40
1801,69,2,885,8,4964,56,80
1802,69,2,886,2,4966,36,20
1803,69,2,887,5,4971,1,50
1804,69,2,888,5,4976,1,50
1805,69,2,889,6,4982,1,60
1806,69,2,890,8,4990,163,80
1807,69,2,891,9,4999,101,90
1808,69,3,1,6,6,39,60
1809,69,3,2,9,15,76,90
1810,69,3,3,9,24,62,90
1811,69,3,4,8,32,79,80
1812,69,3,5,4,36,51,40
1813,69,3,6,8,44,62,80
1814,69,3,7,3,47,60,30
1815,69,3,8,6,53,1,60
1816,69,3,9,9,62,106,90
1817,69,3,10,2,64,47,20
1818,69,3,11,6,70,75,60
1819,69,3,12,7,77,71,70
1820,69,3,13,3,80,48,30
1821,69,3,14,6,86,74,60
1822,69,3,15,2,88,31,20
1823,69,3,16,5,93,1,50
1824,69,3,17,2,95,50,20
1825,69,3,18,9,104,77,90
1826,69,3,19,9,113,1,90
1827,69,3,20,5,118,102,50
1828,69,3,21,5,123,73,50
1829,69,3,22,7,130,71,70
1830,69,3,23,5,135,53,50
1831,69,3,24,2,137,1,20
1832,69,3,25,5,142,76,50
1833,69,3,26,6,148,59,60
1834,69,3,27,4,152,59,40
1835,69,3,28,4,156,53,40
1836,69,3,29,6,162,1,60
1837,69,3,30,3,165,67,30
1838,69,3,31,8,173,72,80
1839,69,3,32,7,180,1,70
1840,69,3,33,4,184,90,40
1841,69,3,34,7,191,83,70
1842,69,3,35,2,193,1,20
1843,69,3,36,7,200,74,70
1844,69,3,37,9,209,82,90
1845,69,3,38,5,214,57,50
1846,69,3,39,7,221,69,70
1847,69,3,40,5,226,58,50
1848,69,3,41,4,230,44,40
1849,69,3,42,4,234,54,40
1850,69,3,43,3,237,1,30
1851,69,3,44,5,242,70,50
1852,69,3,45,7,249,68,70
1853,69,3,46,4,253,63,40
1854,69,3,47,8,261,78,80
1855,69,3,48,6,267,77,60
1856,69,3,49,4,271,57,40
1857,69,3,50,7,278,79,70
1858,69,3,51,5,283,38,50
1859,69,3,52,6,289,52,60
1860,69,3,53,6,295,1,60
1861,69,3,54,6,301,101,60
1862,69,3,55,5,306,61,50
1863,69,3,56,6,312,1,60
1864,69,3,57,3,315,1,30
1865,69,3,58,3,318,94,30
1866,69,3,59,4,322,61,40
1867,69,3,60,5,327,50,50
1868,69,3,61,7,334,1,70
1869,69,3,62,8,342,96,80
1870,69,3,63,5,347,69,50
1871,69,3,64,6,353,62,60
1872,69,3,65,8,361,74,80
1873,69,3,66,5,366,1,50
1874,69,3,67,9,375,106,90
1875,69,3,68,6,381,83,60
1876,69,3,69,5,386,53,50
1877,69,3,70,3,389,60,30
1878,69,3,71,8,397,59,80
1879,69,3,72,8,405,53,80
1880,69,3,73,2,407,1,20
1881,69,3,74,5,412,71,50
1882,69,3,75,4,416,54,40
1883,69,3,76,8,424,68,80
1884,69,3,77,9,433,93,90
1885,69,3,78,9,442,77,90
1886,69,3,79,6,448,81,60
1887,69,3,80,4,452,57,40
1888,69,3,81,9,461,74,90
1889,69,3,82,9,470,82,90
1890,69,3,83,2,472,43,20
1891,69,3,84,9,481,76,90
1892,69,3,85,6,487,52,60
1893,69,3,86,7,494,53,70
1894,69,3,87,3,497,1,30
1895,69,3,88,6,503,77,60
1896,69,3,89,7,510,71,70
1897,69,3,90,7,517,75,70
1898,69,3,91,2,519,40,20
1899,69,3,92,8,527,1,80
1900,69,3,93,3,530,1,30
1901,69,3,94,6,536,116,60
1902,69,3,95,2,538,1,20
1903,69,3,96,6,544,1,60
1904,69,3,97,8,552,150,80
1905,69,3,98,2,554,1,20
1906,69,3,99,3,557,97,30
1907,69,3,100,8,565,86,80
1908,69,3,101,4,569,42,40
1909,69,3,102,4,573,41,40
1910,69,3,103,2,575,25,20
1911,69,3,104,8,583,76,80
1912,69,3,105,7,590,68,70
1913,69,3,106,2,592,35,20
1914,69,3,107,7,599,1,70
1915,69,3,108,8,607,111,80
1916,69,3,109,9,616,117,90
1917,69,3,110,4,620,1,40
1918,69,3,111,2,622,1,20
1919,69,3,112,4,626,118,40
1920,69,3,113,3,629,65,30
1921,69,3,114,4,633,41,40
1922,69,3,115,8,641,58,80
1923,69,3,116,9,650,86,90
1924,69,3,117,2,652,1,20
1925,69,3,118,8,660,1,80
1926,69,3,119,4,664,90,40
1927,69,3,120,3,667,67,30
1928,69,3,121,5,672,53,50
1929,69,3,122,6,678,64,60
1930,69,3,123,2,680,1,20
1931,69,3,124,7,687,1,70
1932,69,3,125,9,696,123,90
1933,69,3,126,3,699,69,30
1934,69,3,127,4,703,57,40
1935,69,3,128,9,712,72,90
1936,69,3,129,4,716,56,40
1937,69,3,130,3,719,35,30
1938,69,3,131,2,721,29,20
1939,69,3,132,4,725,43,40
1940,69,3,133,2,727,29,20
1941,69,3,134,9,736,72,90
1942,69,3,135,5,741,69,50
1943,69,3,136,3,744,40,30
1944,69,3,137,5,749,45,50
1945,69,3,138,3,752,34,30
1946,69,3,139,5,757,46,50
1947,69,3,140,9,766,85,90
1948,69,3,141,2,768,25,20
1949,69,3,142,4,772,43,40
1950,69,3,143,5,777,47,50
1951,69,3,144,7,784,56,70
1952,69,3,145,3,787,40,30
1953,69,3,146,5,792,37,50
1954,69,3,147,9,801,1,90
1955,69,3,148,5,806,86,50
1956,69,3,149,8,814,95,80
1957,69,3,150,6,820,1,60
1958,69,3,151,3,823,1,30
1959,69,3,152,7,830,130,70
1960,69,3,153,6,836,78,60
1961,69,3,154,9,845,102,90
1962,69,3,155,8,853,81,80
1963,69,3,156,5,858,60,50
1964,69,3,157,4,862,1,40
1965,69,3,158,8,870,118,80
1966,69,3,159,7,877,1,70
1967,69,3,160,3,880,105,30
1968,69,3,161,4,884,1,40
1969,69,3,162,7,891,86,70
1970,69,3,163,4,895,62,40
1971,69,3,164,7,902,69,70
1972,69,3,165,7,909,72,70
1973,69,3,166,9,918,1,90
1974,69,3,167,3,921,96,30
1975,69,3,168,6,927,72,60
1976,69,3,169,4,931,61,40
1977,69,3,170,4,935,42,40
1978,69,3,171,4,939,39,40
1979,69,3,172,5,944,54,50
1980,69,3,173,6,950,54,60
1981,69,3,174,6,956,49,60
1982,69,3,175,6,962,1,60
1983,69,3,176,7,969,112,70
1984,69,3,177,7,976,76,70
1985,69,3,178,4,980,55,40
1986,69,3,179,4,984,49,40
1987,69,3,180,7,991,1,70
1988,69,3,181,7,998,102,70
1989,69,3,182,7,1005,70,70
1990,69,3,183,5,1010,79,50
1991,69,3,184,4,1014,45,40
1992,69,3,185,6,1020,55,60
1993,69,3,186,4,1024,43,40
1994,69,3,187,6,1030,55,60
1995,69,3,188,9,1039,68,90
1996,69,3,189,6,1045,56,60
1997,69,3,190,5,1050,49,50
1998,69,3,191,9,1059,69,90
1999,69,3,192,8,1067,74,80
2000,69,3,193,7,1074,70,70
2001,69,3,194,7,1081,101,70
2002,69,3,195,5,1086,50,50
2003,69,3,196,5,1091,1,50
2004,69,3,197,9,1100,100,90
2005,69,3,198,3,1103,62,30
2006,69,3,199,6,1109,62,60
2007,69,3,200,4,1113,48,40
2008,69,3,201,9,1122,72,90
2009,69,3,202,7,1129,81,70
2010,69,3,203,2,1131,1,20
2011,69,3,204,5,1136,74,50
2012,69,3,205,9,1145,1,90
2013,69,3,206,4,1149,105,40
2014,69,3,207,8,1157,93,80
2015,69,3,208,5,1162,54,50
2016,69,3,209,5,1167,56,50
2017,69,3,210,8,1175,70,80
2018,69,3,211,8,1183,80,80
2019,69,3,212,5,1188,1,50
2020,69,3,213,2,1190,1,20
2021,69,3,214,8,1198,104,80
2022,69,3,215,6,1204,76,60
2023,69,3,216,6,1210,62,60
2024,69,3,217,4,1214,61,40
2025,69,3,218,2,1216,42,20
2026,69,3,219,5,1221,43,50
2027,69,3,220,6,1227,51,60
2028,69,3,221,3,1230,36,30
2029,69,3,222,3,1233,1,30
2030,69,3,223,2,1235,46,20
2031,69,3,224,6,1241,65,60
2032,69,3,225,9,1250,79,90
2033,69,3,226,4,1254,63,40
2034,69,3,227,6,1260,64,60
2035,69,3,228,9,1269,74,90
2036,69,3,229,8,1277,60,80
2037,69,3,230,7,1284,79,70
2038,69,3,231,2,1286,1,20
2039,69,3,232,8,1294,97,80
2040,69,3,233,4,1298,58,40
2041,69,3,234,3,1301,44,30
2042,69,3,235,5,1306,42,50
2043,69,3,236,4,1310,39,40
2044,69,3,237,5,1315,1,50
2045,69,3,238,7,1322,101,70
2046,69,3,239,8,1330,78,80
2047,69,3,240,4,1334,1,40
2048,69,3,241,3,1337,59,30
2049,69,3,242,5,1342,65,50
2050,69,3,243,5,1347,55,50
2051,69,3,244,5,1352,68,50
2052,69,3,245,3,1355,1,30
2053,69,3,246,8,1363,80,80
2054,69,3,247,9,1372,81,90
2055,69,3,248,2,1374,26,20
2056,69,3,249,8,1382,1,80
2057,69,3,250,2,1384,86,20
2058,69,3,251,9,1393,83,90
2059,69,3,252,8,1401,1,80
2060,69,3,253,3,1404,104,30
2061,69,3,254,5,1409,79,50
2062,69,3,255,7,1416,1,70
2063,69,3,256,5,1421,105,50
2064,69,3,257,2,1423,57,20
2065,69,3,258,2,1425,25,20
2066,69,3,259,5,1430,44,50
2067,69,3,260,9,1439,71,90
2068,69,3,261,9,1448,76,90
2069,69,3,262,3,1451,1,30
2070,69,3,263,7,1458,73,70
2071,69,3,264,9,1467,84,90
2072,69,3,265,7,1474,96,70
2073,69,3,266,4,1478,56,40
2074,69,3,267,2,1480,1,20
2075,69,3,268,6,1486,72,60
2076,69,3,269,4,1490,55,40
2077,69,3,270,8,1498,1,80
2078,69,3,271,7,1505,1,70
2079,69,3,272,7,1512,149,70
2080,69,3,273,5,1517,87,50
2081,69,3,274,8,1525,84,80
2082,69,3,275,2,1527,45,20
2083,69,3,276,9,1536,73,90
2084,69,3,277,4,1540,48,40
2085,69,3,278,7,1547,60,70
2086,69,3,279,2,1549,1,20
2087,69,3,280,9,1558,80,90
2088,69,3,281,5,1563,71,50
2089,69,3,282,5,1568,53,50
2090,69,3,283,7,1575,73,70
2091,69,3,284,7,1582,65,70
2092,69,3,285,9,1591,87,90
2093,69,3,286,6,1597,62,60
2094,69,3,287,5,1602,1,50
2095,69,3,288,6,1608,92,60
2096,69,3,289,8,1616,1,80
2097,69,3,290,5,1621,134,50
2098,69,3,291,9,1630,95,90
2099,69,3,292,6,1636,79,60
2100,69,3,293,6,1642,77,60
2101,69,3,294,8,1650,70,80
2102,69,3,295,6,1656,61,60
2103,69,3,296,8,1664,58,80
2104,69,3,297,7,1671,1,70
2105,69,3,298,9,1680,1,90
2106,69,3,299,5,1685,1,50
2107,69,3,300,8,1693,242,80
2108,69,3,301,2,1695,1,20
2109,69,3,302,7,1702,1,70
2110,69,3,303,7,1709,163,70
2111,69,3,304,3,1712,78,30
2112,69,3,305,5,1717,1,50
2113,69,3,306,6,1723,87,60
2114,69,3,307,9,1732,1,90
2115,69,3,308,9,1741,136,90
2116,69,3,309,3,1744,77,30
2117,69,3,310,7,1751,73,70
2118,69,3,311,2,1753,1,20
2119,69,3,312,6,1759,67,60
2120,69,3,313,3,1762,49,30
2121,69,3,314,7,1769,1,70
2122,69,3,315,7,1776,98,70
2123,69,3,316,7,1783,85,70
2124,69,3,317,3,1786,53,30
2125,69,3,318,8,1794,75,80
2126,69,3,319,8,1802,1,80
2127,69,3,320,8,1810,123,80
2128,69,3,321,9,1819,111,90
2129,69,3,322,7,1826,62,70
2130,69,3,323,9,1835,81,90
2131,69,3,324,2,1837,64,20
2132,69,3,325,2,1839,1,20
2133,69,3,326,6,1845,66,60
2134,69,3,327,6,1851,1,60
2135,69,3,328,5,1856,91,50
2136,69,3,329,2,1858,1,20
2137,69,3,330,5,1863,82,50
2138,69,3,331,7,1870,65,70
2139,69,3,332,2,1872,45,20
2140,69,3,333,8,1880,62,80
2141,69,3,334,9,1889,83,90
2142,69,3,335,7,1896,63,70
2143,69,3,336,5,1901,77,50
2144,69,3,337,4,1905,56,40
2145,69,3,338,4,1909,38,40
2146,69,3,339,7,1916,50,70
2147,69,3,340,9,1925,65,90
2148,69,3,341,6,1931,1,60
2149,69,3,342,3,1934,101,30
2150,69,3,343,7,1941,84,70
2151,69,3,344,3,1944,37,30
2152,69,3,345,6,1950,64,60
2153,69,3,346,8,1958,1,80
2154,69,3,347,3,1961,89,30
2155,69,3,348,6,1967,70,60
2156,69,3,349,9,1976,71,90
2157,69,3,350,9,1985,80,90
2158,69,3,351,7,1992,74,70
2159,69,3,352,5,1997,66,50
2160,69,3,353,9,2006,95,90
2161,69,3,354,6,2012,76,60
2162,69,3,355,9,2021,82,90
2163,69,3,356,6,2027,1,60
2164,69,3,357,2,2029,72,20
2165,69,3,358,2,2031,43,20
2166,69,3,359,3,2034,35,30
2167,69,3,360,7,2041,59,70
2168,69,3,361,6,2047,49,60
2169,69,3,362,2,2049,40,20
2170,69,3,363,7,2056,63,70
2171,69,3,364,3,2059,1,30
2172,69,3,365,9,2068,82,90
2173,69,3,366,6,2074,75,60
2174,69,3,367,3,2077,1,30
2175,69,3,368,2,2079,50,20
2176,69,3,369,9,2088,75,90
2177,69,3,370,4,2092,59,40
2178,69,3,371,5,2097,55,50
2179,69,3,372,7,2104,1,70
2180,69,3,373,7,2111,107,70
2181,69,3,374,6,2117,75,60
2182,69,3,375,3,2120,1,30
2183,69,3,376,7,2127,87,70
2184,69,3,377,3,2130,64,30
2185,69,3,378,4,2134,42,40
2186,69,3,379,6,2140,57,60
2187,69,3,380,5,2145,46,50
2188,69,3,381,9,2154,79,90
2189,69,3,382,3,2157,45,30
2190,69,3,383,9,2166,1,90
2191,69,3,384,5,2171,110,50
2192,69,3,385,8,2179,89,80
2193,69,3,386,3,2182,47,30
2194,69,3,387,4,2186,39,40
2195,69,3,388,8,2194,76,80
2196,69,3,389,9,2203,92,90
2197,69,3,390,9,2212,75,90
2198,69,3,391,7,2219,78,70
2199,69,3,392,7,2226,70,70
2200,69,3,393,6,2232,62,60
2201,69,3,394,8,2240,73,80
2202,69,3,395,7,2247,72,70
2203,69,3,396,8,2255,89,80
2204,69,3,397,4,2259,1,40
2205,69,3,398,2,2261,54,20
2206,69,3,399,2,2263,1,20
2207,69,3,400,5,2268,60,50
2208,69,3,401,7,2275,70,70
2209,69,3,402,2,2277,50,20
2210,69,3,403,3,2280,32,30
2211,69,3,404,9,2289,67,90
2212,69,3,405,2,2291,26,20
2213,69,3,406,2,2293,1,20
2214,69,3,407,2,2295,38,20
2215,69,3,408,6,2301,1,60
2216,69,3,409,3,2304,1,30
2217,69,3,410,3,2307,79,30
2218,69,3,411,5,2312,1,50
2219,69,3,412,7,2319,109,70
2220,69,3,413,5,2324,71,50
2221,69,3,414,7,2331,66,70
2222,69,3,415,5,2336,1,50
2223,69,3,416,9,2345,107,90
2224,69,3,417,9,2354,103,90
2225,69,3,418,6,2360,79,60
2226,69,3,419,4,2364,58,40
2227,69,3,420,4,2368,57,40
2228,69,3,421,3,2371,31,30
2229,69,3,422,2,2373,32,20
2230,69,3,423,7,2380,47,70
2231,69,3,424,9,2389,77,90
2232,69,3,425,7,2396,1,70
2233,69,3,426,7,2403,106,70
2234,69,3,427,7,2410,89,70
2235,69,3,428,8,2418,93,80
2236,69,3,429,6,2424,67,60
2237,69,3,430,8,2432,81,80
2238,69,3,431,3,2435,1,30
2239,69,3,432,5,2440,59,50
2240,69,3,433,5,2445,64,50
2241,69,3,434,4,2449,51,40
2242,69,3,435,3,2452,44,30
2243,69,3,436,3,2455,1,30
2244,69,3,437,9,2464,84,90
2245,69,3,438,5,2469,67,50
2246,69,3,439,4,2473,45,40
2247,69,3,440,2,2475,33,20
2248,69,3,441,4,2479,33,40
2249,69,3,442,8,2487,69,80
2250,69,3,443,5,2492,42,50
2251,69,3,444,8,2500,58,80
2252,69,3,445,6,2506,74,60
2253,69,3,446,7,2513,80,70
2254,69,3,447,9,2522,71,90
2255,69,3,448,6,2528,76,60
2256,69,3,449,9,2537,90,90
2257,69,3,450,3,2540,52,30
2258,69,3,451,6,2546,1,60
2259,69,3,452,2,2548,1,20
2260,69,3,453,6,2554,1,60
2261,69,3,454,8,2562,162,80
2262,69,3,455,2,2564,79,20
2263,69,3,456,6,2570,67,60
2264,69,3,457,7,2577,1,70
2265,69,3,458,9,2586,107,90
2266,69,3,459,8,2594,92,80
2267,69,3,460,7,2601,61,70
2268,69,3,461,9,2610,72,90
2269,69,3,462,5,2615,68,50
2270,69,3,463,5,2620,63,50
2271,69,3,464,5,2625,1,50
2272,69,3,465,7,2632,105,70
2273,69,3,466,9,2641,108,90
2274,69,3,467,9,2650,96,90
2275,69,3,468,6,2656,75,60
2276,69,3,469,5,2661,58,50
2277,69,3,470,7,2668,64,70
2278,69,3,471,4,2672,56,40
2279,69,3,472,4,2676,38,40
2280,69,3,473,7,2683,1,70
2281,69,3,474,8,2691,127,80
2282,69,3,475,7,2698,84,70
2283,69,3,476,6,2704,72,60
2284,69,3,477,3,2707,46,30
2285,69,3,478,2,2709,36,20
2286,69,3,479,2,2711,25,20
2287,69,3,480,5,2716,42,50
2288,69,3,481,6,2722,46,60
2289,69,3,482,9,2731,57,90
2290,69,3,483,6,2737,61,60
2291,69,3,484,6,2743,52,60
2292,69,3,485,6,2749,1,60
2293,69,3,486,7,2756,104,70
2294,69,3,487,2,2758,42,20
2295,69,3,488,4,2762,40,40
2296,69,3,489,5,2767,55,50
2297,69,3,490,8,2775,73,80
2298,69,3,491,2,2777,33,20
2299,69,3,492,2,2779,15,20
2300,69,3,493,5,2784,1,50
2301,69,3,494,2,2786,46,20
2302,69,3,495,5,2791,1,50
2303,69,3,496,5,2796,88,50
2304,69,3,497,3,2799,53,30
2305,69,3,498,7,2806,57,70
2306,69,3,499,3,2809,44,30
2307,69,3,500,8,2817,60,80
2308,69,3,501,9,2826,75,90
2309,69,3,502,6,2832,54,60
2310,69,3,503,8,2840,77,80
2311,69,3,504,3,2843,1,30
2312,69,3,505,5,2848,80,50
2313,69,3,506,4,2852,56,40
2314,69,3,507,5,2857,1,50
2315,69,3,508,2,2859,63,20
2316,69,3,509,4,2863,51,40
2317,69,3,510,6,2869,62,60
2318,69,3,511,4,2873,1,40
2319,69,3,512,5,2878,79,50
2320,69,3,513,5,2883,55,50
2321,69,3,514,6,2889,1,60
2322,69,3,515,7,2896,105,70
2323,69,3,516,6,2902,73,60
2324,69,3,517,7,2909,81,70
2325,69,3,518,6,2915,60,60
2326,69,3,519,9,2924,68,90
2327,69,3,520,3,2927,50,30
2328,69,3,521,3,2930,37,30
2329,69,3,522,2,2932,26,20
2330,69,3,523,9,2941,59,90
2331,69,3,524,3,2944,47,30
2332,69,3,525,3,2947,46,30
2333,69,3,526,8,2955,50,80
2334,69,3,527,6,2961,65,60
2335,69,3,528,4,2965,43,40
2336,69,3,529,6,2971,51,60
2337,69,3,530,2,2973,37,20
2338,69,3,531,3,2976,31,30
2339,69,3,532,7,2983,55,70
2340,69,3,533,7,2990,58,70
2341,69,3,534,9,2999,77,90
2342,69,3,535,6,3005,1,60
2343,69,3,536,2,3007,70,20
2344,69,3,537,3,3010,46,30
2345,69,3,538,6,3016,60,60
2346,69,3,539,5,3021,1,50
2347,69,3,540,5,3026,78,50
2348,69,3,541,6,3032,74,60
2349,69,3,542,2,3034,30,20
2350,69,3,543,2,3036,27,20
2351,69,3,544,6,3042,39,60
2352,69,3,545,9,3051,1,90
2353,69,3,546,2,3053,90,20
2354,69,3,547,8,3061,82,80
2355,69,3,548,8,3069,73,80
2356,69,3,549,6,3075,63,60
2357,69,3,550,7,3082,76,70
2358,69,3,551,6,3088,1,60
2359,69,3,552,5,3093,92,50
2360,69,3,553,7,3100,1,70
2361,69,3,554,7,3107,130,70
2362,69,3,555,7,3114,1,70
2363,69,3,556,6,3120,114,60
2364,69,3,557,2,3122,1,20
2365,69,3,558,4,3126,77,40
2366,69,3,559,3,3129,1,30
2367,69,3,560,9,3138,111,90
2368,69,3,561,2,3140,1,20
2369,69,3,562,6,3146,94,60
2370,69,3,563,6,3152,87,60
2371,69,3,564,4,3156,63,40
2372,69,3,565,3,3159,33,30
2373,69,3,566,8,3167,74,80
2374,69,3,567,5,3172,60,50
2375,69,3,568,8,3180,62,80
2376,69,3,569,2,3182,1,20
2377,69,3,570,4,3186,60,40
2378,69,3,571,5,3191,70,50
2379,69,3,572,4,3195,50,40
2380,69,3,573,8,3203,1,80
2381,69,3,574,9,3212,1,90
2382,69,3,575,5,3217,142,50
2383,69,3,576,5,3222,86,50
2384,69,3,577,8,3230,87,80
2385,69,3,578,2,3232,46,20
2386,69,3,579,3,3235,41,30
2387,69,3,580,3,3238,36,30
2388,69,3,581,2,3240,1,20
2389,69,3,582,6,3246,1,60
2390,69,3,583,2,3248,80,20
2391,69,3,584,4,3252,63,40
2392,69,3,585,2,3254,30,20
2393,69,3,586,3,3257,38,30
2394,69,3,587,8,3265,59,80
2395,69,3,588,9,3274,60,90
2396,69,3,589,7,3281,69,70
2397,69,3,590,8,3289,71,80
2398,69,3,591,5,3294,1,50
2399,69,3,592,4,3298,86,40
2400,69,3,593,9,3307,80,90
2401,69,3,594,8,3315,81,80
2402,69,3,595,6,3321,1,60
2403,69,3,596,5,3326,106,50
2404,69,3,597,8,3334,1,80
2405,69,3,598,8,3342,1,80
2406,69,3,599,7,3349,193,70
2407,69,3,600,7,3356,95,70
2408,69,3,601,4,3360,74,40
2409,69,3,602,4,3364,42,40
2410,69,3,603,3,3367,28,30
2411,69,3,604,9,3376,90,90
2412,69,3,605,3,3379,51,30
2413,69,3,606,2,3381,39,20
2414,69,3,607,7,3388,41,70
2415,69,3,608,5,3393,56,50
2416,69,3,609,6,3399,55,60
2417,69,3,610,2,3401,34,20
2418,69,3,611,9,3410,75,90
2419,69,3,612,3,3413,45,30
2420,69,3,613,5,3418,46,50
2421,69,3,614,2,3420,40,20
2422,69,3,615,2,3422,27,20
2423,69,3,616,9,3431,65,90
2424,69,3,617,7,3438,85,70
2425,69,3,618,6,3444,54,60
2426,69,3,619,8,3452,76,80
2427,69,3,620,9,3461,81,90
2428,69,3,621,4,3465,62,40
2429,69,3,622,2,3467,33,20
2430,69,3,623,4,3471,1,40
2431,69,3,624,7,3478,1,70
2432,69,3,625,9,3487,133,90
2433,69,3,626,3,3490,62,30
2434,69,3,627,6,3496,71,60
2435,69,3,628,5,3501,66,50
2436,69,3,629,6,3507,62,60
2437,69,3,630,8,3515,72,80
2438,69,3,631,6,3521,74,60
2439,69,3,632,2,3523,1,20
2440,69,3,633,8,3531,74,80
2441,69,3,634,9,3540,91,90
2442,69,3,635,8,3548,81,80
2443,69,3,636,4,3552,1,40
2444,69,3,637,7,3559,115,70
2445,69,3,638,6,3565,77,60
2446,69,3,639,7,3572,67,70
2447,69,3,640,4,3576,58,40
2448,69,3,641,2,3578,33,20
2449,69,3,642,5,3583,50,50
2450,69,3,643,6,3589,62,60
2451,69,3,644,3,3592,39,30
2452,69,3,645,8,3600,60,80
2453,69,3,646,4,3604,52,40
2454,69,3,647,7,3611,60,70
2455,69,3,648,9,3620,76,90
2456,69,3,649,5,3625,61,50
2457,69,3,650,7,3632,80,70
2458,69,3,651,5,3637,62,50
2459,69,3,652,7,3644,78,70
2460,69,3,653,5,3649,62,50
2461,69,3,654,9,3658,74,90
2462,69,3,655,3,3661,1,30
2463,69,3,656,4,3665,67,40
2464,69,3,657,2,3667,34,20
2465,69,3,658,7,3674,56,70
2466,69,3,659,3,3677,45,30
2467,69,3,660,4,3681,32,40
2468,69,3,661,3,3684,21,30
2469,69,3,662,5,3689,1,50
2470,69,3,663,9,3698,106,90
2471,69,3,664,8,3706,88,80
2472,69,3,665,4,3710,49,40
2473,69,3,666,6,3716,62,60
2474,69,3,667,7,3723,79,70
2475,69,3,668,8,3731,62,80
2476,69,3,669,6,3737,1,60
2477,69,3,670,5,3742,1,50
2478,69,3,671,3,3745,89,30
2479,69,3,672,7,3752,77,70
2480,69,3,673,2,3754,46,20
2481,69,3,674,7,3761,69,70
2482,69,3,675,4,3765,41,40
2483,69,3,676,5,3770,42,50
2484,69,3,677,6,3776,54,60
2485,69,3,678,4,3780,61,40
2486,69,3,679,5,3785,41,50
2487,69,3,680,6,3791,45,60
2488,69,3,681,2,3793,28,20
2489,69,3,682,8,3801,1,80
2490,69,3,683,6,3807,1,60
2491,69,3,684,5,3812,149,50
2492,69,3,685,4,3816,1,40
2493,69,3,686,6,3822,106,60
2494,69,3,687,7,3829,93,70
2495,69,3,688,7,3836,1,70
2496,69,3,689,8,3844,136,80
2497,69,3,690,3,3847,1,30
2498,69,3,691,9,3856,137,90
2499,69,3,692,7,3863,110,70
2500,69,3,693,8,3871,75,80
2501,69,3,694,3,3874,53,30
2502,69,3,695,6,3880,51,60
2503,69,3,696,3,3883,41,30
2504,69,3,697,2,3885,42,20
2505,69,3,698,2,3887,28,20
2506,69,3,699,4,3891,1,40
2507,69,3,700,2,3893,63,20
2508,69,3,701,2,3895,41,20
2509,69,3,702,7,3902,48,70
2510,69,3,703,7,3909,1,70
2511,69,3,704,5,3914,88,50
2512,69,3,705,2,3916,45,20
2513,69,3,706,2,3918,30,20
2514,69,3,707,8,3926,54,80
2515,69,3,708,8,3934,65,80
2516,69,3,709,5,3939,66,50
2517,69,3,710,5,3944,49,50
2518,69,3,711,7,3951,72,70
2519,69,3,712,5,3956,41,50
2520,69,3,713,2,3958,35,20
2521,69,3,714,8,3966,59,80
2522,69,3,715,4,3970,50,40
2523,69,3,716,7,3977,52,70
2524,69,3,717,2,3979,39,20
2525,69,3,718,5,3984,53,50
2526,69,3,719,9,3993,61,90
2527,69,3,720,4,3997,70,40
2528,69,3,721,8,4005,55,80
2529,69,3,722,6,4011,64,60
2530,69,3,723,2,4013,1,20
2531,69,3,724,9,4022,77,90
2532,69,3,725,2,4024,49,20
2533,69,3,726,3,4027,1,30
2534,69,3,727,7,4034,1,70
2535,69,3,728,7,4041,127,70
2536,69,3,729,5,4046,88,50
2537,69,3,730,2,4048,34,20
2538,69,3,731,6,4054,68,60
2539,69,3,732,7,4061,65,70
2540,69,3,733,5,4066,45,50
2541,69,3,734,4,4070,45,40
2542,69,3,735,7,4077,51,70
2543,69,3,736,4,4081,1,40
2544,69,3,737,7,4088,90,70
2545,69,3,738,3,4091,55,30
2546,69,3,739,8,4099,1,80
2547,69,3,740,9,4108,121,90
2548,69,3,741,9,4117,91,90
2549,69,3,742,3,4120,1,30
2550,69,3,743,8,4128,114,80
2551,69,3,744,2,4130,60,20
2552,69,3,745,8,4138,61,80
2553,69,3,746,9,4147,71,90
2554,69,3,747,5,4152,71,50
2555,69,3,748,2,4154,44,20
2556,69,3,749,2,4156,1,20
2557,69,3,750,7,4163,1,70
2558,69,3,751,7,4170,101,70
2559,69,3,752,7,4177,1,70
2560,69,3,753,3,4180,104,30
2561,69,3,754,5,4185,1,50
2562,69,3,755,5,4190,93,50
2563,69,3,756,9,4199,89,90
2564,69,3,757,5,4204,59,50
2565,69,3,758,4,4208,53,40
2566,69,3,759,5,4213,39,50
2567,69,3,760,2,4215,40,20
2568,69,3,761,3,4218,39,30
2569,69,3,762,5,4223,51,50
2570,69,3,763,7,4230,1,70
2571,69,3,764,7,4237,97,70
2572,69,3,765,3,4240,1,30
2573,69,3,766,2,4242,66,20
2574,69,3,767,3,4245,41,30
2575,69,3,768,6,4251,58,60
2576,69,3,769,9,4260,68,90
2577,69,3,770,4,4264,52,40
2578,69,3,771,6,4270,1,60
2579,69,3,772,3,4273,82,30
2580,69,3,773,3,4276,52,30
2581,69,3,774,9,4285,76,90
2582,69,3,775,3,4288,1,30
2583,69,3,776,9,4297,99,90
2584,69,3,777,6,4303,61,60
2585,69,3,778,2,4305,27,20
2586,69,3,779,6,4311,47,60
2587,69,3,780,4,4315,1,40
2588,69,3,781,8,4323,86,80
2589,69,3,782,5,4328,1,50
2590,69,3,783,9,4337,121,90
2591,69,3,784,7,4344,82,70
2592,69,3,785,8,4352,1,80
2593,69,3,786,8,4360,128,80
2594,69,3,787,9,4369,95,90
2595,69,3,788,9,4378,114,90
2596,69,3,789,7,4385,87,70
2597,69,3,790,8,4393,75,80
2598,69,3,791,7,4400,94,70
2599,69,3,792,2,4402,52,20
2600,69,3,793,5,4407,53,50
2601,69,3,794,2,4409,26,20
2602,69,3,795,7,4416,50,70
2603,69,3,796,9,4425,68,90
2604,69,3,797,7,4432,73,70
2605,69,3,798,4,4436,53,40
2606,69,3,799,3,4439,37,30
2607,69,3,800,7,4446,57,70
2608,69,3,801,5,4451,1,50
2609,69,3,802,3,4454,69,30
2610,69,3,803,4,4458,51,40
2611,69,3,804,4,4462,51,40
2612,69,3,805,2,4464,1,20
2613,69,3,806,6,4470,1,60
2614,69,3,807,9,4479,136,90
2615,69,3,808,4,4483,75,40
2616,69,3,809,4,4487,47,40
2617,69,3,810,8,4495,1,80
2618,69,3,811,8,4503,139,80
2619,69,3,812,9,4512,1,90
2620,69,3,813,7,4519,147,70
2621,69,3,814,4,4523,82,40
2622,69,3,815,2,4525,46,20
2623,69,3,816,3,4528,40,30
2624,69,3,817,9,4537,74,90
2625,69,3,818,9,4546,86,90
2626,69,3,819,9,4555,84,90
2627,69,3,820,7,4562,94,70
2628,69,3,821,5,4567,56,50
2629,69,3,822,7,4574,58,70
2630,69,3,823,3,4577,1,30
2631,69,3,824,2,4579,56,20
2632,69,3,825,4,4583,50,40
2633,69,3,826,9,4592,76,90
2634,69,3,827,4,4596,57,40
2635,69,3,828,6,4602,56,60
2636,69,3,829,7,4609,72,70
2637,69,3,830,7,4616,75,70
2638,69,3,831,4,4620,51,40
2639,69,3,832,3,4623,41,30
2640,69,3,833,8,4631,66,80
2641,69,3,834,3,4634,49,30
2642,69,3,835,5,4639,57,50
2643,69,3,836,3,4642,36,30
2644,69,3,837,4,4646,1,40
2645,69,3,838,6,4652,1,60
2646,69,3,839,7,4659,1,70
2647,69,3,840,4,4663,136,40
2648,69,3,841,6,4669,91,60
2649,69,3,842,2,4671,50,20
2650,69,3,843,4,4675,1,40
2651,69,3,844,2,4677,62,20
2652,69,3,845,3,4680,40,30
2653,69,3,846,7,4687,64,70
2654,69,3,847,6,4693,56,60
2655,69,3,848,9,4702,79,90
2656,69,3,849,4,4706,49,40
2657,69,3,850,3,4709,32,30
2658,69,3,851,5,4714,44,50
2659,69,3,852,8,4722,80,80
2660,69,3,853,2,4724,41,20
2661,69,3,854,5,4729,42,50
2662,69,3,855,2,4731,29,20
2663,69,3,856,3,4734,36,30
2664,69,3,857,8,4742,70,80
2665,69,3,858,8,4750,1,80
2666,69,3,859,5,4755,88,50
2667,69,3,860,7,4762,96,70
2668,69,3,861,6,4768,1,60
2669,69,3,862,6,4774,1,60
2670,69,3,863,2,4776,119,20
2671,69,3,864,3,4779,1,30
2672,69,3,865,6,4785,98,60
2673,69,3,866,7,4792,1,70
2674,69,3,867,9,4801,1,90
2675,69,3,868,3,4804,133,30
2676,69,3,869,5,4809,88,50
2677,69,3,870,8,4817,89,80
2678,69,3,871,2,4819,42,20
2679,69,3,872,4,4823,43,40
2680,69,3,873,8,4831,57,80
2681,69,3,874,6,4837,49,60
2682,69,3,875,4,4841,49,40
2683,69,3,876,7,4848,58,70
2684,69,3,877,9,4857,72,90
2685,69,3,878,7,4864,1,70
2686,69,3,879,2,4866,87,20
2687,69,3,880,8,4874,1,80
2688,69,3,881,6,4880,125,60
2689,69,3,882,9,4889,91,90
2690,69,3,883,2,4891,67,20
2691,69,3,884,7,4898,62,70
2692,69,3,885,3,4901,45,30
2693,69,3,886,7,4908,48,70
2694,69,3,887,6,4914,1,60
2695,69,3,888,6,4920,95,60
2696,69,3,889,4,4924,44,40
2697,69,3,890,4,4928,42,40
2698,69,3,891,6,4934,64,60
2699,69,3,892,2,4936,26,20
2700,69,3,893,5,4941,1,50
2701,69,3,894,3,4944,57,30
2702,69,3,895,9,4953,68,90
2703,69,3,896,3,4956,41,30
2704,69,3,897,2,4958,28,20
2705,69,3,898,5,4963,35,50
2706,69,3,899,5,4968,1,50
2707,69,3,900,4,4972,70,40
2708,69,3,901,5,4977,1,50
2709,69,3,902,2,4979,1,20
2710,69,3,903,9,4988,109,90
2711,69,3,904,6,4994,77,60
2712,69,3,905,3,4997,57,30
