,Scenario,Trial,Inspection,Interval,Time,Defects,Rate
0,164,1,1,8,8,80,80
1,164,1,2,4,12,40,40
2,164,1,3,5,17,0,50
3,164,1,4,3,20,86,30
4,164,1,5,5,25,45,50
5,164,1,6,3,28,29,30
6,164,1,7,4,32,42,40
7,164,1,8,2,34,16,20
8,164,1,9,7,41,0,70
9,164,1,10,9,50,162,90
10,164,1,11,3,53,33,30
11,164,1,12,8,61,0,80
12,164,1,13,4,65,123,40
13,164,1,14,9,74,0,90
14,164,1,15,2,76,0,20
15,164,1,16,8,84,179,80
16,164,1,17,3,87,28,30
17,164,1,18,9,96,102,90
18,164,1,19,7,103,69,70
19,164,1,20,9,112,95,90
20,164,1,21,2,114,0,20
21,164,1,22,2,116,37,20
22,164,1,23,8,124,81,80
23,164,1,24,9,133,94,90
24,164,1,25,6,139,0,60
25,164,1,26,2,141,0,20
26,164,1,27,6,147,0,60
27,164,1,28,2,149,0,20
28,164,1,29,7,156,246,70
29,164,1,30,8,164,80,80
30,164,1,31,2,166,17,20
31,164,1,32,2,168,24,20
32,164,1,33,5,173,43,50
33,164,1,34,5,178,0,50
34,164,1,35,6,184,0,60
35,164,1,36,2,186,0,20
36,164,1,37,6,192,0,60
37,164,1,38,7,199,239,70
38,164,1,39,3,202,21,30
39,164,1,40,4,206,48,40
40,164,1,41,3,209,31,30
41,164,1,42,2,211,0,20
42,164,1,43,9,220,108,90
43,164,1,44,4,224,43,40
44,164,1,45,7,231,0,70
45,164,1,46,9,240,0,90
46,164,1,47,4,244,192,40
47,164,1,48,9,253,0,90
48,164,1,49,5,258,0,50
49,164,1,50,5,263,0,50
50,164,1,51,9,272,286,90
51,164,1,52,7,279,59,70
52,164,1,53,9,288,81,90
53,164,1,54,2,290,23,20
54,164,1,55,3,293,0,30
55,164,1,56,3,296,0,30
56,164,1,57,4,300,0,40
57,164,1,58,7,307,0,70
58,164,1,59,5,312,199,50
59,164,1,60,2,314,21,20
60,164,1,61,6,320,60,60
61,164,1,62,7,327,69,70
62,164,1,63,6,333,0,60
63,164,1,64,4,337,0,40
64,164,1,65,2,339,124,20
65,164,1,66,7,346,71,70
66,164,1,67,6,352,0,60
67,164,1,68,9,361,125,90
68,164,1,69,6,367,0,60
69,164,1,70,3,370,103,30
70,164,1,71,4,374,0,40
71,164,1,72,2,376,0,20
72,164,1,73,5,381,0,50
73,164,1,74,3,384,141,30
74,164,1,75,4,388,0,40
75,164,1,76,5,393,0,50
76,164,1,77,8,401,160,80
77,164,1,78,4,405,40,40
78,164,1,79,3,408,0,30
79,164,1,80,8,416,0,80
80,164,1,81,6,422,0,60
81,164,1,82,5,427,220,50
82,164,1,83,5,432,0,50
83,164,1,84,4,436,0,40
84,164,1,85,4,440,137,40
85,164,1,86,7,447,67,70
86,164,1,87,7,454,69,70
87,164,1,88,2,456,27,20
88,164,1,89,4,460,0,40
89,164,1,90,4,464,0,40
90,164,1,91,8,472,168,80
91,164,1,92,7,479,62,70
92,164,1,93,8,487,0,80
93,164,1,94,3,490,109,30
94,164,1,95,2,492,0,20
95,164,1,96,8,500,76,80
96,164,1,97,7,507,0,70
97,164,1,98,2,509,97,20
98,164,1,99,3,512,0,30
99,164,1,100,7,519,0,70
100,164,1,101,7,526,0,70
101,164,1,102,5,531,0,50
102,164,1,103,6,537,0,60
103,164,1,104,2,539,285,20
104,164,1,105,9,548,105,90
105,164,1,106,6,554,53,60
106,164,1,107,4,558,0,40
107,164,1,108,6,564,0,60
108,164,1,109,6,570,176,60
109,164,1,110,3,573,28,30
110,164,1,111,3,576,29,30
111,164,1,112,3,579,0,30
112,164,1,113,4,583,0,40
113,164,1,114,8,591,0,80
114,164,1,115,3,594,0,30
115,164,1,116,5,599,0,50
116,164,1,117,6,605,0,60
117,164,1,118,8,613,0,80
118,164,1,119,2,615,0,20
119,164,1,120,4,619,419,40
120,164,1,121,6,625,0,60
121,164,1,122,8,633,0,80
122,164,1,123,6,639,216,60
123,164,1,124,5,644,0,50
124,164,1,125,3,647,0,30
125,164,1,126,4,651,118,40
126,164,1,127,8,659,82,80
127,164,1,128,3,662,0,30
128,164,1,129,8,670,98,80
129,164,1,130,9,679,0,90
130,164,1,131,8,687,0,80
131,164,1,132,4,691,0,40
132,164,1,133,4,695,0,40
133,164,1,134,4,699,290,40
134,164,1,135,2,701,0,20
135,164,1,136,4,705,0,40
136,164,1,137,8,713,0,80
137,164,1,138,7,720,205,70
138,164,1,139,4,724,0,40
139,164,1,140,9,733,111,90
140,164,1,141,8,741,0,80
141,164,1,142,8,749,0,80
142,164,1,143,8,757,256,80
143,164,1,144,2,759,19,20
144,164,1,145,6,765,59,60
145,164,1,146,9,774,0,90
146,164,1,147,8,782,0,80
147,164,1,148,8,790,244,80
148,164,1,149,3,793,39,30
149,164,1,150,9,802,69,90
150,164,1,151,2,804,17,20
151,164,1,152,5,809,49,50
152,164,1,153,9,818,0,90
153,164,1,154,6,824,157,60
154,164,1,155,3,827,0,30
155,164,1,156,2,829,0,20
156,164,1,157,8,837,0,80
157,164,1,158,2,839,0,20
158,164,1,159,5,844,207,50
159,164,1,160,3,847,36,30
160,164,1,161,8,855,0,80
161,164,1,162,3,858,102,30
162,164,1,163,7,865,0,70
163,164,1,164,5,870,0,50
164,164,1,165,6,876,180,60
165,164,1,166,3,879,29,30
166,164,1,167,4,883,43,40
167,164,1,168,4,887,25,40
168,164,1,169,5,892,37,50
169,164,1,170,9,901,103,90
170,164,1,171,2,903,0,20
171,164,1,172,9,912,0,90
172,164,1,173,3,915,128,30
173,164,1,174,9,924,0,90
174,164,1,175,3,927,113,30
175,164,1,176,5,932,0,50
176,164,1,177,4,936,0,40
177,164,1,178,4,940,0,40
178,164,1,179,7,947,0,70
179,164,1,180,3,950,236,30
180,164,1,181,9,959,73,90
181,164,1,182,9,968,0,90
182,164,1,183,4,972,112,40
183,164,1,184,2,974,0,20
184,164,1,185,9,983,97,90
185,164,1,186,8,991,89,80
186,164,1,187,6,997,0,60
187,164,1,188,5,1002,109,50
188,164,1,189,5,1007,0,50
189,164,1,190,8,1015,131,80
190,164,1,191,5,1020,56,50
191,164,1,192,2,1022,0,20
192,164,1,193,4,1026,56,40
193,164,1,194,3,1029,0,30
194,164,1,195,9,1038,0,90
195,164,1,196,7,1045,0,70
196,164,1,197,4,1049,0,40
197,164,1,198,3,1052,253,30
198,164,1,199,2,1054,0,20
199,164,1,200,4,1058,0,40
200,164,1,201,2,1060,93,20
201,164,1,202,3,1063,22,30
202,164,1,203,3,1066,31,30
203,164,1,204,4,1070,0,40
204,164,1,205,7,1077,105,70
205,164,1,206,2,1079,19,20
206,164,1,207,2,1081,0,20
207,164,1,208,5,1086,0,50
208,164,1,209,4,1090,0,40
209,164,1,210,4,1094,0,40
210,164,1,211,7,1101,239,70
211,164,1,212,6,1107,0,60
212,164,1,213,4,1111,106,40
213,164,1,214,9,1120,76,90
214,164,1,215,4,1124,42,40
215,164,1,216,3,1127,0,30
216,164,1,217,2,1129,51,20
217,164,1,218,7,1136,0,70
218,164,1,219,5,1141,0,50
219,164,1,220,2,1143,0,20
220,164,1,221,4,1147,0,40
221,164,1,222,6,1153,224,60
222,164,1,223,9,1162,96,90
223,164,1,224,6,1168,74,60
224,164,1,225,9,1177,0,90
225,164,1,226,5,1182,0,50
226,164,1,227,5,1187,198,50
227,164,1,228,9,1196,93,90
228,164,1,229,4,1200,0,40
229,164,1,230,2,1202,59,20
230,164,1,231,8,1210,0,80
231,164,1,232,3,1213,0,30
232,164,1,233,7,1220,167,70
233,164,1,234,2,1222,30,20
234,164,1,235,3,1225,33,30
235,164,1,236,4,1229,42,40
236,164,1,237,7,1236,0,70
237,164,1,238,8,1244,0,80
238,164,1,239,4,1248,219,40
239,164,1,240,9,1257,93,90
240,164,1,241,3,1260,0,30
241,164,1,242,2,1262,58,20
242,164,1,243,8,1270,0,80
243,164,1,244,3,1273,108,30
244,164,1,245,4,1277,37,40
245,164,1,246,5,1282,60,50
246,164,1,247,4,1286,0,40
247,164,1,248,5,1291,0,50
248,164,1,249,3,1294,0,30
249,164,1,250,7,1301,193,70
250,164,1,251,6,1307,66,60
251,164,1,252,3,1310,0,30
252,164,1,253,9,1319,116,90
253,164,1,254,5,1324,46,50
254,164,1,255,6,1330,67,60
255,164,1,256,9,1339,78,90
256,164,1,257,7,1346,0,70
257,164,1,258,6,1352,143,60
258,164,1,259,2,1354,0,20
259,164,1,260,5,1359,81,50
260,164,1,261,9,1368,0,90
261,164,1,262,6,1374,0,60
262,164,1,263,9,1383,0,90
263,164,1,264,4,1387,271,40
264,164,1,265,8,1395,72,80
265,164,1,266,3,1398,34,30
266,164,1,267,3,1401,0,30
267,164,1,268,2,1403,0,20
268,164,1,269,7,1410,0,70
269,164,1,270,9,1419,210,90
270,164,1,271,6,1425,63,60
271,164,1,272,4,1429,0,40
272,164,1,273,5,1434,97,50
273,164,1,274,9,1443,0,90
274,164,1,275,4,1447,0,40
275,164,1,276,5,1452,169,50
276,164,1,277,8,1460,75,80
277,164,1,278,2,1462,19,20
278,164,1,279,6,1468,76,60
279,164,1,280,8,1476,68,80
280,164,1,281,6,1482,0,60
281,164,1,282,2,1484,0,20
282,164,1,283,4,1488,0,40
283,164,1,284,2,1490,146,20
284,164,1,285,3,1493,44,30
285,164,1,286,8,1501,72,80
286,164,1,287,8,1509,91,80
287,164,1,288,3,1512,23,30
288,164,1,289,6,1518,0,60
289,164,1,290,8,1526,137,80
290,164,1,291,7,1533,72,70
291,164,1,292,2,1535,17,20
292,164,1,293,6,1541,63,60
293,164,1,294,3,1544,0,30
294,164,1,295,8,1552,124,80
295,164,1,296,5,1557,66,50
296,164,1,297,8,1565,0,80
297,164,1,298,8,1573,179,80
298,164,1,299,8,1581,68,80
299,164,1,300,5,1586,57,50
300,164,1,301,3,1589,29,30
301,164,1,302,7,1596,65,70
302,164,1,303,3,1599,0,30
303,164,1,304,3,1602,0,30
304,164,1,305,4,1606,97,40
305,164,1,306,6,1612,64,60
306,164,1,307,9,1621,0,90
307,164,1,308,8,1629,0,80
308,164,1,309,7,1636,0,70
309,164,1,310,2,1638,258,20
310,164,1,311,8,1646,73,80
311,164,1,312,2,1648,0,20
312,164,1,313,4,1652,0,40
313,164,1,314,2,1654,0,20
314,164,1,315,9,1663,179,90
315,164,1,316,8,1671,82,80
316,164,1,317,3,1674,0,30
317,164,1,318,7,1681,118,70
318,164,1,319,9,1690,74,90
319,164,1,320,3,1693,30,30
320,164,1,321,8,1701,85,80
321,164,1,322,5,1706,53,50
322,164,1,323,8,1714,0,80
323,164,1,324,3,1717,0,30
324,164,1,325,4,1721,0,40
325,164,1,326,5,1726,0,50
326,164,1,327,2,1728,0,20
327,164,1,328,2,1730,0,20
328,164,1,329,2,1732,0,20
329,164,1,330,7,1739,0,70
330,164,1,331,6,1745,0,60
331,164,1,332,5,1750,410,50
332,164,1,333,7,1757,0,70
333,164,1,334,5,1762,0,50
334,164,1,335,5,1767,171,50
335,164,1,336,7,1774,0,70
336,164,1,337,9,1783,0,90
337,164,1,338,3,1786,202,30
338,164,1,339,7,1793,0,70
339,164,1,340,7,1800,0,70
340,164,1,341,7,1807,228,70
341,164,1,342,5,1812,0,50
342,164,1,343,5,1817,100,50
343,164,1,344,8,1825,0,80
344,164,1,345,9,1834,163,90
345,164,1,346,3,1837,0,30
346,164,1,347,9,1846,113,90
347,164,1,348,6,1852,0,60
348,164,1,349,9,1861,185,90
349,164,1,350,5,1866,0,50
350,164,1,351,6,1872,103,60
351,164,1,352,6,1878,52,60
352,164,1,353,3,1881,34,30
353,164,1,354,2,1883,0,20
354,164,1,355,7,1890,95,70
355,164,1,356,5,1895,49,50
356,164,1,357,6,1901,0,60
357,164,1,358,5,1906,123,50
358,164,1,359,9,1915,0,90
359,164,1,360,9,1924,182,90
360,164,1,361,3,1927,0,30
361,164,1,362,3,1930,78,30
362,164,1,363,3,1933,32,30
363,164,1,364,6,1939,57,60
364,164,1,365,7,1946,0,70
365,164,1,366,7,1953,146,70
366,164,1,367,4,1957,0,40
367,164,1,368,5,1962,0,50
368,164,1,369,9,1971,0,90
369,164,1,370,7,1978,279,70
370,164,1,371,7,1985,80,70
371,164,1,372,7,1992,73,70
372,164,1,373,3,1995,0,30
373,164,1,374,2,1997,58,20
374,164,1,375,3,2000,0,30
375,164,1,376,6,2006,81,60
376,164,1,377,7,2013,64,70
377,164,1,378,8,2021,81,80
378,164,1,379,3,2024,42,30
379,164,1,380,2,2026,17,20
380,164,1,381,3,2029,24,30
381,164,1,382,7,2036,0,70
382,164,1,383,8,2044,0,80
383,164,1,384,9,2053,252,90
384,164,1,385,5,2058,55,50
385,164,1,386,9,2067,0,90
386,164,1,387,4,2071,0,40
387,164,1,388,5,2076,0,50
388,164,1,389,5,2081,0,50
389,164,1,390,5,2086,0,50
390,164,1,391,7,2093,364,70
391,164,1,392,9,2102,84,90
392,164,1,393,9,2111,88,90
393,164,1,394,8,2119,78,80
394,164,1,395,6,2125,0,60
395,164,1,396,2,2127,0,20
396,164,1,397,4,2131,0,40
397,164,1,398,4,2135,0,40
398,164,1,399,2,2137,152,20
399,164,1,400,6,2143,58,60
400,164,1,401,2,2145,0,20
401,164,1,402,9,2154,0,90
402,164,1,403,3,2157,0,30
403,164,1,404,7,2164,0,70
404,164,1,405,6,2170,268,60
405,164,1,406,5,2175,0,50
406,164,1,407,6,2181,0,60
407,164,1,408,7,2188,179,70
408,164,1,409,8,2196,0,80
409,164,1,410,4,2200,133,40
410,164,1,411,6,2206,0,60
411,164,1,412,6,2212,0,60
412,164,1,413,4,2216,161,40
413,164,1,414,9,2225,0,90
414,164,1,415,9,2234,0,90
415,164,1,416,9,2243,275,90
416,164,1,417,8,2251,0,80
417,164,1,418,9,2260,0,90
418,164,1,419,9,2269,249,90
419,164,1,420,6,2275,0,60
420,164,1,421,7,2282,116,70
421,164,1,422,4,2286,38,40
422,164,1,423,7,2293,82,70
423,164,1,424,3,2296,30,30
424,164,1,425,3,2299,30,30
425,164,1,426,6,2305,0,60
426,164,1,427,6,2311,0,60
427,164,1,428,7,2318,215,70
428,164,1,429,2,2320,0,20
429,164,1,430,5,2325,65,50
430,164,1,431,7,2332,77,70
431,164,1,432,3,2335,22,30
432,164,1,433,4,2339,38,40
433,164,1,434,5,2344,51,50
434,164,1,435,9,2353,87,90
435,164,1,436,3,2356,30,30
436,164,1,437,4,2360,0,40
437,164,1,438,7,2367,106,70
438,164,1,439,6,2373,54,60
439,164,1,440,4,2377,0,40
440,164,1,441,7,2384,107,70
441,164,1,442,9,2393,84,90
442,164,1,443,6,2399,0,60
443,164,1,444,6,2405,126,60
444,164,1,445,4,2409,0,40
445,164,1,446,7,2416,96,70
446,164,1,447,3,2419,0,30
447,164,1,448,6,2425,92,60
448,164,1,449,7,2432,75,70
449,164,1,450,2,2434,18,20
450,164,1,451,9,2443,92,90
451,164,1,452,9,2452,0,90
452,164,1,453,5,2457,144,50
453,164,1,454,2,2459,0,20
454,164,1,455,6,2465,0,60
455,164,1,456,9,2474,0,90
456,164,1,457,9,2483,255,90
457,164,1,458,7,2490,75,70
458,164,1,459,8,2498,77,80
459,164,1,460,6,2504,57,60
460,164,1,461,7,2511,66,70
461,164,1,462,7,2518,62,70
462,164,1,463,9,2527,0,90
463,164,1,464,2,2529,113,20
464,164,1,465,8,2537,78,80
465,164,1,466,7,2544,0,70
466,164,1,467,3,2547,113,30
467,164,1,468,3,2550,50,30
468,164,1,469,3,2553,0,30
469,164,1,470,7,2560,74,70
470,164,1,471,7,2567,76,70
471,164,1,472,2,2569,22,20
472,164,1,473,6,2575,59,60
473,164,1,474,2,2577,25,20
474,164,1,475,6,2583,61,60
475,164,1,476,9,2592,108,90
476,164,1,477,7,2599,61,70
477,164,1,478,2,2601,0,20
478,164,1,479,4,2605,0,40
479,164,1,480,9,2614,148,90
480,164,1,481,9,2623,0,90
481,164,1,482,7,2630,155,70
482,164,1,483,4,2634,0,40
483,164,1,484,8,2642,133,80
484,164,1,485,8,2650,81,80
485,164,1,486,3,2653,0,30
486,164,1,487,6,2659,78,60
487,164,1,488,5,2664,0,50
488,164,1,489,7,2671,117,70
489,164,1,490,8,2679,72,80
490,164,1,491,9,2688,0,90
491,164,1,492,4,2692,140,40
492,164,1,493,7,2699,65,70
493,164,1,494,2,2701,20,20
494,164,1,495,4,2705,40,40
495,164,1,496,7,2712,0,70
496,164,1,497,4,2716,0,40
497,164,1,498,3,2719,130,30
498,164,1,499,3,2722,0,30
499,164,1,500,6,2728,0,60
500,164,1,501,9,2737,180,90
501,164,1,502,4,2741,26,40
502,164,1,503,6,2747,84,60
503,164,1,504,6,2753,0,60
504,164,1,505,8,2761,0,80
505,164,1,506,2,2763,0,20
506,164,1,507,8,2771,0,80
507,164,1,508,4,2775,264,40
508,164,1,509,6,2781,0,60
509,164,1,510,3,2784,0,30
510,164,1,511,6,2790,157,60
511,164,1,512,7,2797,0,70
512,164,1,513,9,2806,159,90
513,164,1,514,9,2815,0,90
514,164,1,515,2,2817,0,20
515,164,1,516,9,2826,0,90
516,164,1,517,8,2834,267,80
517,164,1,518,8,2842,0,80
518,164,1,519,3,2845,95,30
519,164,1,520,8,2853,87,80
520,164,1,521,9,2862,86,90
521,164,1,522,2,2864,17,20
522,164,1,523,9,2873,94,90
523,164,1,524,6,2879,70,60
524,164,1,525,7,2886,69,70
525,164,1,526,2,2888,18,20
526,164,1,527,3,2891,0,30
527,164,1,528,9,2900,125,90
528,164,1,529,4,2904,38,40
529,164,1,530,7,2911,63,70
530,164,1,531,7,2918,76,70
531,164,1,532,4,2922,0,40
532,164,1,533,9,2931,0,90
533,164,1,534,4,2935,145,40
534,164,1,535,6,2941,55,60
535,164,1,536,4,2945,0,40
536,164,1,537,2,2947,0,20
537,164,1,538,4,2951,86,40
538,164,1,539,5,2956,0,50
539,164,1,540,6,2962,0,60
540,164,1,541,8,2970,0,80
541,164,1,542,7,2977,0,70
542,164,1,543,6,2983,0,60
543,164,1,544,2,2985,0,20
544,164,1,545,8,2993,0,80
545,164,1,546,6,2999,0,60
546,164,1,547,4,3003,507,40
547,164,1,548,3,3006,26,30
548,164,1,549,7,3013,0,70
549,164,1,550,2,3015,0,20
550,164,1,551,5,3020,0,50
551,164,1,552,3,3023,192,30
552,164,1,553,7,3030,77,70
553,164,1,554,8,3038,73,80
554,164,1,555,6,3044,0,60
555,164,1,556,5,3049,0,50
556,164,1,557,9,3058,183,90
557,164,1,558,5,3063,49,50
558,164,1,559,2,3065,20,20
559,164,1,560,6,3071,61,60
560,164,1,561,7,3078,65,70
561,164,1,562,6,3084,55,60
562,164,1,563,7,3091,61,70
563,164,1,564,4,3095,0,40
564,164,1,565,8,3103,128,80
565,164,1,566,5,3108,0,50
566,164,1,567,3,3111,85,30
567,164,1,568,7,3118,0,70
568,164,1,569,9,3127,0,90
569,164,1,570,2,3129,193,20
570,164,1,571,4,3133,36,40
571,164,1,572,4,3137,40,40
572,164,1,573,7,3144,0,70
573,164,1,574,9,3153,150,90
574,164,1,575,6,3159,52,60
575,164,1,576,6,3165,0,60
576,164,1,577,6,3171,0,60
577,164,1,578,5,3176,0,50
578,164,1,579,9,3185,268,90
579,164,1,580,9,3194,0,90
580,164,1,581,2,3196,0,20
581,164,1,582,7,3203,0,70
582,164,1,583,5,3208,0,50
583,164,1,584,4,3212,279,40
584,164,1,585,4,3216,0,40
585,164,1,586,4,3220,68,40
586,164,1,587,5,3225,49,50
587,164,1,588,5,3230,61,50
588,164,1,589,9,3239,0,90
589,164,1,590,3,3242,135,30
590,164,1,591,5,3247,0,50
591,164,1,592,9,3256,117,90
592,164,1,593,9,3265,75,90
593,164,1,594,3,3268,0,30
594,164,1,595,8,3276,0,80
595,164,1,596,7,3283,172,70
596,164,1,597,8,3291,0,80
597,164,1,598,3,3294,0,30
598,164,1,599,7,3301,184,70
599,164,1,600,8,3309,0,80
600,164,1,601,2,3311,0,20
601,164,1,602,6,3317,154,60
602,164,1,603,5,3322,44,50
603,164,1,604,7,3329,0,70
604,164,1,605,5,3334,0,50
605,164,1,606,8,3342,217,80
606,164,1,607,6,3348,0,60
607,164,1,608,7,3355,135,70
608,164,1,609,8,3363,75,80
609,164,1,610,4,3367,36,40
610,164,1,611,6,3373,62,60
611,164,1,612,9,3382,89,90
612,164,1,613,7,3389,66,70
613,164,1,614,9,3398,96,90
614,164,1,615,8,3406,77,80
615,164,1,616,8,3414,88,80
616,164,1,617,8,3422,76,80
617,164,1,618,8,3430,78,80
618,164,1,619,3,3433,0,30
619,164,1,620,9,3442,117,90
620,164,1,621,6,3448,65,60
621,164,1,622,5,3453,0,50
622,164,1,623,7,3460,0,70
623,164,1,624,5,3465,0,50
624,164,1,625,2,3467,0,20
625,164,1,626,8,3475,300,80
626,164,1,627,4,3479,36,40
627,164,1,628,2,3481,0,20
628,164,1,629,5,3486,0,50
629,164,1,630,4,3490,0,40
630,164,1,631,2,3492,150,20
631,164,1,632,9,3501,100,90
632,164,1,633,6,3507,61,60
633,164,1,634,5,3512,0,50
634,164,1,635,4,3516,0,40
635,164,1,636,6,3522,0,60
636,164,1,637,9,3531,215,90
637,164,1,638,2,3533,19,20
638,164,1,639,4,3537,0,40
639,164,1,640,2,3539,0,20
640,164,1,641,6,3545,0,60
641,164,1,642,7,3552,185,70
642,164,1,643,5,3557,60,50
643,164,1,644,6,3563,0,60
644,164,1,645,8,3571,130,80
645,164,1,646,4,3575,42,40
646,164,1,647,8,3583,0,80
647,164,1,648,2,3585,105,20
648,164,1,649,3,3588,24,30
649,164,1,650,4,3592,51,40
650,164,1,651,8,3600,0,80
651,164,1,652,6,3606,159,60
652,164,1,653,7,3613,66,70
653,164,1,654,4,3617,48,40
654,164,1,655,7,3624,64,70
655,164,1,656,6,3630,0,60
656,164,1,657,6,3636,0,60
657,164,1,658,6,3642,192,60
658,164,1,659,9,3651,0,90
659,164,1,660,3,3654,120,30
660,164,1,661,9,3663,0,90
661,164,1,662,3,3666,117,30
662,164,1,663,8,3674,88,80
663,164,1,664,4,3678,43,40
664,164,1,665,3,3681,31,30
665,164,1,666,2,3683,21,20
666,164,1,667,5,3688,0,50
667,164,1,668,9,3697,140,90
668,164,1,669,9,3706,0,90
669,164,1,670,7,3713,0,70
670,164,1,671,3,3716,0,30
671,164,1,672,2,3718,232,20
672,164,1,673,9,3727,71,90
673,164,1,674,5,3732,0,50
674,164,1,675,6,3738,0,60
675,164,1,676,2,3740,0,20
676,164,1,677,8,3748,210,80
677,164,1,678,8,3756,96,80
678,164,1,679,7,3763,62,70
679,164,1,680,7,3770,68,70
680,164,1,681,4,3774,36,40
681,164,1,682,6,3780,0,60
682,164,1,683,8,3788,0,80
683,164,1,684,6,3794,0,60
684,164,1,685,6,3800,259,60
685,164,1,686,8,3808,0,80
686,164,1,687,5,3813,0,50
687,164,1,688,3,3816,163,30
688,164,1,689,8,3824,92,80
689,164,1,690,8,3832,0,80
690,164,1,691,4,3836,99,40
691,164,1,692,8,3844,0,80
692,164,1,693,5,3849,142,50
693,164,1,694,3,3852,0,30
694,164,1,695,4,3856,0,40
695,164,1,696,6,3862,0,60
696,164,1,697,3,3865,0,30
697,164,1,698,7,3872,225,70
698,164,1,699,9,3881,0,90
699,164,1,700,3,3884,123,30
700,164,1,701,2,3886,16,20
701,164,1,702,6,3892,62,60
702,164,1,703,4,3896,33,40
703,164,1,704,2,3898,0,20
704,164,1,705,9,3907,106,90
705,164,1,706,4,3911,0,40
706,164,1,707,5,3916,90,50
707,164,1,708,5,3921,49,50
708,164,1,709,6,3927,66,60
709,164,1,710,2,3929,0,20
710,164,1,711,2,3931,0,20
711,164,1,712,9,3940,145,90
712,164,1,713,6,3946,49,60
713,164,1,714,9,3955,90,90
714,164,1,715,5,3960,0,50
715,164,1,716,5,3965,0,50
716,164,1,717,5,3970,0,50
717,164,1,718,2,3972,189,20
718,164,1,719,4,3976,28,40
719,164,1,720,6,3982,0,60
720,164,1,721,6,3988,0,60
721,164,1,722,7,3995,0,70
722,164,1,723,8,4003,0,80
723,164,1,724,6,4009,0,60
724,164,1,725,4,4013,0,40
725,164,1,726,8,4021,447,80
726,164,1,727,3,4024,28,30
727,164,1,728,3,4027,0,30
728,164,1,729,8,4035,124,80
729,164,1,730,4,4039,0,40
730,164,1,731,6,4045,0,60
731,164,1,732,3,4048,0,30
732,164,1,733,9,4057,0,90
733,164,1,734,5,4062,264,50
734,164,1,735,2,4064,0,20
735,164,1,736,7,4071,101,70
736,164,1,737,7,4078,77,70
737,164,1,738,8,4086,74,80
738,164,1,739,9,4095,75,90
739,164,1,740,2,4097,0,20
740,164,1,741,2,4099,0,20
741,164,1,742,3,4102,0,30
742,164,1,743,5,4107,122,50
743,164,1,744,2,4109,11,20
744,164,1,745,6,4115,44,60
745,164,1,746,5,4120,0,50
746,164,1,747,6,4126,0,60
747,164,1,748,4,4130,175,40
748,164,1,749,6,4136,0,60
749,164,1,750,3,4139,0,30
750,164,1,751,2,4141,0,20
751,164,1,752,7,4148,179,70
752,164,1,753,7,4155,64,70
753,164,1,754,9,4164,0,90
754,164,1,755,9,4173,0,90
755,164,1,756,2,4175,0,20
756,164,1,757,3,4178,228,30
757,164,1,758,4,4182,0,40
758,164,1,759,4,4186,83,40
759,164,1,760,5,4191,56,50
760,164,1,761,2,4193,20,20
761,164,1,762,9,4202,0,90
762,164,1,763,6,4208,156,60
763,164,1,764,6,4214,60,60
764,164,1,765,6,4220,0,60
765,164,1,766,4,4224,102,40
766,164,1,767,8,4232,70,80
767,164,1,768,4,4236,41,40
768,164,1,769,3,4239,0,30
769,164,1,770,9,4248,107,90
770,164,1,771,7,4255,72,70
771,164,1,772,2,4257,0,20
772,164,1,773,7,4264,0,70
773,164,1,774,7,4271,162,70
774,164,1,775,3,4274,27,30
775,164,1,776,8,4282,80,80
776,164,1,777,4,4286,42,40
777,164,1,778,3,4289,0,30
778,164,1,779,8,4297,100,80
779,164,1,780,8,4305,0,80
780,164,1,781,9,4314,0,90
781,164,1,782,9,4323,236,90
782,164,1,783,4,4327,0,40
783,164,1,784,2,4329,0,20
784,164,1,785,7,4336,0,70
785,164,1,786,3,4339,0,30
786,164,1,787,8,4347,0,80
787,164,1,788,4,4351,279,40
788,164,1,789,5,4356,0,50
789,164,1,790,3,4359,75,30
790,164,1,791,7,4366,66,70
791,164,1,792,2,4368,21,20
792,164,1,793,6,4374,53,60
793,164,1,794,9,4383,0,90
794,164,1,795,5,4388,127,50
795,164,1,796,2,4390,25,20
796,164,1,797,3,4393,0,30
797,164,1,798,6,4399,93,60
798,164,1,799,8,4407,84,80
799,164,1,800,6,4413,65,60
800,164,1,801,8,4421,0,80
801,164,1,802,5,4426,127,50
802,164,1,803,9,4435,0,90
803,164,1,804,4,4439,0,40
804,164,1,805,5,4444,0,50
805,164,1,806,4,4448,217,40
806,164,1,807,4,4452,38,40
807,164,1,808,7,4459,0,70
808,164,1,809,3,4462,111,30
809,164,1,810,2,4464,28,20
810,164,1,811,3,4467,32,30
811,164,1,812,3,4470,32,30
812,164,1,813,8,4478,0,80
813,164,1,814,9,4487,167,90
814,164,1,815,7,4494,0,70
815,164,1,816,9,4503,162,90
816,164,1,817,6,4509,50,60
817,164,1,818,8,4517,0,80
818,164,1,819,7,4524,0,70
819,164,1,820,7,4531,195,70
820,164,1,821,4,4535,32,40
821,164,1,822,8,4543,87,80
822,164,1,823,5,4548,0,50
823,164,1,824,2,4550,73,20
824,164,1,825,2,4552,17,20
825,164,1,826,8,4560,0,80
826,164,1,827,2,4562,104,20
827,164,1,828,8,4570,68,80
828,164,1,829,4,4574,0,40
829,164,1,830,4,4578,96,40
830,164,1,831,8,4586,0,80
831,164,1,832,6,4592,132,60
832,164,1,833,7,4599,0,70
833,164,1,834,5,4604,0,50
834,164,1,835,9,4613,0,90
835,164,1,836,4,4617,228,40
836,164,1,837,2,4619,28,20
837,164,1,838,9,4628,92,90
838,164,1,839,4,4632,0,40
839,164,1,840,3,4635,0,30
840,164,1,841,8,4643,168,80
841,164,1,842,6,4649,62,60
842,164,1,843,6,4655,0,60
843,164,1,844,5,4660,128,50
844,164,1,845,7,4667,72,70
845,164,1,846,9,4676,71,90
846,164,1,847,3,4679,0,30
847,164,1,848,3,4682,57,30
848,164,1,849,5,4687,51,50
849,164,1,850,7,4694,76,70
850,164,1,851,5,4699,69,50
851,164,1,852,9,4708,0,90
852,164,1,853,7,4715,0,70
853,164,1,854,2,4717,183,20
854,164,1,855,3,4720,0,30
855,164,1,856,6,4726,0,60
856,164,1,857,4,4730,138,40
857,164,1,858,5,4735,53,50
858,164,1,859,5,4740,52,50
859,164,1,860,8,4748,0,80
860,164,1,861,9,4757,0,90
861,164,1,862,4,4761,196,40
862,164,1,863,9,4770,0,90
863,164,1,864,2,4772,0,20
864,164,1,865,9,4781,0,90
865,164,1,866,8,4789,245,80
866,164,1,867,7,4796,86,70
867,164,1,868,3,4799,37,30
868,164,1,869,8,4807,80,80
869,164,1,870,7,4814,0,70
870,164,1,871,2,4816,0,20
871,164,1,872,8,4824,173,80
872,164,1,873,3,4827,35,30
873,164,1,874,5,4832,54,50
874,164,1,875,2,4834,18,20
875,164,1,876,9,4843,0,90
876,164,1,877,8,4851,177,80
877,164,1,878,9,4860,0,90
878,164,1,879,8,4868,200,80
879,164,1,880,4,4872,0,40
880,164,1,881,2,4874,67,20
881,164,1,882,7,4881,74,70
882,164,1,883,5,4886,43,50
883,164,1,884,8,4894,0,80
884,164,1,885,5,4899,0,50
885,164,1,886,9,4908,213,90
886,164,1,887,4,4912,40,40
887,164,1,888,9,4921,86,90
888,164,1,889,3,4924,0,30
889,164,1,890,5,4929,82,50
890,164,1,891,2,4931,0,20
891,164,1,892,7,4938,91,70
892,164,1,893,3,4941,0,30
893,164,1,894,3,4944,0,30
894,164,1,895,2,4946,77,20
895,164,1,896,4,4950,31,40
896,164,1,897,9,4959,87,90
897,164,1,898,5,4964,0,50
898,164,1,899,4,4968,0,40
899,164,1,900,9,4977,0,90
900,164,1,901,5,4982,215,50
901,164,1,902,5,4987,57,50
902,164,1,903,2,4989,0,20
903,164,1,904,7,4996,0,70
904,164,2,1,7,7,0,70
905,164,2,2,2,9,98,20
906,164,2,3,5,14,0,50
907,164,2,4,5,19,85,50
908,164,2,5,5,24,0,50
909,164,2,6,4,28,94,40
910,164,2,7,4,32,50,40
911,164,2,8,5,37,0,50
912,164,2,9,5,42,106,50
913,164,2,10,9,51,98,90
914,164,2,11,6,57,75,60
915,164,2,12,6,63,46,60
916,164,2,13,4,67,0,40
917,164,2,14,6,73,100,60
918,164,2,15,6,79,0,60
919,164,2,16,4,83,0,40
920,164,2,17,4,87,151,40
921,164,2,18,8,95,77,80
922,164,2,19,7,102,71,70
923,164,2,20,4,106,0,40
924,164,2,21,3,109,68,30
925,164,2,22,7,116,63,70
926,164,2,23,6,122,70,60
927,164,2,24,8,130,0,80
928,164,2,25,6,136,125,60
929,164,2,26,2,138,23,20
930,164,2,27,7,145,67,70
931,164,2,28,8,153,74,80
932,164,2,29,9,162,0,90
933,164,2,30,7,169,0,70
934,164,2,31,9,178,264,90
935,164,2,32,4,182,44,40
936,164,2,33,4,186,0,40
937,164,2,34,5,191,0,50
938,164,2,35,6,197,0,60
939,164,2,36,2,199,188,20
940,164,2,37,2,201,0,20
941,164,2,38,9,210,0,90
942,164,2,39,8,218,0,80
943,164,2,40,7,225,0,70
944,164,2,41,9,234,0,90
945,164,2,42,8,242,0,80
946,164,2,43,3,245,475,30
947,164,2,44,8,253,93,80
948,164,2,45,5,258,0,50
949,164,2,46,6,264,92,60
950,164,2,47,6,270,60,60
951,164,2,48,4,274,36,40
952,164,2,49,8,282,79,80
953,164,2,50,3,285,0,30
954,164,2,51,6,291,102,60
955,164,2,52,8,299,0,80
956,164,2,53,7,306,149,70
957,164,2,54,5,311,59,50
958,164,2,55,2,313,0,20
959,164,2,56,7,320,92,70
960,164,2,57,7,327,66,70
961,164,2,58,5,332,48,50
962,164,2,59,6,338,60,60
963,164,2,60,8,346,84,80
964,164,2,61,9,355,102,90
965,164,2,62,6,361,59,60
966,164,2,63,5,366,0,50
967,164,2,64,5,371,104,50
968,164,2,65,9,380,0,90
969,164,2,66,8,388,0,80
970,164,2,67,4,392,0,40
971,164,2,68,3,395,237,30
972,164,2,69,7,402,67,70
973,164,2,70,4,406,45,40
974,164,2,71,9,415,0,90
975,164,2,72,9,424,0,90
976,164,2,73,9,433,290,90
977,164,2,74,9,442,0,90
978,164,2,75,7,449,0,70
979,164,2,76,2,451,175,20
980,164,2,77,5,456,0,50
981,164,2,78,3,459,88,30
982,164,2,79,9,468,0,90
983,164,2,80,9,477,0,90
984,164,2,81,3,480,234,30
985,164,2,82,6,486,61,60
986,164,2,83,6,492,51,60
987,164,2,84,9,501,95,90
988,164,2,85,3,504,0,30
989,164,2,86,5,509,87,50
990,164,2,87,5,514,48,50
991,164,2,88,2,516,27,20
992,164,2,89,6,522,51,60
993,164,2,90,2,524,20,20
994,164,2,91,8,532,0,80
995,164,2,92,7,539,147,70
996,164,2,93,8,547,84,80
997,164,2,94,3,550,24,30
998,164,2,95,3,553,0,30
999,164,2,96,6,559,97,60
1000,164,2,97,7,566,0,70
1001,164,2,98,3,569,0,30
1002,164,2,99,9,578,215,90
1003,164,2,100,9,587,0,90
1004,164,2,101,8,595,0,80
1005,164,2,102,9,604,260,90
1006,164,2,103,4,608,0,40
1007,164,2,104,9,617,147,90
1008,164,2,105,4,621,0,40
1009,164,2,106,7,628,120,70
1010,164,2,107,4,632,31,40
1011,164,2,108,4,636,46,40
1012,164,2,109,9,645,95,90
1013,164,2,110,6,651,64,60
1014,164,2,111,2,653,23,20
1015,164,2,112,3,656,0,30
1016,164,2,113,8,664,118,80
1017,164,2,114,3,667,22,30
1018,164,2,115,9,676,100,90
1019,164,2,116,2,678,0,20
1020,164,2,117,9,687,0,90
1021,164,2,118,4,691,133,40
1022,164,2,119,9,700,0,90
1023,164,2,120,4,704,132,40
1024,164,2,121,5,709,45,50
1025,164,2,122,2,711,20,20
1026,164,2,123,4,715,0,40
1027,164,2,124,3,718,0,30
1028,164,2,125,7,725,149,70
1029,164,2,126,8,733,81,80
1030,164,2,127,7,740,67,70
1031,164,2,128,4,744,0,40
1032,164,2,129,8,752,0,80
1033,164,2,130,8,760,179,80
1034,164,2,131,8,768,81,80
1035,164,2,132,3,771,0,30
1036,164,2,133,7,778,111,70
1037,164,2,134,2,780,24,20
1038,164,2,135,3,783,29,30
1039,164,2,136,3,786,0,30
1040,164,2,137,4,790,67,40
1041,164,2,138,9,799,0,90
1042,164,2,139,7,806,155,70
1043,164,2,140,7,813,66,70
1044,164,2,141,7,820,75,70
1045,164,2,142,3,823,0,30
1046,164,2,143,5,828,0,50
1047,164,2,144,2,830,92,20
1048,164,2,145,8,838,0,80
1049,164,2,146,6,844,0,60
1050,164,2,147,7,851,0,70
1051,164,2,148,4,855,0,40
1052,164,2,149,9,864,0,90
1053,164,2,150,7,871,433,70
1054,164,2,151,9,880,91,90
1055,164,2,152,9,889,96,90
1056,164,2,153,4,893,35,40
1057,164,2,154,6,899,0,60
1058,164,2,155,2,901,0,20
1059,164,2,156,6,907,131,60
1060,164,2,157,8,915,0,80
1061,164,2,158,4,919,0,40
1062,164,2,159,6,925,177,60
1063,164,2,160,4,929,41,40
1064,164,2,161,8,937,0,80
1065,164,2,162,5,942,129,50
1066,164,2,163,5,947,50,50
1067,164,2,164,2,949,24,20
1068,164,2,165,8,957,84,80
1069,164,2,166,4,961,32,40
1070,164,2,167,8,969,0,80
1071,164,2,168,9,978,171,90
1072,164,2,169,5,983,44,50
1073,164,2,170,9,992,77,90
1074,164,2,171,5,997,54,50
1075,164,2,172,3,1000,33,30
1076,164,2,173,4,1004,0,40
1077,164,2,174,4,1008,0,40
1078,164,2,175,8,1016,158,80
1079,164,2,176,5,1021,0,50
1080,164,2,177,8,1029,0,80
1081,164,2,178,3,1032,0,30
1082,164,2,179,3,1035,0,30
1083,164,2,180,4,1039,263,40
1084,164,2,181,5,1044,0,50
1085,164,2,182,2,1046,75,20
1086,164,2,183,8,1054,72,80
1087,164,2,184,9,1063,85,90
1088,164,2,185,7,1070,0,70
1089,164,2,186,9,1079,157,90
1090,164,2,187,4,1083,0,40
1091,164,2,188,8,1091,120,80
1092,164,2,189,2,1093,14,20
1093,164,2,190,4,1097,45,40
1094,164,2,191,3,1100,0,30
1095,164,2,192,8,1108,135,80
1096,164,2,193,7,1115,70,70
1097,164,2,194,3,1118,22,30
1098,164,2,195,3,1121,0,30
1099,164,2,196,6,1127,0,60
1100,164,2,197,2,1129,99,20
1101,164,2,198,3,1132,23,30
1102,164,2,199,2,1134,15,20
1103,164,2,200,8,1142,0,80
1104,164,2,201,9,1151,0,90
1105,164,2,202,7,1158,0,70
1106,164,2,203,4,1162,0,40
1107,164,2,204,2,1164,0,20
1108,164,2,205,8,1172,0,80
1109,164,2,206,8,1180,0,80
1110,164,2,207,5,1185,0,50
1111,164,2,208,9,1194,0,90
1112,164,2,209,7,1201,649,70
1113,164,2,210,5,1206,0,50
1114,164,2,211,8,1214,116,80
1115,164,2,212,6,1220,0,60
1116,164,2,213,2,1222,93,20
1117,164,2,214,9,1231,84,90
1118,164,2,215,6,1237,61,60
1119,164,2,216,7,1244,0,70
1120,164,2,217,5,1249,125,50
1121,164,2,218,2,1251,0,20
1122,164,2,219,8,1259,113,80
1123,164,2,220,4,1263,0,40
1124,164,2,221,4,1267,82,40
1125,164,2,222,5,1272,67,50
1126,164,2,223,4,1276,0,40
1127,164,2,224,8,1284,129,80
1128,164,2,225,9,1293,0,90
1129,164,2,226,4,1297,140,40
1130,164,2,227,2,1299,22,20
1131,164,2,228,7,1306,68,70
1132,164,2,229,2,1308,0,20
1133,164,2,230,7,1315,84,70
1134,164,2,231,8,1323,0,80
1135,164,2,232,2,1325,111,20
1136,164,2,233,2,1327,0,20
1137,164,2,234,9,1336,103,90
1138,164,2,235,2,1338,0,20
1139,164,2,236,8,1346,101,80
1140,164,2,237,3,1349,34,30
1141,164,2,238,4,1353,44,40
1142,164,2,239,2,1355,0,20
1143,164,2,240,3,1358,45,30
1144,164,2,241,2,1360,18,20
1145,164,2,242,5,1365,33,50
1146,164,2,243,3,1368,0,30
1147,164,2,244,9,1377,120,90
1148,164,2,245,7,1384,0,70
1149,164,2,246,7,1391,121,70
1150,164,2,247,5,1396,0,50
1151,164,2,248,2,1398,73,20
1152,164,2,249,7,1405,0,70
1153,164,2,250,4,1409,107,40
1154,164,2,251,6,1415,56,60
1155,164,2,252,4,1419,42,40
1156,164,2,253,6,1425,0,60
1157,164,2,254,9,1434,148,90
1158,164,2,255,3,1437,40,30
1159,164,2,256,5,1442,55,50
1160,164,2,257,3,1445,33,30
1161,164,2,258,2,1447,0,20
1162,164,2,259,2,1449,0,20
1163,164,2,260,5,1454,76,50
1164,164,2,261,3,1457,33,30
1165,164,2,262,7,1464,70,70
1166,164,2,263,5,1469,57,50
1167,164,2,264,9,1478,0,90
1168,164,2,265,2,1480,90,20
1169,164,2,266,7,1487,71,70
1170,164,2,267,2,1489,20,20
1171,164,2,268,7,1496,0,70
1172,164,2,269,7,1503,157,70
1173,164,2,270,3,1506,0,30
1174,164,2,271,2,1508,47,20
1175,164,2,272,4,1512,0,40
1176,164,2,273,8,1520,0,80
1177,164,2,274,9,1529,205,90
1178,164,2,275,7,1536,0,70
1179,164,2,276,3,1539,0,30
1180,164,2,277,2,1541,128,20
1181,164,2,278,2,1543,0,20
1182,164,2,279,5,1548,0,50
1183,164,2,280,8,1556,0,80
1184,164,2,281,6,1562,217,60
1185,164,2,282,5,1567,0,50
1186,164,2,283,6,1573,0,60
1187,164,2,284,9,1582,179,90
1188,164,2,285,8,1590,74,80
1189,164,2,286,8,1598,90,80
1190,164,2,287,3,1601,31,30
1191,164,2,288,2,1603,0,20
1192,164,2,289,7,1610,0,70
1193,164,2,290,8,1618,151,80
1194,164,2,291,6,1624,57,60
1195,164,2,292,3,1627,30,30
1196,164,2,293,5,1632,46,50
1197,164,2,294,5,1637,42,50
1198,164,2,295,6,1643,0,60
1199,164,2,296,7,1650,0,70
1200,164,2,297,3,1653,148,30
1201,164,2,298,4,1657,0,40
1202,164,2,299,7,1664,70,70
1203,164,2,300,2,1666,0,20
1204,164,2,301,9,1675,0,90
1205,164,2,302,9,1684,0,90
1206,164,2,303,7,1691,274,70
1207,164,2,304,7,1698,0,70
1208,164,2,305,8,1706,0,80
1209,164,2,306,2,1708,179,20
1210,164,2,307,7,1715,73,70
1211,164,2,308,3,1718,0,30
1212,164,2,309,8,1726,91,80
1213,164,2,310,7,1733,0,70
1214,164,2,311,6,1739,0,60
1215,164,2,312,7,1746,0,70
1216,164,2,313,9,1755,0,90
1217,164,2,314,3,1758,0,30
1218,164,2,315,2,1760,341,20
1219,164,2,316,2,1762,0,20
1220,164,2,317,9,1771,117,90
1221,164,2,318,7,1778,72,70
1222,164,2,319,5,1783,0,50
1223,164,2,320,8,1791,0,80
1224,164,2,321,3,1794,161,30
1225,164,2,322,2,1796,21,20
1226,164,2,323,6,1802,64,60
1227,164,2,324,8,1810,75,80
1228,164,2,325,9,1819,80,90
1229,164,2,326,3,1822,0,30
1230,164,2,327,8,1830,101,80
1231,164,2,328,2,1832,0,20
1232,164,2,329,5,1837,57,50
1233,164,2,330,2,1839,20,20
1234,164,2,331,6,1845,62,60
1235,164,2,332,3,1848,40,30
1236,164,2,333,7,1855,0,70
1237,164,2,334,8,1863,0,80
1238,164,2,335,6,1869,0,60
1239,164,2,336,9,1878,292,90
1240,164,2,337,7,1885,90,70
1241,164,2,338,3,1888,34,30
1242,164,2,339,2,1890,18,20
1243,164,2,340,3,1893,0,30
1244,164,2,341,8,1901,0,80
1245,164,2,342,7,1908,0,70
1246,164,2,343,3,1911,0,30
1247,164,2,344,2,1913,217,20
1248,164,2,345,6,1919,43,60
1249,164,2,346,6,1925,46,60
1250,164,2,347,7,1932,60,70
1251,164,2,348,6,1938,57,60
1252,164,2,349,8,1946,77,80
1253,164,2,350,3,1949,32,30
1254,164,2,351,6,1955,0,60
1255,164,2,352,3,1958,90,30
1256,164,2,353,9,1967,0,90
1257,164,2,354,4,1971,0,40
1258,164,2,355,9,1980,200,90
1259,164,2,356,3,1983,0,30
1260,164,2,357,7,1990,93,70
1261,164,2,358,6,1996,65,60
1262,164,2,359,5,2001,0,50
1263,164,2,360,5,2006,0,50
1264,164,2,361,7,2013,0,70
1265,164,2,362,4,2017,0,40
1266,164,2,363,5,2022,268,50
1267,164,2,364,8,2030,67,80
1268,164,2,365,6,2036,56,60
1269,164,2,366,7,2043,0,70
1270,164,2,367,6,2049,0,60
1271,164,2,368,2,2051,0,20
1272,164,2,369,5,2056,194,50
1273,164,2,370,4,2060,0,40
1274,164,2,371,2,2062,0,20
1275,164,2,372,2,2064,77,20
1276,164,2,373,6,2070,58,60
1277,164,2,374,8,2078,0,80
1278,164,2,375,3,2081,0,30
1279,164,2,376,8,2089,177,80
1280,164,2,377,3,2092,26,30
1281,164,2,378,8,2100,0,80
1282,164,2,379,8,2108,174,80
1283,164,2,380,6,2114,0,60
1284,164,2,381,6,2120,0,60
1285,164,2,382,8,2128,0,80
1286,164,2,383,4,2132,0,40
1287,164,2,384,8,2140,0,80
1288,164,2,385,2,2142,0,20
1289,164,2,386,5,2147,407,50
1290,164,2,387,9,2156,100,90
1291,164,2,388,7,2163,66,70
1292,164,2,389,8,2171,79,80
1293,164,2,390,8,2179,0,80
1294,164,2,391,9,2188,159,90
1295,164,2,392,9,2197,0,90
1296,164,2,393,2,2199,118,20
1297,164,2,394,5,2204,0,50
1298,164,2,395,7,2211,0,70
1299,164,2,396,6,2217,185,60
1300,164,2,397,5,2222,51,50
1301,164,2,398,9,2231,0,90
1302,164,2,399,5,2236,135,50
1303,164,2,400,6,2242,0,60
1304,164,2,401,7,2249,0,70
1305,164,2,402,3,2252,0,30
1306,164,2,403,2,2254,199,20
1307,164,2,404,3,2257,37,30
1308,164,2,405,7,2264,0,70
1309,164,2,406,2,2266,77,20
1310,164,2,407,8,2274,90,80
1311,164,2,408,6,2280,71,60
1312,164,2,409,4,2284,41,40
1313,164,2,410,4,2288,0,40
1314,164,2,411,5,2293,0,50
1315,164,2,412,2,2295,113,20
1316,164,2,413,2,2297,0,20
1317,164,2,414,5,2302,72,50
1318,164,2,415,6,2308,0,60
1319,164,2,416,6,2314,118,60
1320,164,2,417,8,2322,80,80
1321,164,2,418,4,2326,0,40
1322,164,2,419,2,2328,0,20
1323,164,2,420,2,2330,88,20
1324,164,2,421,3,2333,0,30
1325,164,2,422,9,2342,0,90
1326,164,2,423,4,2346,0,40
1327,164,2,424,7,2353,0,70
1328,164,2,425,8,2361,332,80
1329,164,2,426,3,2364,25,30
1330,164,2,427,7,2371,60,70
1331,164,2,428,5,2376,0,50
1332,164,2,429,4,2380,89,40
1333,164,2,430,7,2387,63,70
1334,164,2,431,8,2395,81,80
1335,164,2,432,4,2399,35,40
1336,164,2,433,6,2405,0,60
1337,164,2,434,5,2410,116,50
1338,164,2,435,3,2413,38,30
1339,164,2,436,5,2418,0,50
1340,164,2,437,9,2427,149,90
1341,164,2,438,9,2436,0,90
1342,164,2,439,5,2441,118,50
1343,164,2,440,7,2448,0,70
1344,164,2,441,9,2457,0,90
1345,164,2,442,2,2459,162,20
1346,164,2,443,4,2463,0,40
1347,164,2,444,8,2471,0,80
1348,164,2,445,9,2480,230,90
1349,164,2,446,6,2486,43,60
1350,164,2,447,2,2488,27,20
1351,164,2,448,6,2494,0,60
1352,164,2,449,2,2496,80,20
1353,164,2,450,6,2502,71,60
1354,164,2,451,4,2506,0,40
1355,164,2,452,2,2508,67,20
1356,164,2,453,8,2516,0,80
1357,164,2,454,3,2519,115,30
1358,164,2,455,5,2524,56,50
1359,164,2,456,8,2532,0,80
1360,164,2,457,6,2538,130,60
1361,164,2,458,8,2546,0,80
1362,164,2,459,3,2549,0,30
1363,164,2,460,3,2552,0,30
1364,164,2,461,7,2559,209,70
1365,164,2,462,6,2565,60,60
1366,164,2,463,7,2572,65,70
1367,164,2,464,4,2576,0,40
1368,164,2,465,6,2582,0,60
1369,164,2,466,3,2585,148,30
1370,164,2,467,5,2590,48,50
1371,164,2,468,2,2592,22,20
1372,164,2,469,4,2596,50,40
1373,164,2,470,8,2604,89,80
1374,164,2,471,7,2611,68,70
1375,164,2,472,9,2620,91,90
1376,164,2,473,8,2628,0,80
1377,164,2,474,9,2637,0,90
1378,164,2,475,3,2640,221,30
1379,164,2,476,2,2642,0,20
1380,164,2,477,2,2644,39,20
1381,164,2,478,6,2650,0,60
1382,164,2,479,5,2655,0,50
1383,164,2,480,5,2660,146,50
1384,164,2,481,4,2664,38,40
1385,164,2,482,3,2667,27,30
1386,164,2,483,5,2672,0,50
1387,164,2,484,5,2677,98,50
1388,164,2,485,8,2685,0,80
1389,164,2,486,8,2693,171,80
1390,164,2,487,6,2699,50,60
1391,164,2,488,8,2707,0,80
1392,164,2,489,4,2711,135,40
1393,164,2,490,2,2713,0,20
1394,164,2,491,5,2718,64,50
1395,164,2,492,8,2726,0,80
1396,164,2,493,6,2732,143,60
1397,164,2,494,3,2735,0,30
1398,164,2,495,7,2742,103,70
1399,164,2,496,3,2745,0,30
1400,164,2,497,7,2752,0,70
1401,164,2,498,4,2756,122,40
1402,164,2,499,6,2762,0,60
1403,164,2,500,7,2769,115,70
1404,164,2,501,5,2774,47,50
1405,164,2,502,9,2783,81,90
1406,164,2,503,4,2787,51,40
1407,164,2,504,6,2793,0,60
1408,164,2,505,2,2795,89,20
1409,164,2,506,4,2799,45,40
1410,164,2,507,3,2802,26,30
1411,164,2,508,7,2809,0,70
1412,164,2,509,3,2812,109,30
1413,164,2,510,7,2819,74,70
1414,164,2,511,4,2823,45,40
1415,164,2,512,4,2827,35,40
1416,164,2,513,8,2835,91,80
1417,164,2,514,7,2842,65,70
1418,164,2,515,8,2850,87,80
1419,164,2,516,4,2854,32,40
1420,164,2,517,5,2859,49,50
1421,164,2,518,8,2867,0,80
1422,164,2,519,5,2872,136,50
1423,164,2,520,3,2875,0,30
1424,164,2,521,6,2881,89,60
1425,164,2,522,6,2887,57,60
1426,164,2,523,3,2890,0,30
1427,164,2,524,9,2899,0,90
1428,164,2,525,2,2901,154,20
1429,164,2,526,7,2908,66,70
1430,164,2,527,6,2914,0,60
1431,164,2,528,6,2920,0,60
1432,164,2,529,6,2926,187,60
1433,164,2,530,9,2935,93,90
1434,164,2,531,7,2942,0,70
1435,164,2,532,5,2947,134,50
1436,164,2,533,7,2954,0,70
1437,164,2,534,5,2959,135,50
1438,164,2,535,2,2961,0,20
1439,164,2,536,3,2964,0,30
1440,164,2,537,9,2973,118,90
1441,164,2,538,5,2978,0,50
1442,164,2,539,3,2981,86,30
1443,164,2,540,4,2985,0,40
1444,164,2,541,8,2993,0,80
1445,164,2,542,6,2999,0,60
1446,164,2,543,5,3004,198,50
1447,164,2,544,5,3009,48,50
1448,164,2,545,7,3016,82,70
1449,164,2,546,8,3024,0,80
1450,164,2,547,8,3032,0,80
1451,164,2,548,8,3040,234,80
1452,164,2,549,8,3048,0,80
1453,164,2,550,8,3056,0,80
1454,164,2,551,4,3060,205,40
1455,164,2,552,6,3066,0,60
1456,164,2,553,2,3068,77,20
1457,164,2,554,2,3070,0,20
1458,164,2,555,8,3078,0,80
1459,164,2,556,6,3084,0,60
1460,164,2,557,8,3092,210,80
1461,164,2,558,6,3098,0,60
1462,164,2,559,6,3104,121,60
1463,164,2,560,5,3109,0,50
1464,164,2,561,9,3118,0,90
1465,164,2,562,5,3123,171,50
1466,164,2,563,3,3126,30,30
1467,164,2,564,4,3130,35,40
1468,164,2,565,4,3134,42,40
1469,164,2,566,5,3139,40,50
1470,164,2,567,8,3147,0,80
1471,164,2,568,6,3153,150,60
1472,164,2,569,4,3157,42,40
1473,164,2,570,5,3162,49,50
1474,164,2,571,9,3171,83,90
1475,164,2,572,8,3179,95,80
1476,164,2,573,7,3186,74,70
1477,164,2,574,2,3188,20,20
1478,164,2,575,6,3194,59,60
1479,164,2,576,9,3203,0,90
1480,164,2,577,6,3209,0,60
1481,164,2,578,5,3214,176,50
1482,164,2,579,9,3223,82,90
1483,164,2,580,9,3232,87,90
1484,164,2,581,3,3235,0,30
1485,164,2,582,4,3239,63,40
1486,164,2,583,8,3247,73,80
1487,164,2,584,4,3251,38,40
1488,164,2,585,2,3253,15,20
1489,164,2,586,7,3260,66,70
1490,164,2,587,4,3264,37,40
1491,164,2,588,7,3271,67,70
1492,164,2,589,8,3279,0,80
1493,164,2,590,2,3281,0,20
1494,164,2,591,8,3289,177,80
1495,164,2,592,4,3293,32,40
1496,164,2,593,2,3295,16,20
1497,164,2,594,5,3300,0,50
1498,164,2,595,9,3309,128,90
1499,164,2,596,9,3318,0,90
1500,164,2,597,9,3327,0,90
1501,164,2,598,9,3336,0,90
1502,164,2,599,5,3341,328,50
1503,164,2,600,3,3344,0,30
1504,164,2,601,3,3347,0,30
1505,164,2,602,8,3355,154,80
1506,164,2,603,6,3361,0,60
1507,164,2,604,9,3370,150,90
1508,164,2,605,3,3373,0,30
1509,164,2,606,3,3376,0,30
1510,164,2,607,5,3381,106,50
1511,164,2,608,4,3385,0,40
1512,164,2,609,9,3394,0,90
1513,164,2,610,6,3400,174,60
1514,164,2,611,6,3406,50,60
1515,164,2,612,2,3408,26,20
1516,164,2,613,7,3415,0,70
1517,164,2,614,4,3419,111,40
1518,164,2,615,5,3424,0,50
1519,164,2,616,8,3432,123,80
1520,164,2,617,7,3439,66,70
1521,164,2,618,3,3442,24,30
1522,164,2,619,2,3444,16,20
1523,164,2,620,2,3446,0,20
1524,164,2,621,7,3453,94,70
1525,164,2,622,5,3458,39,50
1526,164,2,623,5,3463,57,50
1527,164,2,624,5,3468,43,50
1528,164,2,625,9,3477,86,90
1529,164,2,626,2,3479,14,20
1530,164,2,627,8,3487,0,80
1531,164,2,628,3,3490,0,30
1532,164,2,629,9,3499,194,90
1533,164,2,630,6,3505,57,60
1534,164,2,631,9,3514,97,90
1535,164,2,632,6,3520,62,60
1536,164,2,633,4,3524,33,40
1537,164,2,634,6,3530,68,60
1538,164,2,635,8,3538,92,80
1539,164,2,636,8,3546,85,80
1540,164,2,637,8,3554,0,80
1541,164,2,638,3,3557,87,30
1542,164,2,639,6,3563,0,60
1543,164,2,640,4,3567,89,40
1544,164,2,641,5,3572,0,50
1545,164,2,642,6,3578,0,60
1546,164,2,643,3,3581,138,30
1547,164,2,644,6,3587,0,60
1548,164,2,645,8,3595,0,80
1549,164,2,646,6,3601,0,60
1550,164,2,647,4,3605,236,40
1551,164,2,648,3,3608,28,30
1552,164,2,649,8,3616,0,80
1553,164,2,650,6,3622,0,60
1554,164,2,651,7,3629,210,70
1555,164,2,652,5,3634,0,50
1556,164,2,653,8,3642,135,80
1557,164,2,654,5,3647,60,50
1558,164,2,655,2,3649,18,20
1559,164,2,656,9,3658,0,90
1560,164,2,657,5,3663,0,50
1561,164,2,658,3,3666,174,30
1562,164,2,659,7,3673,0,70
1563,164,2,660,8,3681,139,80
1564,164,2,661,5,3686,50,50
1565,164,2,662,4,3690,35,40
1566,164,2,663,7,3697,60,70
1567,164,2,664,6,3703,62,60
1568,164,2,665,5,3708,46,50
1569,164,2,666,6,3714,74,60
1570,164,2,667,8,3722,0,80
1571,164,2,668,5,3727,0,50
1572,164,2,669,7,3734,219,70
1573,164,2,670,7,3741,74,70
1574,164,2,671,6,3747,0,60
1575,164,2,672,6,3753,118,60
1576,164,2,673,9,3762,77,90
1577,164,2,674,7,3769,0,70
1578,164,2,675,8,3777,0,80
1579,164,2,676,3,3780,168,30
1580,164,2,677,8,3788,86,80
1581,164,2,678,2,3790,0,20
1582,164,2,679,6,3796,71,60
1583,164,2,680,4,3800,0,40
1584,164,2,681,2,3802,68,20
1585,164,2,682,3,3805,0,30
1586,164,2,683,2,3807,53,20
1587,164,2,684,4,3811,0,40
1588,164,2,685,8,3819,143,80
1589,164,2,686,5,3824,50,50
1590,164,2,687,3,3827,0,30
1591,164,2,688,2,3829,0,20
1592,164,2,689,8,3837,131,80
1593,164,2,690,5,3842,0,50
1594,164,2,691,3,3845,0,30
1595,164,2,692,5,3850,0,50
1596,164,2,693,4,3854,156,40
1597,164,2,694,7,3861,0,70
1598,164,2,695,9,3870,150,90
1599,164,2,696,5,3875,48,50
1600,164,2,697,9,3884,0,90
1601,164,2,698,5,3889,148,50
1602,164,2,699,9,3898,0,90
1603,164,2,700,8,3906,0,80
1604,164,2,701,5,3911,221,50
1605,164,2,702,5,3916,0,50
1606,164,2,703,3,3919,68,30
1607,164,2,704,8,3927,68,80
1608,164,2,705,2,3929,21,20
1609,164,2,706,6,3935,0,60
1610,164,2,707,3,3938,95,30
1611,164,2,708,8,3946,86,80
1612,164,2,709,3,3949,0,30
1613,164,2,710,9,3958,0,90
1614,164,2,711,7,3965,0,70
1615,164,2,712,8,3973,274,80
1616,164,2,713,2,3975,16,20
1617,164,2,714,4,3979,0,40
1618,164,2,715,4,3983,0,40
1619,164,2,716,6,3989,0,60
1620,164,2,717,3,3992,0,30
1621,164,2,718,7,3999,0,70
1622,164,2,719,6,4005,0,60
1623,164,2,720,4,4009,323,40
1624,164,2,721,3,4012,36,30
1625,164,2,722,6,4018,75,60
1626,164,2,723,8,4026,76,80
1627,164,2,724,2,4028,0,20
1628,164,2,725,6,4034,89,60
1629,164,2,726,9,4043,0,90
1630,164,2,727,2,4045,112,20
1631,164,2,728,9,4054,0,90
1632,164,2,729,5,4059,0,50
1633,164,2,730,3,4062,162,30
1634,164,2,731,4,4066,41,40
1635,164,2,732,5,4071,0,50
1636,164,2,733,7,4078,123,70
1637,164,2,734,6,4084,67,60
1638,164,2,735,6,4090,46,60
1639,164,2,736,9,4099,0,90
1640,164,2,737,5,4104,0,50
1641,164,2,738,5,4109,0,50
1642,164,2,739,7,4116,0,70
1643,164,2,740,3,4119,278,30
1644,164,2,741,9,4128,93,90
1645,164,2,742,8,4136,93,80
1646,164,2,743,9,4145,0,90
1647,164,2,744,5,4150,140,50
1648,164,2,745,9,4159,99,90
1649,164,2,746,2,4161,21,20
1650,164,2,747,2,4163,0,20
1651,164,2,748,5,4168,68,50
1652,164,2,749,6,4174,58,60
1653,164,2,750,6,4180,51,60
1654,164,2,751,6,4186,59,60
1655,164,2,752,2,4188,0,20
1656,164,2,753,8,4196,111,80
1657,164,2,754,8,4204,89,80
1658,164,2,755,6,4210,0,60
1659,164,2,756,4,4214,104,40
1660,164,2,757,7,4221,68,70
1661,164,2,758,7,4228,73,70
1662,164,2,759,9,4237,0,90
1663,164,2,760,5,4242,0,50
1664,164,2,761,7,4249,0,70
1665,164,2,762,6,4255,0,60
1666,164,2,763,6,4261,373,60
1667,164,2,764,8,4269,0,80
1668,164,2,765,3,4272,0,30
1669,164,2,766,2,4274,0,20
1670,164,2,767,5,4279,173,50
1671,164,2,768,6,4285,69,60
1672,164,2,769,8,4293,0,80
1673,164,2,770,5,4298,0,50
1674,164,2,771,5,4303,0,50
1675,164,2,772,2,4305,0,20
1676,164,2,773,8,4313,0,80
1677,164,2,774,5,4318,341,50
1678,164,2,775,9,4327,0,90
1679,164,2,776,6,4333,0,60
1680,164,2,777,6,4339,0,60
1681,164,2,778,6,4345,262,60
1682,164,2,779,6,4351,62,60
1683,164,2,780,8,4359,88,80
1684,164,2,781,2,4361,15,20
1685,164,2,782,9,4370,0,90
1686,164,2,783,8,4378,166,80
1687,164,2,784,3,4381,26,30
1688,164,2,785,8,4389,0,80
1689,164,2,786,7,4396,0,70
1690,164,2,787,6,4402,184,60
1691,164,2,788,8,4410,0,80
1692,164,2,789,7,4417,0,70
1693,164,2,790,8,4425,0,80
1694,164,2,791,8,4433,0,80
1695,164,2,792,4,4437,0,40
1696,164,2,793,7,4444,0,70
1697,164,2,794,4,4448,439,40
1698,164,2,795,4,4452,0,40
1699,164,2,796,4,4456,0,40
1700,164,2,797,3,4459,100,30
1701,164,2,798,4,4463,50,40
1702,164,2,799,7,4470,0,70
1703,164,2,800,8,4478,141,80
1704,164,2,801,7,4485,61,70
1705,164,2,802,6,4491,48,60
1706,164,2,803,6,4497,0,60
1707,164,2,804,2,4499,68,20
1708,164,2,805,8,4507,72,80
1709,164,2,806,5,4512,54,50
1710,164,2,807,5,4517,48,50
1711,164,2,808,8,4525,0,80
1712,164,2,809,6,4531,0,60
1713,164,2,810,8,4539,188,80
1714,164,2,811,8,4547,0,80
1715,164,2,812,5,4552,0,50
1716,164,2,813,2,4554,149,20
1717,164,2,814,6,4560,0,60
1718,164,2,815,8,4568,125,80
1719,164,2,816,4,4572,40,40
1720,164,2,817,7,4579,0,70
1721,164,2,818,2,4581,0,20
1722,164,2,819,5,4586,0,50
1723,164,2,820,5,4591,196,50
1724,164,2,821,8,4599,0,80
1725,164,2,822,8,4607,0,80
1726,164,2,823,7,4614,275,70
1727,164,2,824,3,4617,35,30
1728,164,2,825,2,4619,18,20
1729,164,2,826,7,4626,0,70
1730,164,2,827,5,4631,119,50
1731,164,2,828,5,4636,0,50
1732,164,2,829,3,4639,0,30
1733,164,2,830,2,4641,0,20
1734,164,2,831,5,4646,157,50
1735,164,2,832,6,4652,54,60
1736,164,2,833,4,4656,0,40
1737,164,2,834,2,4658,0,20
1738,164,2,835,6,4664,118,60
1739,164,2,836,9,4673,73,90
1740,164,2,837,6,4679,65,60
1741,164,2,838,8,4687,0,80
1742,164,2,839,4,4691,111,40
1743,164,2,840,9,4700,84,90
1744,164,2,841,6,4706,59,60
1745,164,2,842,4,4710,44,40
1746,164,2,843,8,4718,70,80
1747,164,2,844,2,4720,22,20
1748,164,2,845,8,4728,0,80
1749,164,2,846,3,4731,0,30
1750,164,2,847,2,4733,126,20
1751,164,2,848,6,4739,0,60
1752,164,2,849,8,4747,130,80
1753,164,2,850,9,4756,97,90
1754,164,2,851,9,4765,0,90
1755,164,2,852,8,4773,0,80
1756,164,2,853,7,4780,0,70
1757,164,2,854,3,4783,274,30
1758,164,2,855,6,4789,59,60
1759,164,2,856,6,4795,66,60
1760,164,2,857,5,4800,44,50
1761,164,2,858,4,4804,0,40
1762,164,2,859,6,4810,69,60
1763,164,2,860,4,4814,0,40
1764,164,2,861,9,4823,141,90
1765,164,2,862,6,4829,51,60
1766,164,2,863,6,4835,69,60
1767,164,2,864,4,4839,0,40
1768,164,2,865,4,4843,87,40
1769,164,2,866,6,4849,67,60
1770,164,2,867,5,4854,63,50
1771,164,2,868,9,4863,0,90
1772,164,2,869,4,4867,136,40
1773,164,2,870,3,4870,29,30
1774,164,2,871,3,4873,0,30
1775,164,2,872,3,4876,0,30
1776,164,2,873,2,4878,0,20
1777,164,2,874,2,4880,102,20
1778,164,2,875,2,4882,22,20
1779,164,2,876,8,4890,73,80
1780,164,2,877,4,4894,53,40
1781,164,2,878,2,4896,0,20
1782,164,2,879,2,4898,0,20
1783,164,2,880,9,4907,0,90
1784,164,2,881,9,4916,0,90
1785,164,2,882,4,4920,257,40
1786,164,2,883,5,4925,0,50
1787,164,2,884,4,4929,81,40
1788,164,2,885,6,4935,54,60
1789,164,2,886,4,4939,47,40
1790,164,2,887,9,4948,0,90
1791,164,2,888,5,4953,142,50
1792,164,2,889,5,4958,49,50
1793,164,2,890,4,4962,0,40
1794,164,2,891,2,4964,0,20
1795,164,2,892,6,4970,0,60
1796,164,2,893,2,4972,0,20
1797,164,2,894,8,4980,0,80
1798,164,2,895,5,4985,254,50
1799,164,2,896,6,4991,54,60
1800,164,3,1,3,3,0,30
1801,164,3,2,7,10,0,70
1802,164,3,3,6,16,143,60
1803,164,3,4,3,19,0,30
1804,164,3,5,2,21,48,20
1805,164,3,6,4,25,0,40
1806,164,3,7,3,28,68,30
1807,164,3,8,9,37,0,90
1808,164,3,9,8,45,0,80
1809,164,3,10,9,54,0,90
1810,164,3,11,6,60,335,60
1811,164,3,12,7,67,0,70
1812,164,3,13,7,74,139,70
1813,164,3,14,3,77,0,30
1814,164,3,15,3,80,0,30
1815,164,3,16,2,82,76,20
1816,164,3,17,2,84,28,20
1817,164,3,18,9,93,107,90
1818,164,3,19,3,96,27,30
1819,164,3,20,2,98,17,20
1820,164,3,21,7,105,62,70
1821,164,3,22,2,107,0,20
1822,164,3,23,9,116,0,90
1823,164,3,24,3,119,132,30
1824,164,3,25,6,125,0,60
1825,164,3,26,3,128,0,30
1826,164,3,27,4,132,120,40
1827,164,3,28,9,141,92,90
1828,164,3,29,3,144,28,30
1829,164,3,30,9,153,82,90
1830,164,3,31,5,158,0,50
1831,164,3,32,4,162,111,40
1832,164,3,33,5,167,0,50
1833,164,3,34,2,169,93,20
1834,164,3,35,6,175,74,60
1835,164,3,36,2,177,0,20
1836,164,3,37,9,186,0,90
1837,164,3,38,6,192,0,60
1838,164,3,39,5,197,211,50
1839,164,3,40,9,206,0,90
1840,164,3,41,4,210,0,40
1841,164,3,42,7,217,0,70
1842,164,3,43,2,219,241,20
1843,164,3,44,5,224,44,50
1844,164,3,45,9,233,91,90
1845,164,3,46,3,236,31,30
1846,164,3,47,3,239,0,30
1847,164,3,48,2,241,55,20
1848,164,3,49,3,244,0,30
1849,164,3,50,3,247,65,30
1850,164,3,51,9,256,93,90
1851,164,3,52,3,259,24,30
1852,164,3,53,6,265,0,60
1853,164,3,54,3,268,96,30
1854,164,3,55,6,274,0,60
1855,164,3,56,8,282,134,80
1856,164,3,57,4,286,0,40
1857,164,3,58,6,292,0,60
1858,164,3,59,5,297,153,50
1859,164,3,60,5,302,41,50
1860,164,3,61,7,309,79,70
1861,164,3,62,9,318,77,90
1862,164,3,63,3,321,36,30
1863,164,3,64,4,325,31,40
1864,164,3,65,9,334,87,90
1865,164,3,66,6,340,0,60
1866,164,3,67,5,345,109,50
1867,164,3,68,8,353,81,80
1868,164,3,69,6,359,0,60
1869,164,3,70,3,362,85,30
1870,164,3,71,6,368,51,60
1871,164,3,72,8,376,0,80
1872,164,3,73,4,380,111,40
1873,164,3,74,7,387,60,70
1874,164,3,75,8,395,80,80
1875,164,3,76,8,403,0,80
1876,164,3,77,9,412,197,90
1877,164,3,78,8,420,0,80
1878,164,3,79,9,429,0,90
1879,164,3,80,7,436,0,70
1880,164,3,81,4,440,0,40
1881,164,3,82,2,442,321,20
1882,164,3,83,9,451,75,90
1883,164,3,84,8,459,74,80
1884,164,3,85,2,461,0,20
1885,164,3,86,8,469,105,80
1886,164,3,87,6,475,0,60
1887,164,3,88,6,481,126,60
1888,164,3,89,9,490,0,90
1889,164,3,90,4,494,0,40
1890,164,3,91,7,501,185,70
1891,164,3,92,6,507,49,60
1892,164,3,93,3,510,0,30
1893,164,3,94,9,519,112,90
1894,164,3,95,5,524,0,50
1895,164,3,96,3,527,90,30
1896,164,3,97,4,531,31,40
1897,164,3,98,8,539,0,80
1898,164,3,99,2,541,116,20
1899,164,3,100,6,547,0,60
1900,164,3,101,2,549,63,20
1901,164,3,102,7,556,75,70
1902,164,3,103,7,563,65,70
1903,164,3,104,9,572,96,90
1904,164,3,105,2,574,0,20
1905,164,3,106,5,579,66,50
1906,164,3,107,8,587,82,80
1907,164,3,108,6,593,64,60
1908,164,3,109,7,600,0,70
1909,164,3,110,7,607,145,70
1910,164,3,111,8,615,67,80
1911,164,3,112,5,620,57,50
1912,164,3,113,7,627,0,70
1913,164,3,114,7,634,138,70
1914,164,3,115,3,637,23,30
1915,164,3,116,5,642,0,50
1916,164,3,117,8,650,0,80
1917,164,3,118,7,657,0,70
1918,164,3,119,2,659,222,20
1919,164,3,120,8,667,0,80
1920,164,3,121,4,671,113,40
1921,164,3,122,7,678,64,70
1922,164,3,123,4,682,43,40
1923,164,3,124,7,689,0,70
1924,164,3,125,9,698,155,90
1925,164,3,126,4,702,33,40
1926,164,3,127,2,704,0,20
1927,164,3,128,8,712,0,80
1928,164,3,129,3,715,0,30
1929,164,3,130,6,721,194,60
1930,164,3,131,4,725,54,40
1931,164,3,132,5,730,47,50
1932,164,3,133,3,733,0,30
1933,164,3,134,8,741,0,80
1934,164,3,135,5,746,133,50
1935,164,3,136,3,749,0,30
1936,164,3,137,2,751,51,20
1937,164,3,138,3,754,41,30
1938,164,3,139,9,763,0,90
1939,164,3,140,7,770,175,70
1940,164,3,141,7,777,0,70
1941,164,3,142,4,781,0,40
1942,164,3,143,9,790,207,90
1943,164,3,144,5,795,66,50
1944,164,3,145,9,804,0,90
1945,164,3,146,9,813,161,90
1946,164,3,147,3,816,0,30
1947,164,3,148,8,824,124,80
1948,164,3,149,2,826,21,20
1949,164,3,150,8,834,107,80
1950,164,3,151,3,837,40,30
1951,164,3,152,7,844,75,70
1952,164,3,153,6,850,58,60
1953,164,3,154,3,853,0,30
1954,164,3,155,4,857,0,40
1955,164,3,156,9,866,0,90
1956,164,3,157,8,874,223,80
1957,164,3,158,5,879,0,50
1958,164,3,159,5,884,0,50
1959,164,3,160,3,887,0,30
1960,164,3,161,7,894,0,70
1961,164,3,162,2,896,230,20
1962,164,3,163,2,898,0,20
1963,164,3,164,2,900,0,20
1964,164,3,165,9,909,128,90
1965,164,3,166,3,912,29,30
1966,164,3,167,3,915,38,30
1967,164,3,168,7,922,69,70
1968,164,3,169,8,930,0,80
1969,164,3,170,9,939,171,90
1970,164,3,171,5,944,52,50
1971,164,3,172,7,951,53,70
1972,164,3,173,8,959,0,80
1973,164,3,174,4,963,117,40
1974,164,3,175,8,971,88,80
1975,164,3,176,5,976,53,50
1976,164,3,177,9,985,89,90
1977,164,3,178,3,988,24,30
1978,164,3,179,8,996,0,80
1979,164,3,180,6,1002,130,60
1980,164,3,181,8,1010,68,80
1981,164,3,182,8,1018,84,80
1982,164,3,183,4,1022,46,40
1983,164,3,184,2,1024,0,20
1984,164,3,185,8,1032,0,80
1985,164,3,186,3,1035,134,30
1986,164,3,187,4,1039,0,40
1987,164,3,188,9,1048,141,90
1988,164,3,189,8,1056,0,80
1989,164,3,190,4,1060,118,40
1990,164,3,191,9,1069,0,90
1991,164,3,192,8,1077,0,80
1992,164,3,193,4,1081,0,40
1993,164,3,194,5,1086,0,50
1994,164,3,195,5,1091,0,50
1995,164,3,196,6,1097,0,60
1996,164,3,197,4,1101,370,40
1997,164,3,198,3,1104,29,30
1998,164,3,199,3,1107,31,30
1999,164,3,200,7,1114,70,70
2000,164,3,201,4,1118,47,40
2001,164,3,202,5,1123,0,50
2002,164,3,203,9,1132,152,90
2003,164,3,204,4,1136,0,40
2004,164,3,205,4,1140,66,40
2005,164,3,206,2,1142,22,20
2006,164,3,207,3,1145,41,30
2007,164,3,208,2,1147,0,20
2008,164,3,209,3,1150,48,30
2009,164,3,210,5,1155,49,50
2010,164,3,211,8,1163,76,80
2011,164,3,212,3,1166,28,30
2012,164,3,213,2,1168,10,20
2013,164,3,214,4,1172,0,40
2014,164,3,215,2,1174,57,20
2015,164,3,216,9,1183,0,90
2016,164,3,217,4,1187,123,40
2017,164,3,218,4,1191,41,40
2018,164,3,219,6,1197,0,60
2019,164,3,220,2,1199,0,20
2020,164,3,221,8,1207,0,80
2021,164,3,222,8,1215,0,80
2022,164,3,223,2,1217,264,20
2023,164,3,224,4,1221,0,40
2024,164,3,225,7,1228,117,70
2025,164,3,226,5,1233,0,50
2026,164,3,227,9,1242,129,90
2027,164,3,228,5,1247,0,50
2028,164,3,229,3,1250,73,30
2029,164,3,230,5,1255,55,50
2030,164,3,231,9,1264,0,90
2031,164,3,232,4,1268,0,40
2032,164,3,233,4,1272,0,40
2033,164,3,234,8,1280,248,80
2034,164,3,235,2,1282,26,20
2035,164,3,236,6,1288,65,60
2036,164,3,237,2,1290,0,20
2037,164,3,238,3,1293,0,30
2038,164,3,239,9,1302,134,90
2039,164,3,240,7,1309,0,70
2040,164,3,241,8,1317,0,80
2041,164,3,242,9,1326,243,90
2042,164,3,243,6,1332,61,60
2043,164,3,244,5,1337,40,50
2044,164,3,245,8,1345,83,80
2045,164,3,246,4,1349,38,40
2046,164,3,247,7,1356,0,70
2047,164,3,248,2,1358,98,20
2048,164,3,249,5,1363,44,50
2049,164,3,250,5,1368,65,50
2050,164,3,251,2,1370,21,20
2051,164,3,252,4,1374,40,40
2052,164,3,253,2,1376,17,20
2053,164,3,254,2,1378,0,20
2054,164,3,255,2,1380,50,20
2055,164,3,256,9,1389,95,90
2056,164,3,257,4,1393,42,40
2057,164,3,258,9,1402,0,90
2058,164,3,259,7,1409,188,70
2059,164,3,260,9,1418,91,90
2060,164,3,261,4,1422,55,40
2061,164,3,262,3,1425,27,30
2062,164,3,263,8,1433,81,80
2063,164,3,264,6,1439,68,60
2064,164,3,265,5,1444,52,50
2065,164,3,266,4,1448,49,40
2066,164,3,267,4,1452,37,40
2067,164,3,268,9,1461,0,90
2068,164,3,269,8,1469,0,80
2069,164,3,270,5,1474,0,50
2070,164,3,271,2,1476,0,20
2071,164,3,272,7,1483,294,70
2072,164,3,273,6,1489,0,60
2073,164,3,274,5,1494,125,50
2074,164,3,275,4,1498,0,40
2075,164,3,276,7,1505,104,70
2076,164,3,277,6,1511,0,60
2077,164,3,278,9,1520,0,90
2078,164,3,279,9,1529,0,90
2079,164,3,280,2,1531,256,20
2080,164,3,281,2,1533,25,20
2081,164,3,282,5,1538,56,50
2082,164,3,283,7,1545,95,70
2083,164,3,284,7,1552,74,70
2084,164,3,285,2,1554,0,20
2085,164,3,286,4,1558,0,40
2086,164,3,287,9,1567,0,90
2087,164,3,288,9,1576,245,90
2088,164,3,289,3,1579,34,30
2089,164,3,290,7,1586,0,70
2090,164,3,291,6,1592,0,60
2091,164,3,292,7,1599,0,70
2092,164,3,293,4,1603,242,40
2093,164,3,294,5,1608,0,50
2094,164,3,295,9,1617,123,90
2095,164,3,296,6,1623,55,60
2096,164,3,297,5,1628,0,50
2097,164,3,298,2,1630,0,20
2098,164,3,299,9,1639,154,90
2099,164,3,300,8,1647,0,80
2100,164,3,301,4,1651,124,40
2101,164,3,302,8,1659,82,80
2102,164,3,303,2,1661,0,20
2103,164,3,304,9,1670,114,90
2104,164,3,305,7,1677,79,70
2105,164,3,306,2,1679,19,20
2106,164,3,307,8,1687,0,80
2107,164,3,308,8,1695,147,80
2108,164,3,309,8,1703,0,80
2109,164,3,310,5,1708,0,50
2110,164,3,311,2,1710,132,20
2111,164,3,312,9,1719,96,90
2112,164,3,313,7,1726,70,70
2113,164,3,314,9,1735,69,90
2114,164,3,315,3,1738,34,30
2115,164,3,316,8,1746,86,80
2116,164,3,317,8,1754,79,80
2117,164,3,318,2,1756,17,20
2118,164,3,319,8,1764,81,80
2119,164,3,320,3,1767,24,30
2120,164,3,321,4,1771,37,40
2121,164,3,322,4,1775,38,40
2122,164,3,323,2,1777,0,20
2123,164,3,324,5,1782,0,50
2124,164,3,325,8,1790,167,80
2125,164,3,326,5,1795,0,50
2126,164,3,327,5,1800,0,50
2127,164,3,328,9,1809,0,90
2128,164,3,329,7,1816,258,70
2129,164,3,330,9,1825,103,90
2130,164,3,331,8,1833,84,80
2131,164,3,332,6,1839,0,60
2132,164,3,333,6,1845,117,60
2133,164,3,334,2,1847,0,20
2134,164,3,335,8,1855,90,80
2135,164,3,336,4,1859,39,40
2136,164,3,337,4,1863,38,40
2137,164,3,338,2,1865,10,20
2138,164,3,339,3,1868,40,30
2139,164,3,340,4,1872,41,40
2140,164,3,341,7,1879,58,70
2141,164,3,342,3,1882,32,30
2142,164,3,343,2,1884,18,20
2143,164,3,344,9,1893,0,90
2144,164,3,345,4,1897,0,40
2145,164,3,346,7,1904,219,70
2146,164,3,347,6,1910,0,60
2147,164,3,348,2,1912,75,20
2148,164,3,349,5,1917,0,50
2149,164,3,350,4,1921,0,40
2150,164,3,351,3,1924,111,30
2151,164,3,352,3,1927,0,30
2152,164,3,353,7,1934,0,70
2153,164,3,354,6,1940,0,60
2154,164,3,355,2,1942,0,20
2155,164,3,356,2,1944,0,20
2156,164,3,357,8,1952,0,80
2157,164,3,358,2,1954,0,20
2158,164,3,359,2,1956,0,20
2159,164,3,360,2,1958,0,20
2160,164,3,361,2,1960,338,20
2161,164,3,362,3,1963,32,30
2162,164,3,363,7,1970,61,70
2163,164,3,364,2,1972,23,20
2164,164,3,365,6,1978,69,60
2165,164,3,366,4,1982,30,40
2166,164,3,367,9,1991,0,90
2167,164,3,368,3,1994,100,30
2168,164,3,369,8,2002,79,80
2169,164,3,370,6,2008,0,60
2170,164,3,371,7,2015,0,70
2171,164,3,372,5,2020,179,50
2172,164,3,373,8,2028,0,80
2173,164,3,374,6,2034,0,60
2174,164,3,375,6,2040,0,60
2175,164,3,376,4,2044,234,40
2176,164,3,377,5,2049,0,50
2177,164,3,378,8,2057,0,80
2178,164,3,379,8,2065,207,80
2179,164,3,380,7,2072,64,70
2180,164,3,381,2,2074,14,20
2181,164,3,382,4,2078,0,40
2182,164,3,383,7,2085,0,70
2183,164,3,384,4,2089,0,40
2184,164,3,385,6,2095,196,60
2185,164,3,386,5,2100,0,50
2186,164,3,387,2,2102,0,20
2187,164,3,388,7,2109,140,70
2188,164,3,389,4,2113,49,40
2189,164,3,390,6,2119,58,60
2190,164,3,391,2,2121,0,20
2191,164,3,392,5,2126,89,50
2192,164,3,393,8,2134,0,80
2193,164,3,394,5,2139,0,50
2194,164,3,395,6,2145,0,60
2195,164,3,396,5,2150,0,50
2196,164,3,397,9,2159,332,90
2197,164,3,398,3,2162,40,30
2198,164,3,399,9,2171,81,90
2199,164,3,400,8,2179,0,80
2200,164,3,401,5,2184,0,50
2201,164,3,402,9,2193,210,90
2202,164,3,403,9,2202,101,90
2203,164,3,404,4,2206,53,40
2204,164,3,405,7,2213,65,70
2205,164,3,406,4,2217,42,40
2206,164,3,407,9,2226,74,90
2207,164,3,408,4,2230,35,40
2208,164,3,409,8,2238,0,80
2209,164,3,410,5,2243,137,50
2210,164,3,411,9,2252,92,90
2211,164,3,412,8,2260,0,80
2212,164,3,413,8,2268,0,80
2213,164,3,414,5,2273,0,50
2214,164,3,415,6,2279,282,60
2215,164,3,416,8,2287,72,80
2216,164,3,417,4,2291,44,40
2217,164,3,418,3,2294,0,30
2218,164,3,419,6,2300,82,60
2219,164,3,420,6,2306,0,60
2220,164,3,421,7,2313,0,70
2221,164,3,422,6,2319,0,60
2222,164,3,423,6,2325,222,60
2223,164,3,424,3,2328,34,30
2224,164,3,425,9,2337,0,90
2225,164,3,426,9,2346,0,90
2226,164,3,427,3,2349,201,30
2227,164,3,428,7,2356,76,70
2228,164,3,429,2,2358,18,20
2229,164,3,430,2,2360,18,20
2230,164,3,431,9,2369,0,90
2231,164,3,432,4,2373,126,40
2232,164,3,433,4,2377,0,40
2233,164,3,434,8,2385,132,80
2234,164,3,435,7,2392,71,70
2235,164,3,436,3,2395,31,30
2236,164,3,437,9,2404,0,90
2237,164,3,438,4,2408,140,40
2238,164,3,439,9,2417,77,90
2239,164,3,440,2,2419,19,20
2240,164,3,441,6,2425,0,60
2241,164,3,442,8,2433,0,80
2242,164,3,443,8,2441,253,80
2243,164,3,444,6,2447,0,60
2244,164,3,445,6,2453,115,60
2245,164,3,446,4,2457,39,40
2246,164,3,447,5,2462,0,50
2247,164,3,448,8,2470,0,80
2248,164,3,449,2,2472,0,20
2249,164,3,450,6,2478,205,60
2250,164,3,451,7,2485,0,70
2251,164,3,452,9,2494,161,90
2252,164,3,453,2,2496,23,20
2253,164,3,454,4,2500,0,40
2254,164,3,455,3,2503,82,30
2255,164,3,456,8,2511,74,80
2256,164,3,457,8,2519,87,80
2257,164,3,458,9,2528,77,90
2258,164,3,459,4,2532,44,40
2259,164,3,460,5,2537,0,50
2260,164,3,461,2,2539,80,20
2261,164,3,462,9,2548,87,90
2262,164,3,463,8,2556,0,80
2263,164,3,464,3,2559,0,30
2264,164,3,465,7,2566,161,70
2265,164,3,466,9,2575,88,90
2266,164,3,467,5,2580,0,50
2267,164,3,468,4,2584,91,40
2268,164,3,469,2,2586,15,20
2269,164,3,470,3,2589,0,30
2270,164,3,471,4,2593,68,40
2271,164,3,472,9,2602,111,90
2272,164,3,473,9,2611,98,90
2273,164,3,474,8,2619,102,80
2274,164,3,475,5,2624,46,50
2275,164,3,476,2,2626,0,20
2276,164,3,477,5,2631,0,50
2277,164,3,478,7,2638,135,70
2278,164,3,479,5,2643,51,50
2279,164,3,480,6,2649,63,60
2280,164,3,481,2,2651,0,20
2281,164,3,482,8,2659,104,80
2282,164,3,483,9,2668,0,90
2283,164,3,484,4,2672,0,40
2284,164,3,485,6,2678,169,60
2285,164,3,486,2,2680,0,20
2286,164,3,487,8,2688,106,80
2287,164,3,488,4,2692,43,40
2288,164,3,489,9,2701,88,90
2289,164,3,490,3,2704,29,30
2290,164,3,491,6,2710,0,60
2291,164,3,492,5,2715,120,50
2292,164,3,493,2,2717,0,20
2293,164,3,494,9,2726,126,90
2294,164,3,495,5,2731,0,50
2295,164,3,496,2,2733,62,20
2296,164,3,497,4,2737,42,40
2297,164,3,498,8,2745,77,80
2298,164,3,499,8,2753,74,80
2299,164,3,500,5,2758,0,50
2300,164,3,501,8,2766,127,80
2301,164,3,502,3,2769,26,30
2302,164,3,503,3,2772,30,30
2303,164,3,504,8,2780,0,80
2304,164,3,505,8,2788,0,80
2305,164,3,506,2,2790,0,20
2306,164,3,507,9,2799,0,90
2307,164,3,508,8,2807,365,80
2308,164,3,509,3,2810,0,30
2309,164,3,510,5,2815,90,50
2310,164,3,511,9,2824,75,90
2311,164,3,512,3,2827,0,30
2312,164,3,513,8,2835,98,80
2313,164,3,514,3,2838,0,30
2314,164,3,515,9,2847,0,90
2315,164,3,516,7,2854,208,70
2316,164,3,517,6,2860,0,60
2317,164,3,518,4,2864,107,40
2318,164,3,519,5,2869,0,50
2319,164,3,520,7,2876,115,70
2320,164,3,521,3,2879,26,30
2321,164,3,522,5,2884,0,50
2322,164,3,523,7,2891,110,70
2323,164,3,524,3,2894,33,30
2324,164,3,525,3,2897,0,30
2325,164,3,526,9,2906,135,90
2326,164,3,527,6,2912,0,60
2327,164,3,528,2,2914,90,20
2328,164,3,529,4,2918,0,40
2329,164,3,530,6,2924,90,60
2330,164,3,531,6,2930,65,60
2331,164,3,532,5,2935,0,50
2332,164,3,533,5,2940,94,50
2333,164,3,534,3,2943,0,30
2334,164,3,535,2,2945,47,20
2335,164,3,536,6,2951,0,60
2336,164,3,537,8,2959,147,80
2337,164,3,538,9,2968,0,90
2338,164,3,539,9,2977,204,90
2339,164,3,540,6,2983,65,60
2340,164,3,541,2,2985,0,20
2341,164,3,542,3,2988,48,30
2342,164,3,543,4,2992,0,40
2343,164,3,544,5,2997,103,50
2344,164,3,545,4,3001,39,40
2345,164,3,546,6,3007,58,60
2346,164,3,547,7,3014,77,70
2347,164,3,548,7,3021,0,70
2348,164,3,549,5,3026,101,50
2349,164,3,550,3,3029,0,30
2350,164,3,551,3,3032,59,30
2351,164,3,552,9,3041,0,90
2352,164,3,553,8,3049,0,80
2353,164,3,554,8,3057,0,80
2354,164,3,555,4,3061,293,40
2355,164,3,556,6,3067,0,60
2356,164,3,557,4,3071,0,40
2357,164,3,558,9,3080,0,90
2358,164,3,559,6,3086,281,60
2359,164,3,560,4,3090,34,40
2360,164,3,561,7,3097,70,70
2361,164,3,562,3,3100,0,30
2362,164,3,563,4,3104,0,40
2363,164,3,564,8,3112,0,80
2364,164,3,565,7,3119,0,70
2365,164,3,566,4,3123,0,40
2366,164,3,567,8,3131,0,80
2367,164,3,568,8,3139,422,80
2368,164,3,569,6,3145,0,60
2369,164,3,570,3,3148,0,30
2370,164,3,571,9,3157,0,90
2371,164,3,572,6,3163,266,60
2372,164,3,573,8,3171,0,80
2373,164,3,574,3,3174,0,30
2374,164,3,575,9,3183,194,90
2375,164,3,576,4,3187,37,40
2376,164,3,577,2,3189,20,20
2377,164,3,578,3,3192,29,30
2378,164,3,579,9,3201,0,90
2379,164,3,580,8,3209,169,80
2380,164,3,581,7,3216,65,70
2381,164,3,582,3,3219,0,30
2382,164,3,583,4,3223,0,40
2383,164,3,584,3,3226,112,30
2384,164,3,585,5,3231,38,50
2385,164,3,586,5,3236,35,50
2386,164,3,587,3,3239,0,30
2387,164,3,588,4,3243,0,40
2388,164,3,589,2,3245,93,20
2389,164,3,590,5,3250,54,50
2390,164,3,591,9,3259,0,90
2391,164,3,592,4,3263,0,40
2392,164,3,593,7,3270,0,70
2393,164,3,594,7,3277,268,70
2394,164,3,595,2,3279,18,20
2395,164,3,596,6,3285,65,60
2396,164,3,597,5,3290,54,50
2397,164,3,598,8,3298,78,80
2398,164,3,599,2,3300,15,20
2399,164,3,600,6,3306,0,60
2400,164,3,601,9,3315,0,90
2401,164,3,602,8,3323,0,80
2402,164,3,603,8,3331,290,80
2403,164,3,604,2,3333,0,20
2404,164,3,605,7,3340,97,70
2405,164,3,606,7,3347,0,70
2406,164,3,607,5,3352,0,50
2407,164,3,608,2,3354,0,20
2408,164,3,609,2,3356,0,20
2409,164,3,610,5,3361,222,50
2410,164,3,611,6,3367,57,60
2411,164,3,612,6,3373,57,60
2412,164,3,613,5,3378,0,50
2413,164,3,614,8,3386,0,80
2414,164,3,615,5,3391,0,50
2415,164,3,616,3,3394,233,30
2416,164,3,617,8,3402,0,80
2417,164,3,618,4,3406,123,40
2418,164,3,619,5,3411,0,50
2419,164,3,620,3,3414,70,30
2420,164,3,621,8,3422,76,80
2421,164,3,622,8,3430,0,80
2422,164,3,623,8,3438,0,80
2423,164,3,624,3,3441,0,30
2424,164,3,625,6,3447,242,60
2425,164,3,626,8,3455,91,80
2426,164,3,627,8,3463,86,80
2427,164,3,628,2,3465,0,20
2428,164,3,629,7,3472,81,70
2429,164,3,630,3,3475,28,30
2430,164,3,631,7,3482,74,70
2431,164,3,632,7,3489,94,70
2432,164,3,633,8,3497,0,80
2433,164,3,634,3,3500,0,30
2434,164,3,635,6,3506,0,60
2435,164,3,636,9,3515,286,90
2436,164,3,637,3,3518,29,30
2437,164,3,638,6,3524,56,60
2438,164,3,639,5,3529,51,50
2439,164,3,640,7,3536,71,70
2440,164,3,641,3,3539,0,30
2441,164,3,642,8,3547,0,80
2442,164,3,643,3,3550,0,30
2443,164,3,644,8,3558,236,80
2444,164,3,645,4,3562,49,40
2445,164,3,646,6,3568,56,60
2446,164,3,647,7,3575,0,70
2447,164,3,648,4,3579,111,40
2448,164,3,649,6,3585,74,60
2449,164,3,650,5,3590,0,50
2450,164,3,651,7,3597,110,70
2451,164,3,652,8,3605,82,80
2452,164,3,653,5,3610,56,50
2453,164,3,654,6,3616,56,60
2454,164,3,655,5,3621,0,50
2455,164,3,656,6,3627,0,60
2456,164,3,657,2,3629,0,20
2457,164,3,658,6,3635,201,60
2458,164,3,659,8,3643,0,80
2459,164,3,660,3,3646,127,30
2460,164,3,661,9,3655,87,90
2461,164,3,662,2,3657,19,20
2462,164,3,663,6,3663,0,60
2463,164,3,664,6,3669,0,60
2464,164,3,665,6,3675,0,60
2465,164,3,666,6,3681,0,60
2466,164,3,667,7,3688,299,70
2467,164,3,668,4,3692,0,40
2468,164,3,669,5,3697,0,50
2469,164,3,670,3,3700,132,30
2470,164,3,671,6,3706,71,60
2471,164,3,672,6,3712,67,60
2472,164,3,673,8,3720,90,80
2473,164,3,674,7,3727,62,70
2474,164,3,675,5,3732,0,50
2475,164,3,676,2,3734,0,20
2476,164,3,677,6,3740,124,60
2477,164,3,678,7,3747,0,70
2478,164,3,679,7,3754,140,70
2479,164,3,680,4,3758,38,40
2480,164,3,681,2,3760,0,20
2481,164,3,682,5,3765,77,50
2482,164,3,683,8,3773,76,80
2483,164,3,684,5,3778,0,50
2484,164,3,685,3,3781,0,30
2485,164,3,686,3,3784,124,30
2486,164,3,687,2,3786,0,20
2487,164,3,688,5,3791,76,50
2488,164,3,689,6,3797,61,60
2489,164,3,690,7,3804,58,70
2490,164,3,691,8,3812,77,80
2491,164,3,692,8,3820,86,80
2492,164,3,693,7,3827,58,70
2493,164,3,694,5,3832,0,50
2494,164,3,695,3,3835,0,30
2495,164,3,696,5,3840,138,50
2496,164,3,697,5,3845,45,50
2497,164,3,698,4,3849,37,40
2498,164,3,699,8,3857,0,80
2499,164,3,700,3,3860,116,30
2500,164,3,701,8,3868,96,80
2501,164,3,702,5,3873,0,50
2502,164,3,703,9,3882,132,90
2503,164,3,704,6,3888,0,60
2504,164,3,705,5,3893,99,50
2505,164,3,706,5,3898,50,50
2506,164,3,707,3,3901,19,30
2507,164,3,708,6,3907,0,60
2508,164,3,709,7,3914,141,70
2509,164,3,710,4,3918,0,40
2510,164,3,711,4,3922,0,40
2511,164,3,712,3,3925,0,30
2512,164,3,713,3,3928,136,30
2513,164,3,714,6,3934,58,60
2514,164,3,715,6,3940,64,60
2515,164,3,716,2,3942,17,20
2516,164,3,717,5,3947,0,50
2517,164,3,718,4,3951,92,40
2518,164,3,719,9,3960,94,90
2519,164,3,720,5,3965,57,50
2520,164,3,721,5,3970,59,50
2521,164,3,722,5,3975,56,50
2522,164,3,723,9,3984,104,90
2523,164,3,724,2,3986,0,20
2524,164,3,725,3,3989,46,30
2525,164,3,726,5,3994,0,50
2526,164,3,727,8,4002,0,80
2527,164,3,728,5,4007,186,50
2528,164,3,729,7,4014,0,70
2529,164,3,730,7,4021,139,70
2530,164,3,731,3,4024,0,30
2531,164,3,732,5,4029,76,50
2532,164,3,733,5,4034,43,50
2533,164,3,734,4,4038,38,40
2534,164,3,735,7,4045,0,70
2535,164,3,736,5,4050,141,50
2536,164,3,737,3,4053,26,30
2537,164,3,738,5,4058,52,50
2538,164,3,739,9,4067,0,90
2539,164,3,740,4,4071,133,40
2540,164,3,741,7,4078,66,70
2541,164,3,742,9,4087,0,90
2542,164,3,743,7,4094,173,70
2543,164,3,744,3,4097,26,30
2544,164,3,745,8,4105,76,80
2545,164,3,746,4,4109,0,40
2546,164,3,747,4,4113,85,40
2547,164,3,748,4,4117,40,40
2548,164,3,749,4,4121,50,40
2549,164,3,750,7,4128,70,70
2550,164,3,751,9,4137,0,90
2551,164,3,752,8,4145,0,80
2552,164,3,753,3,4148,0,30
2553,164,3,754,2,4150,0,20
2554,164,3,755,3,4153,249,30
2555,164,3,756,9,4162,89,90
2556,164,3,757,7,4169,0,70
2557,164,3,758,4,4173,128,40
2558,164,3,759,2,4175,0,20
2559,164,3,760,6,4181,83,60
2560,164,3,761,3,4184,0,30
2561,164,3,762,8,4192,0,80
2562,164,3,763,7,4199,0,70
2563,164,3,764,6,4205,241,60
2564,164,3,765,4,4209,37,40
2565,164,3,766,6,4215,0,60
2566,164,3,767,2,4217,0,20
2567,164,3,768,7,4224,0,70
2568,164,3,769,2,4226,0,20
2569,164,3,770,7,4233,265,70
2570,164,3,771,6,4239,0,60
2571,164,3,772,3,4242,0,30
2572,164,3,773,2,4244,122,20
2573,164,3,774,6,4250,0,60
2574,164,3,775,4,4254,0,40
2575,164,3,776,7,4261,0,70
2576,164,3,777,5,4266,230,50
2577,164,3,778,4,4270,48,40
2578,164,3,779,7,4277,74,70
2579,164,3,780,9,4286,0,90
2580,164,3,781,5,4291,0,50
2581,164,3,782,4,4295,179,40
2582,164,3,783,4,4299,0,40
2583,164,3,784,2,4301,46,20
2584,164,3,785,9,4310,94,90
2585,164,3,786,3,4313,34,30
2586,164,3,787,2,4315,0,20
2587,164,3,788,5,4320,0,50
2588,164,3,789,5,4325,0,50
2589,164,3,790,7,4332,187,70
2590,164,3,791,2,4334,19,20
2591,164,3,792,7,4341,78,70
2592,164,3,793,7,4348,0,70
2593,164,3,794,9,4357,155,90
2594,164,3,795,9,4366,100,90
2595,164,3,796,4,4370,0,40
2596,164,3,797,7,4377,110,70
2597,164,3,798,9,4386,0,90
2598,164,3,799,3,4389,0,30
2599,164,3,800,6,4395,179,60
2600,164,3,801,4,4399,39,40
2601,164,3,802,4,4403,43,40
2602,164,3,803,5,4408,44,50
2603,164,3,804,7,4415,0,70
2604,164,3,805,3,4418,0,30
2605,164,3,806,8,4426,0,80
2606,164,3,807,3,4429,199,30
2607,164,3,808,2,4431,24,20
2608,164,3,809,3,4434,30,30
2609,164,3,810,3,4437,0,30
2610,164,3,811,5,4442,72,50
2611,164,3,812,3,4445,20,30
2612,164,3,813,9,4454,90,90
2613,164,3,814,3,4457,0,30
2614,164,3,815,7,4464,88,70
2615,164,3,816,5,4469,0,50
2616,164,3,817,6,4475,112,60
2617,164,3,818,4,4479,44,40
2618,164,3,819,2,4481,27,20
2619,164,3,820,3,4484,30,30
2620,164,3,821,9,4493,0,90
2621,164,3,822,5,4498,135,50
2622,164,3,823,4,4502,0,40
2623,164,3,824,2,4504,62,20
2624,164,3,825,2,4506,0,20
2625,164,3,826,9,4515,0,90
2626,164,3,827,5,4520,0,50
2627,164,3,828,6,4526,189,60
2628,164,3,829,3,4529,0,30
2629,164,3,830,6,4535,0,60
2630,164,3,831,5,4540,0,50
2631,164,3,832,5,4545,184,50
2632,164,3,833,2,4547,0,20
2633,164,3,834,2,4549,34,20
2634,164,3,835,2,4551,0,20
2635,164,3,836,5,4556,60,50
2636,164,3,837,9,4565,0,90
2637,164,3,838,4,4569,134,40
2638,164,3,839,8,4577,86,80
2639,164,3,840,6,4583,0,60
2640,164,3,841,5,4588,0,50
2641,164,3,842,9,4597,0,90
2642,164,3,843,6,4603,0,60
2643,164,3,844,4,4607,300,40
2644,164,3,845,8,4615,81,80
2645,164,3,846,6,4621,62,60
2646,164,3,847,3,4624,0,30
2647,164,3,848,5,4629,94,50
2648,164,3,849,8,4637,85,80
2649,164,3,850,6,4643,0,60
2650,164,3,851,4,4647,81,40
2651,164,3,852,2,4649,27,20
2652,164,3,853,2,4651,13,20
2653,164,3,854,5,4656,0,50
2654,164,3,855,2,4658,79,20
2655,164,3,856,3,4661,0,30
2656,164,3,857,8,4669,112,80
2657,164,3,858,8,4677,0,80
2658,164,3,859,9,4686,180,90
2659,164,3,860,3,4689,0,30
2660,164,3,861,8,4697,91,80
2661,164,3,862,2,4699,21,20
2662,164,3,863,8,4707,0,80
2663,164,3,864,3,4710,105,30
2664,164,3,865,2,4712,28,20
2665,164,3,866,7,4719,72,70
2666,164,3,867,3,4722,33,30
2667,164,3,868,2,4724,25,20
2668,164,3,869,8,4732,0,80
2669,164,3,870,3,4735,144,30
2670,164,3,871,8,4743,91,80
2671,164,3,872,4,4747,47,40
2672,164,3,873,6,4753,79,60
2673,164,3,874,3,4756,34,30
2674,164,3,875,6,4762,57,60
2675,164,3,876,6,4768,58,60
2676,164,3,877,3,4771,23,30
2677,164,3,878,5,4776,58,50
2678,164,3,879,6,4782,56,60
2679,164,3,880,9,4791,81,90
2680,164,3,881,4,4795,49,40
2681,164,3,882,4,4799,33,40
2682,164,3,883,8,4807,0,80
2683,164,3,884,6,4813,122,60
2684,164,3,885,3,4816,27,30
2685,164,3,886,9,4825,95,90
2686,164,3,887,2,4827,0,20
2687,164,3,888,7,4834,79,70
2688,164,3,889,8,4842,89,80
2689,164,3,890,5,4847,0,50
2690,164,3,891,5,4852,112,50
2691,164,3,892,5,4857,48,50
2692,164,3,893,6,4863,0,60
2693,164,3,894,2,4865,0,20
2694,164,3,895,5,4870,154,50
2695,164,3,896,5,4875,0,50
2696,164,3,897,4,4879,100,40
2697,164,3,898,6,4885,54,60
2698,164,3,899,2,4887,0,20
2699,164,3,900,4,4891,0,40
2700,164,3,901,3,4894,82,30
2701,164,3,902,7,4901,0,70
2702,164,3,903,6,4907,136,60
2703,164,3,904,8,4915,80,80
2704,164,3,905,4,4919,50,40
2705,164,3,906,6,4925,68,60
2706,164,3,907,8,4933,66,80
2707,164,3,908,3,4936,0,30
2708,164,3,909,5,4941,0,50
2709,164,3,910,6,4947,134,60
2710,164,3,911,5,4952,0,50
2711,164,3,912,7,4959,0,70
2712,164,3,913,5,4964,159,50
2713,164,3,914,4,4968,0,40
2714,164,3,915,4,4972,0,40
2715,164,3,916,2,4974,0,20
2716,164,3,917,6,4980,161,60
2717,164,3,918,9,4989,83,90
2718,164,3,919,7,4996,74,70
2719,164,3,920,2,4998,0,20
