,Scenario,Trial,Inspection,Interval,Time,Defects,Rate
0,89,1,1,7,7,74,70
1,89,1,2,5,12,0,50
2,89,1,3,3,15,0,30
3,89,1,4,8,23,166,80
4,89,1,5,7,30,0,70
5,89,1,6,8,38,148,80
6,89,1,7,9,47,0,90
7,89,1,8,8,55,0,80
8,89,1,9,8,63,245,80
9,89,1,10,7,70,60,70
10,89,1,11,5,75,51,50
11,89,1,12,4,79,43,40
12,89,1,13,5,84,55,50
13,89,1,14,2,86,0,20
14,89,1,15,4,90,59,40
15,89,1,16,7,97,74,70
16,89,1,17,8,105,0,80
17,89,1,18,6,111,140,60
18,89,1,19,8,119,94,80
19,89,1,20,6,125,59,60
20,89,1,21,4,129,37,40
21,89,1,22,5,134,47,50
22,89,1,23,5,139,49,50
23,89,1,24,2,141,0,20
24,89,1,25,7,148,91,70
25,89,1,26,8,156,88,80
26,89,1,27,7,163,78,70
27,89,1,28,9,172,93,90
28,89,1,29,3,175,37,30
29,89,1,30,5,180,43,50
30,89,1,31,3,183,36,30
31,89,1,32,9,192,87,90
32,89,1,33,6,198,54,60
33,89,1,34,3,201,0,30
34,89,1,35,8,209,119,80
35,89,1,36,7,216,74,70
36,89,1,37,2,218,29,20
37,89,1,38,7,225,77,70
38,89,1,39,5,230,0,50
39,89,1,40,6,236,0,60
40,89,1,41,4,240,148,40
41,89,1,42,8,248,79,80
42,89,1,43,3,251,35,30
43,89,1,44,8,259,91,80
44,89,1,45,7,266,0,70
45,89,1,46,4,270,99,40
46,89,1,47,6,276,52,60
47,89,1,48,6,282,52,60
48,89,1,49,5,287,54,50
49,89,1,50,7,294,69,70
50,89,1,51,9,303,95,90
51,89,1,52,9,312,84,90
52,89,1,53,5,317,59,50
53,89,1,54,2,319,21,20
54,89,1,55,9,328,75,90
55,89,1,56,3,331,0,30
56,89,1,57,5,336,88,50
57,89,1,58,9,345,0,90
58,89,1,59,7,352,162,70
59,89,1,60,7,359,69,70
60,89,1,61,5,364,53,50
61,89,1,62,9,373,95,90
62,89,1,63,5,378,0,50
63,89,1,64,4,382,78,40
64,89,1,65,7,389,67,70
65,89,1,66,4,393,36,40
66,89,1,67,7,400,75,70
67,89,1,68,5,405,61,50
68,89,1,69,8,413,86,80
69,89,1,70,7,420,79,70
70,89,1,71,8,428,81,80
71,89,1,72,2,430,23,20
72,89,1,73,8,438,68,80
73,89,1,74,7,445,80,70
74,89,1,75,6,451,47,60
75,89,1,76,6,457,68,60
76,89,1,77,9,466,85,90
77,89,1,78,7,473,70,70
78,89,1,79,8,481,82,80
79,89,1,80,8,489,87,80
80,89,1,81,4,493,37,40
81,89,1,82,8,501,100,80
82,89,1,83,4,505,38,40
83,89,1,84,9,514,0,90
84,89,1,85,9,523,167,90
85,89,1,86,3,526,28,30
86,89,1,87,9,535,85,90
87,89,1,88,5,540,0,50
88,89,1,89,9,549,124,90
89,89,1,90,8,557,79,80
90,89,1,91,2,559,17,20
91,89,1,92,5,564,0,50
92,89,1,93,6,570,117,60
93,89,1,94,6,576,62,60
94,89,1,95,8,584,74,80
95,89,1,96,9,593,0,90
96,89,1,97,7,600,159,70
97,89,1,98,8,608,78,80
98,89,1,99,8,616,83,80
99,89,1,100,6,622,73,60
100,89,1,101,8,630,90,80
101,89,1,102,9,639,79,90
102,89,1,103,7,646,0,70
103,89,1,104,4,650,0,40
104,89,1,105,8,658,185,80
105,89,1,106,7,665,79,70
106,89,1,107,5,670,59,50
107,89,1,108,5,675,41,50
108,89,1,109,5,680,62,50
109,89,1,110,7,687,70,70
110,89,1,111,3,690,0,30
111,89,1,112,3,693,0,30
112,89,1,113,4,697,0,40
113,89,1,114,3,700,0,30
114,89,1,115,4,704,164,40
115,89,1,116,3,707,34,30
116,89,1,117,4,711,32,40
117,89,1,118,7,718,81,70
118,89,1,119,2,720,0,20
119,89,1,120,9,729,128,90
120,89,1,121,4,733,40,40
121,89,1,122,7,740,70,70
122,89,1,123,5,745,54,50
123,89,1,124,7,752,77,70
124,89,1,125,2,754,18,20
125,89,1,126,2,756,20,20
126,89,1,127,2,758,12,20
127,89,1,128,2,760,0,20
128,89,1,129,4,764,45,40
129,89,1,130,3,767,27,30
130,89,1,131,9,776,97,90
131,89,1,132,3,779,14,30
132,89,1,133,3,782,35,30
133,89,1,134,5,787,0,50
134,89,1,135,2,789,71,20
135,89,1,136,2,791,18,20
136,89,1,137,7,798,65,70
137,89,1,138,8,806,76,80
138,89,1,139,6,812,51,60
139,89,1,140,6,818,62,60
140,89,1,141,7,825,0,70
141,89,1,142,6,831,0,60
142,89,1,143,5,836,169,50
143,89,1,144,4,840,37,40
144,89,1,145,9,849,83,90
145,89,1,146,6,855,77,60
146,89,1,147,7,862,88,70
147,89,1,148,7,869,0,70
148,89,1,149,2,871,83,20
149,89,1,150,3,874,0,30
150,89,1,151,2,876,46,20
151,89,1,152,7,883,66,70
152,89,1,153,2,885,0,20
153,89,1,154,5,890,76,50
154,89,1,155,2,892,20,20
155,89,1,156,7,899,86,70
156,89,1,157,8,907,85,80
157,89,1,158,4,911,36,40
158,89,1,159,3,914,25,30
159,89,1,160,7,921,71,70
160,89,1,161,2,923,18,20
161,89,1,162,4,927,0,40
162,89,1,163,6,933,0,60
163,89,1,164,3,936,136,30
164,89,1,165,8,944,87,80
165,89,1,166,9,953,90,90
166,89,1,167,9,962,81,90
167,89,1,168,5,967,42,50
168,89,1,169,3,970,0,30
169,89,1,170,2,972,49,20
170,89,1,171,8,980,56,80
171,89,1,172,9,989,96,90
172,89,1,173,8,997,79,80
173,89,1,174,3,1000,0,30
174,89,1,175,3,1003,61,30
175,89,1,176,5,1008,50,50
176,89,1,177,8,1016,79,80
177,89,1,178,8,1024,83,80
178,89,1,179,5,1029,0,50
179,89,1,180,3,1032,77,30
180,89,1,181,7,1039,0,70
181,89,1,182,9,1048,0,90
182,89,1,183,9,1057,0,90
183,89,1,184,2,1059,273,20
184,89,1,185,5,1064,0,50
185,89,1,186,3,1067,0,30
186,89,1,187,3,1070,139,30
187,89,1,188,7,1077,69,70
188,89,1,189,4,1081,31,40
189,89,1,190,9,1090,84,90
190,89,1,191,2,1092,22,20
191,89,1,192,2,1094,21,20
192,89,1,193,2,1096,14,20
193,89,1,194,2,1098,0,20
194,89,1,195,5,1103,85,50
195,89,1,196,9,1112,100,90
196,89,1,197,8,1120,93,80
197,89,1,198,5,1125,41,50
198,89,1,199,5,1130,56,50
199,89,1,200,7,1137,80,70
200,89,1,201,3,1140,0,30
201,89,1,202,6,1146,0,60
202,89,1,203,8,1154,0,80
203,89,1,204,9,1163,268,90
204,89,1,205,2,1165,18,20
205,89,1,206,9,1174,85,90
206,89,1,207,4,1178,0,40
207,89,1,208,9,1187,130,90
208,89,1,209,3,1190,24,30
209,89,1,210,4,1194,48,40
210,89,1,211,3,1197,0,30
211,89,1,212,7,1204,104,70
212,89,1,213,3,1207,0,30
213,89,1,214,9,1216,0,90
214,89,1,215,4,1220,140,40
215,89,1,216,3,1223,0,30
216,89,1,217,7,1230,0,70
217,89,1,218,5,1235,138,50
218,89,1,219,2,1237,25,20
219,89,1,220,7,1244,71,70
220,89,1,221,7,1251,78,70
221,89,1,222,2,1253,19,20
222,89,1,223,3,1256,31,30
223,89,1,224,5,1261,0,50
224,89,1,225,4,1265,88,40
225,89,1,226,6,1271,81,60
226,89,1,227,3,1274,24,30
227,89,1,228,4,1278,46,40
228,89,1,229,9,1287,97,90
229,89,1,230,7,1294,0,70
230,89,1,231,9,1303,159,90
231,89,1,232,2,1305,0,20
232,89,1,233,2,1307,0,20
233,89,1,234,2,1309,54,20
234,89,1,235,3,1312,0,30
235,89,1,236,5,1317,73,50
236,89,1,237,5,1322,0,50
237,89,1,238,2,1324,79,20
238,89,1,239,2,1326,0,20
239,89,1,240,5,1331,72,50
240,89,1,241,3,1334,31,30
241,89,1,242,4,1338,0,40
242,89,1,243,9,1347,119,90
243,89,1,244,8,1355,0,80
244,89,1,245,4,1359,121,40
245,89,1,246,9,1368,0,90
246,89,1,247,8,1376,163,80
247,89,1,248,3,1379,0,30
248,89,1,249,9,1388,114,90
249,89,1,250,4,1392,38,40
250,89,1,251,9,1401,82,90
251,89,1,252,3,1404,26,30
252,89,1,253,8,1412,0,80
253,89,1,254,7,1419,0,70
254,89,1,255,7,1426,0,70
255,89,1,256,7,1433,300,70
256,89,1,257,9,1442,0,90
257,89,1,258,9,1451,0,90
258,89,1,259,3,1454,226,30
259,89,1,260,3,1457,40,30
260,89,1,261,7,1464,67,70
261,89,1,262,7,1471,82,70
262,89,1,263,9,1480,89,90
263,89,1,264,6,1486,0,60
264,89,1,265,5,1491,0,50
265,89,1,266,7,1498,166,70
266,89,1,267,7,1505,79,70
267,89,1,268,3,1508,37,30
268,89,1,269,6,1514,56,60
269,89,1,270,9,1523,0,90
270,89,1,271,7,1530,181,70
271,89,1,272,7,1537,67,70
272,89,1,273,6,1543,70,60
273,89,1,274,3,1546,29,30
274,89,1,275,5,1551,48,50
275,89,1,276,9,1560,89,90
276,89,1,277,7,1567,63,70
277,89,1,278,7,1574,74,70
278,89,1,279,9,1583,88,90
279,89,1,280,3,1586,28,30
280,89,1,281,5,1591,0,50
281,89,1,282,2,1593,77,20
282,89,1,283,6,1599,55,60
283,89,1,284,5,1604,0,50
284,89,1,285,3,1607,75,30
285,89,1,286,3,1610,34,30
286,89,1,287,6,1616,48,60
287,89,1,288,3,1619,34,30
288,89,1,289,2,1621,19,20
289,89,1,290,7,1628,61,70
290,89,1,291,6,1634,62,60
291,89,1,292,3,1637,30,30
292,89,1,293,9,1646,69,90
293,89,1,294,3,1649,36,30
294,89,1,295,7,1656,67,70
295,89,1,296,6,1662,0,60
296,89,1,297,7,1669,147,70
297,89,1,298,4,1673,38,40
298,89,1,299,5,1678,0,50
299,89,1,300,4,1682,75,40
300,89,1,301,7,1689,75,70
301,89,1,302,2,1691,24,20
302,89,1,303,4,1695,0,40
303,89,1,304,4,1699,0,40
304,89,1,305,8,1707,150,80
305,89,1,306,9,1716,0,90
306,89,1,307,8,1724,154,80
307,89,1,308,9,1733,90,90
308,89,1,309,5,1738,44,50
309,89,1,310,4,1742,41,40
310,89,1,311,9,1751,0,90
311,89,1,312,4,1755,142,40
312,89,1,313,8,1763,68,80
313,89,1,314,8,1771,70,80
314,89,1,315,9,1780,90,90
315,89,1,316,2,1782,18,20
316,89,1,317,5,1787,64,50
317,89,1,318,3,1790,0,30
318,89,1,319,7,1797,97,70
319,89,1,320,9,1806,0,90
320,89,1,321,9,1815,0,90
321,89,1,322,2,1817,182,20
322,89,1,323,7,1824,0,70
323,89,1,324,5,1829,122,50
324,89,1,325,5,1834,50,50
325,89,1,326,6,1840,66,60
326,89,1,327,6,1846,0,60
327,89,1,328,3,1849,87,30
328,89,1,329,5,1854,49,50
329,89,1,330,6,1860,59,60
330,89,1,331,6,1866,54,60
331,89,1,332,8,1874,84,80
332,89,1,333,8,1882,89,80
333,89,1,334,3,1885,37,30
334,89,1,335,2,1887,21,20
335,89,1,336,9,1896,0,90
336,89,1,337,4,1900,0,40
337,89,1,338,4,1904,185,40
338,89,1,339,6,1910,57,60
339,89,1,340,5,1915,43,50
340,89,1,341,5,1920,0,50
341,89,1,342,7,1927,108,70
342,89,1,343,9,1936,0,90
343,89,1,344,3,1939,124,30
344,89,1,345,9,1948,94,90
345,89,1,346,3,1951,33,30
346,89,1,347,9,1960,84,90
347,89,1,348,6,1966,58,60
348,89,1,349,9,1975,98,90
349,89,1,350,2,1977,0,20
350,89,1,351,9,1986,0,90
351,89,1,352,2,1988,141,20
352,89,1,353,2,1990,8,20
353,89,1,354,7,1997,66,70
354,89,1,355,9,2006,0,90
355,89,1,356,7,2013,0,70
356,89,1,357,2,2015,196,20
357,89,1,358,5,2020,42,50
358,89,1,359,3,2023,24,30
359,89,1,360,4,2027,50,40
360,89,1,361,8,2035,85,80
361,89,1,362,8,2043,0,80
362,89,1,363,4,2047,124,40
363,89,1,364,7,2054,67,70
364,89,1,365,5,2059,47,50
365,89,1,366,4,2063,46,40
366,89,1,367,4,2067,38,40
367,89,1,368,6,2073,52,60
368,89,1,369,6,2079,61,60
369,89,1,370,3,2082,0,30
370,89,1,371,2,2084,0,20
371,89,1,372,8,2092,0,80
372,89,1,373,8,2100,0,80
373,89,1,374,9,2109,345,90
374,89,1,375,5,2114,35,50
375,89,1,376,9,2123,84,90
376,89,1,377,2,2125,0,20
377,89,1,378,7,2132,100,70
378,89,1,379,9,2141,103,90
379,89,1,380,3,2144,29,30
380,89,1,381,9,2153,78,90
381,89,1,382,2,2155,0,20
382,89,1,383,9,2164,116,90
383,89,1,384,7,2171,76,70
384,89,1,385,5,2176,52,50
385,89,1,386,3,2179,37,30
386,89,1,387,5,2184,37,50
387,89,1,388,7,2191,65,70
388,89,1,389,9,2200,77,90
389,89,1,390,6,2206,62,60
390,89,1,391,2,2208,22,20
391,89,1,392,8,2216,55,80
392,89,1,393,3,2219,25,30
393,89,1,394,9,2228,111,90
394,89,1,395,8,2236,107,80
395,89,1,396,6,2242,0,60
396,89,1,397,2,2244,82,20
397,89,1,398,6,2250,56,60
398,89,1,399,3,2253,27,30
399,89,1,400,8,2261,0,80
400,89,1,401,5,2266,151,50
401,89,1,402,2,2268,0,20
402,89,1,403,2,2270,0,20
403,89,1,404,2,2272,64,20
404,89,1,405,3,2275,24,30
405,89,1,406,2,2277,20,20
406,89,1,407,7,2284,0,70
407,89,1,408,6,2290,130,60
408,89,1,409,5,2295,0,50
409,89,1,410,8,2303,0,80
410,89,1,411,3,2306,0,30
411,89,1,412,2,2308,0,20
412,89,1,413,9,2317,258,90
413,89,1,414,7,2324,50,70
414,89,1,415,8,2332,0,80
415,89,1,416,3,2335,105,30
416,89,1,417,8,2343,90,80
417,89,1,418,2,2345,15,20
418,89,1,419,4,2349,34,40
419,89,1,420,7,2356,0,70
420,89,1,421,4,2360,94,40
421,89,1,422,2,2362,18,20
422,89,1,423,2,2364,26,20
423,89,1,424,5,2369,54,50
424,89,1,425,2,2371,0,20
425,89,1,426,9,2380,0,90
426,89,1,427,3,2383,140,30
427,89,1,428,6,2389,0,60
428,89,1,429,5,2394,117,50
429,89,1,430,4,2398,0,40
430,89,1,431,9,2407,0,90
431,89,1,432,8,2415,194,80
432,89,1,433,7,2422,76,70
433,89,1,434,6,2428,43,60
434,89,1,435,6,2434,58,60
435,89,1,436,6,2440,0,60
436,89,1,437,9,2449,159,90
437,89,1,438,3,2452,30,30
438,89,1,439,5,2457,0,50
439,89,1,440,8,2465,129,80
440,89,1,441,8,2473,86,80
441,89,1,442,3,2476,31,30
442,89,1,443,4,2480,43,40
443,89,1,444,8,2488,92,80
444,89,1,445,7,2495,63,70
445,89,1,446,5,2500,0,50
446,89,1,447,5,2505,0,50
447,89,1,448,2,2507,0,20
448,89,1,449,3,2510,151,30
449,89,1,450,3,2513,45,30
450,89,1,451,5,2518,45,50
451,89,1,452,7,2525,76,70
452,89,1,453,9,2534,83,90
453,89,1,454,8,2542,78,80
454,89,1,455,2,2544,0,20
455,89,1,456,2,2546,0,20
456,89,1,457,8,2554,127,80
457,89,1,458,8,2562,0,80
458,89,1,459,6,2568,167,60
459,89,1,460,7,2575,78,70
460,89,1,461,2,2577,22,20
461,89,1,462,6,2583,0,60
462,89,1,463,5,2588,103,50
463,89,1,464,9,2597,87,90
464,89,1,465,6,2603,67,60
465,89,1,466,6,2609,57,60
466,89,1,467,7,2616,0,70
467,89,1,468,7,2623,149,70
468,89,1,469,9,2632,106,90
469,89,1,470,8,2640,81,80
470,89,1,471,8,2648,89,80
471,89,1,472,6,2654,0,60
472,89,1,473,4,2658,89,40
473,89,1,474,7,2665,0,70
474,89,1,475,9,2674,156,90
475,89,1,476,4,2678,0,40
476,89,1,477,2,2680,58,20
477,89,1,478,2,2682,18,20
478,89,1,479,4,2686,0,40
479,89,1,480,8,2694,0,80
480,89,1,481,2,2696,119,20
481,89,1,482,3,2699,30,30
482,89,1,483,4,2703,42,40
483,89,1,484,2,2705,14,20
484,89,1,485,4,2709,41,40
485,89,1,486,3,2712,30,30
486,89,1,487,3,2715,25,30
487,89,1,488,6,2721,62,60
488,89,1,489,4,2725,48,40
489,89,1,490,5,2730,42,50
490,89,1,491,4,2734,29,40
491,89,1,492,8,2742,0,80
492,89,1,493,8,2750,162,80
493,89,1,494,9,2759,97,90
494,89,1,495,8,2767,77,80
495,89,1,496,8,2775,93,80
496,89,1,497,3,2778,37,30
497,89,1,498,9,2787,0,90
498,89,1,499,8,2795,173,80
499,89,1,500,4,2799,48,40
500,89,1,501,9,2808,102,90
501,89,1,502,5,2813,41,50
502,89,1,503,4,2817,0,40
503,89,1,504,7,2824,98,70
504,89,1,505,6,2830,67,60
505,89,1,506,3,2833,0,30
506,89,1,507,3,2836,62,30
507,89,1,508,8,2844,65,80
508,89,1,509,4,2848,0,40
509,89,1,510,4,2852,0,40
510,89,1,511,3,2855,106,30
511,89,1,512,9,2864,0,90
512,89,1,513,6,2870,153,60
513,89,1,514,2,2872,0,20
514,89,1,515,8,2880,99,80
515,89,1,516,3,2883,30,30
516,89,1,517,2,2885,0,20
517,89,1,518,3,2888,0,30
518,89,1,519,8,2896,140,80
519,89,1,520,5,2901,52,50
520,89,1,521,5,2906,0,50
521,89,1,522,3,2909,71,30
522,89,1,523,4,2913,50,40
523,89,1,524,3,2916,0,30
524,89,1,525,4,2920,75,40
525,89,1,526,5,2925,50,50
526,89,1,527,5,2930,56,50
527,89,1,528,9,2939,91,90
528,89,1,529,8,2947,0,80
529,89,1,530,8,2955,156,80
530,89,1,531,9,2964,96,90
531,89,1,532,5,2969,51,50
532,89,1,533,4,2973,31,40
533,89,1,534,7,2980,0,70
534,89,1,535,2,2982,89,20
535,89,1,536,3,2985,25,30
536,89,1,537,3,2988,27,30
537,89,1,538,8,2996,78,80
538,89,1,539,9,3005,78,90
539,89,1,540,2,3007,0,20
540,89,1,541,8,3015,0,80
541,89,1,542,7,3022,0,70
542,89,1,543,8,3030,248,80
543,89,1,544,2,3032,0,20
544,89,1,545,5,3037,77,50
545,89,1,546,6,3043,63,60
546,89,1,547,7,3050,73,70
547,89,1,548,4,3054,40,40
548,89,1,549,6,3060,72,60
549,89,1,550,2,3062,18,20
550,89,1,551,4,3066,0,40
551,89,1,552,3,3069,0,30
552,89,1,553,3,3072,0,30
553,89,1,554,2,3074,130,20
554,89,1,555,9,3083,75,90
555,89,1,556,8,3091,98,80
556,89,1,557,3,3094,23,30
557,89,1,558,2,3096,19,20
558,89,1,559,9,3105,104,90
559,89,1,560,4,3109,0,40
560,89,1,561,6,3115,0,60
561,89,1,562,7,3122,176,70
562,89,1,563,6,3128,69,60
563,89,1,564,3,3131,31,30
564,89,1,565,2,3133,17,20
565,89,1,566,8,3141,84,80
566,89,1,567,3,3144,29,30
567,89,1,568,8,3152,76,80
568,89,1,569,3,3155,0,30
569,89,1,570,8,3163,116,80
570,89,1,571,8,3171,0,80
571,89,1,572,3,3174,113,30
572,89,1,573,6,3180,59,60
573,89,1,574,6,3186,52,60
574,89,1,575,8,3194,87,80
575,89,1,576,7,3201,73,70
576,89,1,577,9,3210,89,90
577,89,1,578,3,3213,37,30
578,89,1,579,9,3222,78,90
579,89,1,580,7,3229,58,70
580,89,1,581,9,3238,91,90
581,89,1,582,9,3247,90,90
582,89,1,583,8,3255,0,80
583,89,1,584,9,3264,182,90
584,89,1,585,7,3271,64,70
585,89,1,586,7,3278,73,70
586,89,1,587,2,3280,19,20
587,89,1,588,8,3288,82,80
588,89,1,589,9,3297,85,90
589,89,1,590,6,3303,0,60
590,89,1,591,7,3310,124,70
591,89,1,592,8,3318,70,80
592,89,1,593,4,3322,40,40
593,89,1,594,5,3327,45,50
594,89,1,595,6,3333,63,60
595,89,1,596,5,3338,48,50
596,89,1,597,8,3346,88,80
597,89,1,598,3,3349,30,30
598,89,1,599,8,3357,92,80
599,89,1,600,3,3360,0,30
600,89,1,601,4,3364,66,40
601,89,1,602,7,3371,0,70
602,89,1,603,9,3380,137,90
603,89,1,604,5,3385,39,50
604,89,1,605,4,3389,45,40
605,89,1,606,9,3398,98,90
606,89,1,607,8,3406,78,80
607,89,1,608,2,3408,25,20
608,89,1,609,8,3416,0,80
609,89,1,610,2,3418,85,20
610,89,1,611,8,3426,91,80
611,89,1,612,4,3430,38,40
612,89,1,613,5,3435,0,50
613,89,1,614,2,3437,63,20
614,89,1,615,9,3446,84,90
615,89,1,616,6,3452,0,60
616,89,1,617,5,3457,119,50
617,89,1,618,8,3465,86,80
618,89,1,619,9,3474,0,90
619,89,1,620,6,3480,152,60
620,89,1,621,3,3483,30,30
621,89,1,622,2,3485,0,20
622,89,1,623,2,3487,0,20
623,89,1,624,5,3492,78,50
624,89,1,625,5,3497,54,50
625,89,1,626,2,3499,22,20
626,89,1,627,2,3501,22,20
627,89,1,628,8,3509,95,80
628,89,1,629,8,3517,66,80
629,89,1,630,2,3519,16,20
630,89,1,631,4,3523,0,40
631,89,1,632,3,3526,65,30
632,89,1,633,7,3533,58,70
633,89,1,634,7,3540,74,70
634,89,1,635,9,3549,91,90
635,89,1,636,5,3554,55,50
636,89,1,637,6,3560,59,60
637,89,1,638,2,3562,0,20
638,89,1,639,3,3565,55,30
639,89,1,640,3,3568,0,30
640,89,1,641,9,3577,121,90
641,89,1,642,3,3580,36,30
642,89,1,643,4,3584,48,40
643,89,1,644,9,3593,90,90
644,89,1,645,7,3600,0,70
645,89,1,646,7,3607,160,70
646,89,1,647,5,3612,54,50
647,89,1,648,3,3615,34,30
648,89,1,649,2,3617,21,20
649,89,1,650,2,3619,0,20
650,89,1,651,9,3628,107,90
651,89,1,652,9,3637,86,90
652,89,1,653,7,3644,0,70
653,89,1,654,3,3647,0,30
654,89,1,655,7,3654,0,70
655,89,1,656,5,3659,233,50
656,89,1,657,5,3664,0,50
657,89,1,658,5,3669,0,50
658,89,1,659,4,3673,144,40
659,89,1,660,6,3679,71,60
660,89,1,661,8,3687,74,80
661,89,1,662,7,3694,62,70
662,89,1,663,8,3702,70,80
663,89,1,664,3,3705,35,30
664,89,1,665,4,3709,0,40
665,89,1,666,3,3712,72,30
666,89,1,667,5,3717,60,50
667,89,1,668,9,3726,73,90
668,89,1,669,8,3734,67,80
669,89,1,670,3,3737,0,30
670,89,1,671,5,3742,86,50
671,89,1,672,2,3744,0,20
672,89,1,673,3,3747,48,30
673,89,1,674,5,3752,0,50
674,89,1,675,8,3760,113,80
675,89,1,676,4,3764,38,40
676,89,1,677,5,3769,0,50
677,89,1,678,3,3772,67,30
678,89,1,679,4,3776,39,40
679,89,1,680,7,3783,66,70
680,89,1,681,6,3789,0,60
681,89,1,682,3,3792,109,30
682,89,1,683,8,3800,0,80
683,89,1,684,9,3809,172,90
684,89,1,685,6,3815,59,60
685,89,1,686,3,3818,34,30
686,89,1,687,5,3823,51,50
687,89,1,688,8,3831,98,80
688,89,1,689,9,3840,85,90
689,89,1,690,4,3844,39,40
690,89,1,691,8,3852,76,80
691,89,1,692,5,3857,46,50
692,89,1,693,9,3866,0,90
693,89,1,694,5,3871,0,50
694,89,1,695,3,3874,155,30
695,89,1,696,4,3878,32,40
696,89,1,697,8,3886,63,80
697,89,1,698,5,3891,55,50
698,89,1,699,6,3897,0,60
699,89,1,700,3,3900,86,30
700,89,1,701,6,3906,64,60
701,89,1,702,8,3914,77,80
702,89,1,703,7,3921,80,70
703,89,1,704,5,3926,49,50
704,89,1,705,3,3929,0,30
705,89,1,706,4,3933,64,40
706,89,1,707,2,3935,0,20
707,89,1,708,7,3942,0,70
708,89,1,709,2,3944,118,20
709,89,1,710,4,3948,35,40
710,89,1,711,2,3950,20,20
711,89,1,712,8,3958,81,80
712,89,1,713,7,3965,75,70
713,89,1,714,8,3973,74,80
714,89,1,715,6,3979,55,60
715,89,1,716,9,3988,102,90
716,89,1,717,2,3990,0,20
717,89,1,718,4,3994,58,40
718,89,1,719,9,4003,92,90
719,89,1,720,9,4012,106,90
720,89,1,721,6,4018,57,60
721,89,1,722,9,4027,0,90
722,89,1,723,6,4033,129,60
723,89,1,724,2,4035,22,20
724,89,1,725,7,4042,69,70
725,89,1,726,6,4048,58,60
726,89,1,727,6,4054,0,60
727,89,1,728,2,4056,0,20
728,89,1,729,4,4060,119,40
729,89,1,730,2,4062,13,20
730,89,1,731,5,4067,48,50
731,89,1,732,6,4073,0,60
732,89,1,733,7,4080,148,70
733,89,1,734,9,4089,103,90
734,89,1,735,7,4096,75,70
735,89,1,736,6,4102,0,60
736,89,1,737,8,4110,140,80
737,89,1,738,2,4112,19,20
738,89,1,739,2,4114,19,20
739,89,1,740,5,4119,48,50
740,89,1,741,7,4126,61,70
741,89,1,742,4,4130,36,40
742,89,1,743,4,4134,45,40
743,89,1,744,4,4138,32,40
744,89,1,745,4,4142,35,40
745,89,1,746,5,4147,43,50
746,89,1,747,9,4156,81,90
747,89,1,748,7,4163,53,70
748,89,1,749,4,4167,28,40
749,89,1,750,3,4170,0,30
750,89,1,751,5,4175,0,50
751,89,1,752,3,4178,0,30
752,89,1,753,3,4181,126,30
753,89,1,754,7,4188,64,70
754,89,1,755,6,4194,73,60
755,89,1,756,6,4200,62,60
756,89,1,757,6,4206,0,60
757,89,1,758,4,4210,110,40
758,89,1,759,4,4214,40,40
759,89,1,760,7,4221,88,70
760,89,1,761,2,4223,12,20
761,89,1,762,2,4225,17,20
762,89,1,763,4,4229,39,40
763,89,1,764,4,4233,38,40
764,89,1,765,8,4241,76,80
765,89,1,766,8,4249,85,80
766,89,1,767,9,4258,0,90
767,89,1,768,4,4262,0,40
768,89,1,769,2,4264,160,20
769,89,1,770,8,4272,0,80
770,89,1,771,7,4279,133,70
771,89,1,772,7,4286,0,70
772,89,1,773,9,4295,199,90
773,89,1,774,7,4302,78,70
774,89,1,775,6,4308,50,60
775,89,1,776,8,4316,0,80
776,89,1,777,2,4318,74,20
777,89,1,778,4,4322,44,40
778,89,1,779,5,4327,49,50
779,89,1,780,7,4334,0,70
780,89,1,781,2,4336,0,20
781,89,1,782,7,4343,164,70
782,89,1,783,3,4346,0,30
783,89,1,784,9,4355,98,90
784,89,1,785,2,4357,20,20
785,89,1,786,4,4361,0,40
786,89,1,787,3,4364,71,30
787,89,1,788,7,4371,62,70
788,89,1,789,2,4373,15,20
789,89,1,790,7,4380,0,70
790,89,1,791,4,4384,100,40
791,89,1,792,5,4389,0,50
792,89,1,793,8,4397,124,80
793,89,1,794,6,4403,0,60
794,89,1,795,6,4409,122,60
795,89,1,796,2,4411,22,20
796,89,1,797,2,4413,20,20
797,89,1,798,7,4420,77,70
798,89,1,799,7,4427,69,70
799,89,1,800,4,4431,44,40
800,89,1,801,2,4433,0,20
801,89,1,802,5,4438,0,50
802,89,1,803,6,4444,118,60
803,89,1,804,9,4453,91,90
804,89,1,805,2,4455,17,20
805,89,1,806,9,4464,84,90
806,89,1,807,4,4468,43,40
807,89,1,808,4,4472,42,40
808,89,1,809,2,4474,13,20
809,89,1,810,9,4483,90,90
810,89,1,811,9,4492,0,90
811,89,1,812,2,4494,104,20
812,89,1,813,2,4496,24,20
813,89,1,814,6,4502,0,60
814,89,1,815,5,4507,104,50
815,89,1,816,7,4514,0,70
816,89,1,817,7,4521,0,70
817,89,1,818,2,4523,163,20
818,89,1,819,6,4529,62,60
819,89,1,820,8,4537,62,80
820,89,1,821,2,4539,0,20
821,89,1,822,4,4543,51,40
822,89,1,823,6,4549,65,60
823,89,1,824,4,4553,0,40
824,89,1,825,8,4561,128,80
825,89,1,826,8,4569,78,80
826,89,1,827,4,4573,0,40
827,89,1,828,3,4576,68,30
828,89,1,829,9,4585,0,90
829,89,1,830,8,4593,167,80
830,89,1,831,3,4596,31,30
831,89,1,832,4,4600,46,40
832,89,1,833,8,4608,0,80
833,89,1,834,4,4612,0,40
834,89,1,835,9,4621,0,90
835,89,1,836,7,4628,0,70
836,89,1,837,8,4636,368,80
837,89,1,838,3,4639,33,30
838,89,1,839,2,4641,36,20
839,89,1,840,3,4644,30,30
840,89,1,841,7,4651,66,70
841,89,1,842,4,4655,31,40
842,89,1,843,3,4658,0,30
843,89,1,844,4,4662,71,40
844,89,1,845,2,4664,0,20
845,89,1,846,5,4669,64,50
846,89,1,847,5,4674,0,50
847,89,1,848,7,4681,112,70
848,89,1,849,7,4688,77,70
849,89,1,850,6,4694,48,60
850,89,1,851,7,4701,69,70
851,89,1,852,4,4705,38,40
852,89,1,853,9,4714,106,90
853,89,1,854,8,4722,73,80
854,89,1,855,4,4726,37,40
855,89,1,856,3,4729,0,30
856,89,1,857,3,4732,68,30
857,89,1,858,6,4738,61,60
858,89,1,859,4,4742,43,40
859,89,1,860,7,4749,74,70
860,89,1,861,5,4754,49,50
861,89,1,862,2,4756,21,20
862,89,1,863,6,4762,67,60
863,89,1,864,6,4768,70,60
864,89,1,865,7,4775,60,70
865,89,1,866,8,4783,81,80
866,89,1,867,4,4787,32,40
867,89,1,868,9,4796,101,90
868,89,1,869,2,4798,17,20
869,89,1,870,7,4805,68,70
870,89,1,871,6,4811,62,60
871,89,1,872,3,4814,25,30
872,89,1,873,7,4821,0,70
873,89,1,874,3,4824,88,30
874,89,1,875,3,4827,0,30
875,89,1,876,2,4829,0,20
876,89,1,877,6,4835,91,60
877,89,1,878,5,4840,59,50
878,89,1,879,4,4844,42,40
879,89,1,880,7,4851,75,70
880,89,1,881,3,4854,0,30
881,89,1,882,6,4860,89,60
882,89,1,883,8,4868,71,80
883,89,1,884,8,4876,99,80
884,89,1,885,9,4885,108,90
885,89,1,886,9,4894,100,90
886,89,1,887,2,4896,0,20
887,89,1,888,5,4901,48,50
888,89,1,889,3,4904,36,30
889,89,1,890,8,4912,85,80
890,89,1,891,4,4916,31,40
891,89,1,892,6,4922,63,60
892,89,1,893,7,4929,63,70
893,89,1,894,8,4937,0,80
894,89,1,895,5,4942,139,50
895,89,1,896,9,4951,112,90
896,89,1,897,9,4960,108,90
897,89,1,898,8,4968,89,80
898,89,1,899,6,4974,0,60
899,89,1,900,2,4976,93,20
900,89,1,901,5,4981,56,50
901,89,1,902,4,4985,28,40
902,89,1,903,7,4992,0,70
903,89,1,904,4,4996,101,40
904,89,2,1,6,6,66,60
905,89,2,2,7,13,70,70
906,89,2,3,8,21,0,80
907,89,2,4,9,30,159,90
908,89,2,5,2,32,0,20
909,89,2,6,9,41,128,90
910,89,2,7,8,49,91,80
911,89,2,8,8,57,100,80
912,89,2,9,9,66,85,90
913,89,2,10,5,71,53,50
914,89,2,11,2,73,18,20
915,89,2,12,5,78,55,50
916,89,2,13,3,81,30,30
917,89,2,14,6,87,64,60
918,89,2,15,6,93,59,60
919,89,2,16,8,101,86,80
920,89,2,17,5,106,37,50
921,89,2,18,4,110,36,40
922,89,2,19,3,113,34,30
923,89,2,20,8,121,77,80
924,89,2,21,2,123,0,20
925,89,2,22,7,130,103,70
926,89,2,23,9,139,89,90
927,89,2,24,7,146,69,70
928,89,2,25,9,155,79,90
929,89,2,26,9,164,0,90
930,89,2,27,5,169,0,50
931,89,2,28,3,172,153,30
932,89,2,29,4,176,36,40
933,89,2,30,7,183,0,70
934,89,2,31,3,186,113,30
935,89,2,32,8,194,86,80
936,89,2,33,3,197,37,30
937,89,2,34,4,201,41,40
938,89,2,35,3,204,38,30
939,89,2,36,8,212,83,80
940,89,2,37,6,218,0,60
941,89,2,38,6,224,0,60
942,89,2,39,5,229,167,50
943,89,2,40,9,238,85,90
944,89,2,41,4,242,41,40
945,89,2,42,4,246,0,40
946,89,2,43,8,254,100,80
947,89,2,44,4,258,0,40
948,89,2,45,5,263,81,50
949,89,2,46,5,268,45,50
950,89,2,47,4,272,47,40
951,89,2,48,5,277,47,50
952,89,2,49,2,279,21,20
953,89,2,50,6,285,0,60
954,89,2,51,8,293,0,80
955,89,2,52,9,302,241,90
956,89,2,53,6,308,59,60
957,89,2,54,9,317,91,90
958,89,2,55,7,324,67,70
959,89,2,56,8,332,0,80
960,89,2,57,5,337,105,50
961,89,2,58,8,345,0,80
962,89,2,59,3,348,107,30
963,89,2,60,5,353,52,50
964,89,2,61,8,361,0,80
965,89,2,62,6,367,132,60
966,89,2,63,6,373,74,60
967,89,2,64,2,375,26,20
968,89,2,65,3,378,27,30
969,89,2,66,8,386,63,80
970,89,2,67,5,391,0,50
971,89,2,68,9,400,142,90
972,89,2,69,8,408,72,80
973,89,2,70,3,411,37,30
974,89,2,71,8,419,79,80
975,89,2,72,3,422,0,30
976,89,2,73,4,426,70,40
977,89,2,74,3,429,29,30
978,89,2,75,6,435,48,60
979,89,2,76,4,439,42,40
980,89,2,77,5,444,0,50
981,89,2,78,2,446,0,20
982,89,2,79,7,453,137,70
983,89,2,80,6,459,64,60
984,89,2,81,7,466,66,70
985,89,2,82,6,472,58,60
986,89,2,83,5,477,46,50
987,89,2,84,2,479,15,20
988,89,2,85,9,488,75,90
989,89,2,86,4,492,0,40
990,89,2,87,6,498,90,60
991,89,2,88,6,504,75,60
992,89,2,89,3,507,24,30
993,89,2,90,3,510,0,30
994,89,2,91,5,515,79,50
995,89,2,92,8,523,71,80
996,89,2,93,8,531,0,80
997,89,2,94,3,534,116,30
998,89,2,95,3,537,0,30
999,89,2,96,9,546,118,90
1000,89,2,97,8,554,90,80
1001,89,2,98,5,559,46,50
1002,89,2,99,9,568,96,90
1003,89,2,100,3,571,23,30
1004,89,2,101,3,574,25,30
1005,89,2,102,6,580,46,60
1006,89,2,103,7,587,79,70
1007,89,2,104,8,595,71,80
1008,89,2,105,3,598,27,30
1009,89,2,106,2,600,14,20
1010,89,2,107,7,607,70,70
1011,89,2,108,7,614,0,70
1012,89,2,109,6,620,0,60
1013,89,2,110,6,626,185,60
1014,89,2,111,9,635,0,90
1015,89,2,112,7,642,148,70
1016,89,2,113,7,649,67,70
1017,89,2,114,6,655,58,60
1018,89,2,115,3,658,40,30
1019,89,2,116,8,666,94,80
1020,89,2,117,3,669,0,30
1021,89,2,118,9,678,116,90
1022,89,2,119,2,680,0,20
1023,89,2,120,3,683,45,30
1024,89,2,121,5,688,61,50
1025,89,2,122,9,697,79,90
1026,89,2,123,2,699,15,20
1027,89,2,124,5,704,49,50
1028,89,2,125,6,710,66,60
1029,89,2,126,4,714,44,40
1030,89,2,127,5,719,44,50
1031,89,2,128,9,728,0,90
1032,89,2,129,5,733,0,50
1033,89,2,130,7,740,201,70
1034,89,2,131,4,744,0,40
1035,89,2,132,4,748,89,40
1036,89,2,133,5,753,39,50
1037,89,2,134,5,758,0,50
1038,89,2,135,3,761,79,30
1039,89,2,136,8,769,0,80
1040,89,2,137,5,774,134,50
1041,89,2,138,9,783,92,90
1042,89,2,139,9,792,92,90
1043,89,2,140,4,796,33,40
1044,89,2,141,9,805,0,90
1045,89,2,142,7,812,156,70
1046,89,2,143,4,816,43,40
1047,89,2,144,8,824,96,80
1048,89,2,145,9,833,0,90
1049,89,2,146,3,836,119,30
1050,89,2,147,8,844,0,80
1051,89,2,148,9,853,161,90
1052,89,2,149,4,857,45,40
1053,89,2,150,9,866,0,90
1054,89,2,151,6,872,0,60
1055,89,2,152,4,876,199,40
1056,89,2,153,2,878,19,20
1057,89,2,154,5,883,63,50
1058,89,2,155,2,885,11,20
1059,89,2,156,7,892,0,70
1060,89,2,157,8,900,122,80
1061,89,2,158,8,908,0,80
1062,89,2,159,3,911,101,30
1063,89,2,160,6,917,0,60
1064,89,2,161,2,919,0,20
1065,89,2,162,3,922,100,30
1066,89,2,163,3,925,19,30
1067,89,2,164,9,934,91,90
1068,89,2,165,4,938,40,40
1069,89,2,166,7,945,67,70
1070,89,2,167,4,949,37,40
1071,89,2,168,7,956,0,70
1072,89,2,169,8,964,0,80
1073,89,2,170,3,967,153,30
1074,89,2,171,8,975,76,80
1075,89,2,172,8,983,65,80
1076,89,2,173,6,989,55,60
1077,89,2,174,4,993,0,40
1078,89,2,175,2,995,67,20
1079,89,2,176,8,1003,74,80
1080,89,2,177,8,1011,72,80
1081,89,2,178,2,1013,20,20
1082,89,2,179,8,1021,87,80
1083,89,2,180,7,1028,79,70
1084,89,2,181,4,1032,44,40
1085,89,2,182,4,1036,31,40
1086,89,2,183,4,1040,34,40
1087,89,2,184,7,1047,78,70
1088,89,2,185,7,1054,0,70
1089,89,2,186,4,1058,121,40
1090,89,2,187,4,1062,40,40
1091,89,2,188,3,1065,29,30
1092,89,2,189,7,1072,61,70
1093,89,2,190,5,1077,35,50
1094,89,2,191,6,1083,72,60
1095,89,2,192,9,1092,78,90
1096,89,2,193,9,1101,87,90
1097,89,2,194,3,1104,33,30
1098,89,2,195,3,1107,0,30
1099,89,2,196,3,1110,50,30
1100,89,2,197,3,1113,33,30
1101,89,2,198,7,1120,85,70
1102,89,2,199,4,1124,0,40
1103,89,2,200,4,1128,76,40
1104,89,2,201,9,1137,90,90
1105,89,2,202,7,1144,76,70
1106,89,2,203,4,1148,42,40
1107,89,2,204,5,1153,0,50
1108,89,2,205,2,1155,64,20
1109,89,2,206,8,1163,76,80
1110,89,2,207,5,1168,50,50
1111,89,2,208,4,1172,41,40
1112,89,2,209,8,1180,74,80
1113,89,2,210,2,1182,18,20
1114,89,2,211,9,1191,91,90
1115,89,2,212,2,1193,24,20
1116,89,2,213,8,1201,78,80
1117,89,2,214,3,1204,0,30
1118,89,2,215,2,1206,47,20
1119,89,2,216,9,1215,101,90
1120,89,2,217,2,1217,20,20
1121,89,2,218,3,1220,31,30
1122,89,2,219,2,1222,0,20
1123,89,2,220,2,1224,32,20
1124,89,2,221,6,1230,66,60
1125,89,2,222,3,1233,22,30
1126,89,2,223,2,1235,0,20
1127,89,2,224,9,1244,101,90
1128,89,2,225,9,1253,0,90
1129,89,2,226,8,1261,0,80
1130,89,2,227,4,1265,222,40
1131,89,2,228,3,1268,28,30
1132,89,2,229,7,1275,0,70
1133,89,2,230,5,1280,0,50
1134,89,2,231,8,1288,210,80
1135,89,2,232,4,1292,39,40
1136,89,2,233,8,1300,83,80
1137,89,2,234,6,1306,63,60
1138,89,2,235,6,1312,48,60
1139,89,2,236,2,1314,20,20
1140,89,2,237,2,1316,20,20
1141,89,2,238,5,1321,51,50
1142,89,2,239,5,1326,45,50
1143,89,2,240,5,1331,49,50
1144,89,2,241,6,1337,69,60
1145,89,2,242,2,1339,14,20
1146,89,2,243,3,1342,0,30
1147,89,2,244,9,1351,127,90
1148,89,2,245,2,1353,18,20
1149,89,2,246,5,1358,51,50
1150,89,2,247,6,1364,64,60
1151,89,2,248,2,1366,0,20
1152,89,2,249,4,1370,68,40
1153,89,2,250,9,1379,86,90
1154,89,2,251,5,1384,54,50
1155,89,2,252,2,1386,0,20
1156,89,2,253,3,1389,42,30
1157,89,2,254,2,1391,0,20
1158,89,2,255,3,1394,0,30
1159,89,2,256,7,1401,139,70
1160,89,2,257,5,1406,54,50
1161,89,2,258,2,1408,20,20
1162,89,2,259,4,1412,0,40
1163,89,2,260,5,1417,96,50
1164,89,2,261,4,1421,0,40
1165,89,2,262,5,1426,0,50
1166,89,2,263,5,1431,150,50
1167,89,2,264,3,1434,0,30
1168,89,2,265,3,1437,0,30
1169,89,2,266,3,1440,0,30
1170,89,2,267,9,1449,198,90
1171,89,2,268,5,1454,44,50
1172,89,2,269,5,1459,53,50
1173,89,2,270,7,1466,81,70
1174,89,2,271,3,1469,0,30
1175,89,2,272,7,1476,108,70
1176,89,2,273,9,1485,0,90
1177,89,2,274,6,1491,161,60
1178,89,2,275,4,1495,34,40
1179,89,2,276,6,1501,48,60
1180,89,2,277,6,1507,54,60
1181,89,2,278,2,1509,0,20
1182,89,2,279,7,1516,85,70
1183,89,2,280,9,1525,94,90
1184,89,2,281,5,1530,49,50
1185,89,2,282,9,1539,83,90
1186,89,2,283,5,1544,44,50
1187,89,2,284,9,1553,104,90
1188,89,2,285,7,1560,67,70
1189,89,2,286,5,1565,51,50
1190,89,2,287,6,1571,60,60
1191,89,2,288,8,1579,79,80
1192,89,2,289,9,1588,74,90
1193,89,2,290,8,1596,74,80
1194,89,2,291,5,1601,57,50
1195,89,2,292,4,1605,45,40
1196,89,2,293,8,1613,74,80
1197,89,2,294,6,1619,0,60
1198,89,2,295,6,1625,126,60
1199,89,2,296,6,1631,49,60
1200,89,2,297,9,1640,95,90
1201,89,2,298,6,1646,0,60
1202,89,2,299,5,1651,0,50
1203,89,2,300,6,1657,157,60
1204,89,2,301,2,1659,0,20
1205,89,2,302,2,1661,46,20
1206,89,2,303,7,1668,85,70
1207,89,2,304,5,1673,45,50
1208,89,2,305,3,1676,0,30
1209,89,2,306,2,1678,58,20
1210,89,2,307,5,1683,48,50
1211,89,2,308,4,1687,39,40
1212,89,2,309,9,1696,69,90
1213,89,2,310,3,1699,0,30
1214,89,2,311,4,1703,66,40
1215,89,2,312,4,1707,38,40
1216,89,2,313,2,1709,24,20
1217,89,2,314,4,1713,42,40
1218,89,2,315,5,1718,0,50
1219,89,2,316,5,1723,0,50
1220,89,2,317,6,1729,157,60
1221,89,2,318,5,1734,0,50
1222,89,2,319,4,1738,94,40
1223,89,2,320,8,1746,89,80
1224,89,2,321,8,1754,78,80
1225,89,2,322,5,1759,46,50
1226,89,2,323,2,1761,23,20
1227,89,2,324,6,1767,0,60
1228,89,2,325,7,1774,0,70
1229,89,2,326,9,1783,0,90
1230,89,2,327,9,1792,307,90
1231,89,2,328,6,1798,62,60
1232,89,2,329,2,1800,0,20
1233,89,2,330,9,1809,96,90
1234,89,2,331,9,1818,83,90
1235,89,2,332,9,1827,109,90
1236,89,2,333,9,1836,103,90
1237,89,2,334,8,1844,85,80
1238,89,2,335,2,1846,18,20
1239,89,2,336,4,1850,44,40
1240,89,2,337,7,1857,0,70
1241,89,2,338,4,1861,122,40
1242,89,2,339,4,1865,38,40
1243,89,2,340,6,1871,54,60
1244,89,2,341,9,1880,98,90
1245,89,2,342,3,1883,24,30
1246,89,2,343,4,1887,48,40
1247,89,2,344,3,1890,24,30
1248,89,2,345,2,1892,19,20
1249,89,2,346,5,1897,51,50
1250,89,2,347,2,1899,20,20
1251,89,2,348,5,1904,46,50
1252,89,2,349,9,1913,100,90
1253,89,2,350,8,1921,0,80
1254,89,2,351,3,1924,111,30
1255,89,2,352,9,1933,93,90
1256,89,2,353,2,1935,23,20
1257,89,2,354,7,1942,72,70
1258,89,2,355,9,1951,90,90
1259,89,2,356,9,1960,0,90
1260,89,2,357,5,1965,0,50
1261,89,2,358,6,1971,190,60
1262,89,2,359,9,1980,96,90
1263,89,2,360,9,1989,0,90
1264,89,2,361,9,1998,210,90
1265,89,2,362,8,2006,0,80
1266,89,2,363,7,2013,140,70
1267,89,2,364,5,2018,53,50
1268,89,2,365,8,2026,88,80
1269,89,2,366,3,2029,31,30
1270,89,2,367,5,2034,45,50
1271,89,2,368,3,2037,43,30
1272,89,2,369,9,2046,0,90
1273,89,2,370,5,2051,129,50
1274,89,2,371,5,2056,49,50
1275,89,2,372,2,2058,0,20
1276,89,2,373,2,2060,38,20
1277,89,2,374,3,2063,30,30
1278,89,2,375,8,2071,0,80
1279,89,2,376,4,2075,114,40
1280,89,2,377,4,2079,51,40
1281,89,2,378,3,2082,28,30
1282,89,2,379,3,2085,25,30
1283,89,2,380,4,2089,43,40
1284,89,2,381,2,2091,18,20
1285,89,2,382,4,2095,46,40
1286,89,2,383,4,2099,42,40
1287,89,2,384,5,2104,51,50
1288,89,2,385,9,2113,76,90
1289,89,2,386,2,2115,15,20
1290,89,2,387,5,2120,51,50
1291,89,2,388,3,2123,21,30
1292,89,2,389,7,2130,0,70
1293,89,2,390,4,2134,129,40
1294,89,2,391,5,2139,59,50
1295,89,2,392,2,2141,23,20
1296,89,2,393,5,2146,43,50
1297,89,2,394,7,2153,84,70
1298,89,2,395,3,2156,0,30
1299,89,2,396,2,2158,58,20
1300,89,2,397,5,2163,47,50
1301,89,2,398,3,2166,30,30
1302,89,2,399,5,2171,0,50
1303,89,2,400,5,2176,104,50
1304,89,2,401,2,2178,21,20
1305,89,2,402,6,2184,71,60
1306,89,2,403,9,2193,101,90
1307,89,2,404,8,2201,71,80
1308,89,2,405,2,2203,18,20
1309,89,2,406,8,2211,0,80
1310,89,2,407,6,2217,151,60
1311,89,2,408,7,2224,70,70
1312,89,2,409,5,2229,58,50
1313,89,2,410,7,2236,75,70
1314,89,2,411,5,2241,0,50
1315,89,2,412,2,2243,70,20
1316,89,2,413,2,2245,0,20
1317,89,2,414,6,2251,88,60
1318,89,2,415,4,2255,38,40
1319,89,2,416,3,2258,0,30
1320,89,2,417,6,2264,0,60
1321,89,2,418,6,2270,143,60
1322,89,2,419,3,2273,22,30
1323,89,2,420,3,2276,24,30
1324,89,2,421,7,2283,68,70
1325,89,2,422,2,2285,24,20
1326,89,2,423,2,2287,22,20
1327,89,2,424,6,2293,59,60
1328,89,2,425,2,2295,20,20
1329,89,2,426,2,2297,29,20
1330,89,2,427,6,2303,55,60
1331,89,2,428,9,2312,0,90
1332,89,2,429,2,2314,120,20
1333,89,2,430,8,2322,82,80
1334,89,2,431,2,2324,21,20
1335,89,2,432,9,2333,0,90
1336,89,2,433,8,2341,162,80
1337,89,2,434,6,2347,62,60
1338,89,2,435,9,2356,94,90
1339,89,2,436,5,2361,50,50
1340,89,2,437,2,2363,15,20
1341,89,2,438,4,2367,0,40
1342,89,2,439,4,2371,66,40
1343,89,2,440,8,2379,0,80
1344,89,2,441,3,2382,86,30
1345,89,2,442,2,2384,22,20
1346,89,2,443,3,2387,0,30
1347,89,2,444,8,2395,114,80
1348,89,2,445,4,2399,41,40
1349,89,2,446,5,2404,51,50
1350,89,2,447,6,2410,62,60
1351,89,2,448,5,2415,37,50
1352,89,2,449,7,2422,54,70
1353,89,2,450,8,2430,77,80
1354,89,2,451,4,2434,44,40
1355,89,2,452,2,2436,25,20
1356,89,2,453,4,2440,38,40
1357,89,2,454,7,2447,66,70
1358,89,2,455,7,2454,64,70
1359,89,2,456,6,2460,48,60
1360,89,2,457,4,2464,35,40
1361,89,2,458,4,2468,39,40
1362,89,2,459,7,2475,64,70
1363,89,2,460,6,2481,58,60
1364,89,2,461,4,2485,41,40
1365,89,2,462,6,2491,0,60
1366,89,2,463,9,2500,153,90
1367,89,2,464,2,2502,21,20
1368,89,2,465,8,2510,91,80
1369,89,2,466,3,2513,0,30
1370,89,2,467,4,2517,69,40
1371,89,2,468,9,2526,100,90
1372,89,2,469,7,2533,75,70
1373,89,2,470,6,2539,63,60
1374,89,2,471,5,2544,59,50
1375,89,2,472,4,2548,0,40
1376,89,2,473,6,2554,0,60
1377,89,2,474,5,2559,0,50
1378,89,2,475,6,2565,209,60
1379,89,2,476,2,2567,11,20
1380,89,2,477,7,2574,78,70
1381,89,2,478,5,2579,46,50
1382,89,2,479,8,2587,0,80
1383,89,2,480,6,2593,147,60
1384,89,2,481,2,2595,13,20
1385,89,2,482,3,2598,39,30
1386,89,2,483,8,2606,74,80
1387,89,2,484,3,2609,0,30
1388,89,2,485,6,2615,96,60
1389,89,2,486,3,2618,29,30
1390,89,2,487,5,2623,0,50
1391,89,2,488,2,2625,78,20
1392,89,2,489,2,2627,0,20
1393,89,2,490,2,2629,38,20
1394,89,2,491,6,2635,60,60
1395,89,2,492,9,2644,79,90
1396,89,2,493,2,2646,21,20
1397,89,2,494,2,2648,31,20
1398,89,2,495,2,2650,0,20
1399,89,2,496,9,2659,100,90
1400,89,2,497,3,2662,23,30
1401,89,2,498,6,2668,47,60
1402,89,2,499,5,2673,57,50
1403,89,2,500,2,2675,16,20
1404,89,2,501,8,2683,88,80
1405,89,2,502,6,2689,58,60
1406,89,2,503,6,2695,63,60
1407,89,2,504,8,2703,89,80
1408,89,2,505,6,2709,64,60
1409,89,2,506,4,2713,45,40
1410,89,2,507,5,2718,67,50
1411,89,2,508,3,2721,0,30
1412,89,2,509,4,2725,0,40
1413,89,2,510,6,2731,125,60
1414,89,2,511,8,2739,83,80
1415,89,2,512,4,2743,40,40
1416,89,2,513,3,2746,19,30
1417,89,2,514,2,2748,0,20
1418,89,2,515,6,2754,87,60
1419,89,2,516,2,2756,15,20
1420,89,2,517,9,2765,0,90
1421,89,2,518,7,2772,161,70
1422,89,2,519,4,2776,47,40
1423,89,2,520,3,2779,31,30
1424,89,2,521,6,2785,0,60
1425,89,2,522,8,2793,144,80
1426,89,2,523,3,2796,34,30
1427,89,2,524,4,2800,38,40
1428,89,2,525,2,2802,25,20
1429,89,2,526,5,2807,46,50
1430,89,2,527,7,2814,53,70
1431,89,2,528,4,2818,0,40
1432,89,2,529,6,2824,0,60
1433,89,2,530,6,2830,0,60
1434,89,2,531,8,2838,259,80
1435,89,2,532,6,2844,0,60
1436,89,2,533,7,2851,124,70
1437,89,2,534,9,2860,71,90
1438,89,2,535,6,2866,74,60
1439,89,2,536,6,2872,54,60
1440,89,2,537,7,2879,71,70
1441,89,2,538,2,2881,15,20
1442,89,2,539,5,2886,0,50
1443,89,2,540,7,2893,107,70
1444,89,2,541,4,2897,0,40
1445,89,2,542,3,2900,63,30
1446,89,2,543,3,2903,29,30
1447,89,2,544,6,2909,54,60
1448,89,2,545,3,2912,0,30
1449,89,2,546,9,2921,131,90
1450,89,2,547,5,2926,54,50
1451,89,2,548,6,2932,61,60
1452,89,2,549,5,2937,0,50
1453,89,2,550,3,2940,68,30
1454,89,2,551,9,2949,0,90
1455,89,2,552,7,2956,160,70
1456,89,2,553,9,2965,91,90
1457,89,2,554,9,2974,98,90
1458,89,2,555,8,2982,79,80
1459,89,2,556,7,2989,62,70
1460,89,2,557,7,2996,71,70
1461,89,2,558,2,2998,21,20
1462,89,2,559,3,3001,32,30
1463,89,2,560,7,3008,0,70
1464,89,2,561,5,3013,124,50
1465,89,2,562,9,3022,0,90
1466,89,2,563,9,3031,161,90
1467,89,2,564,3,3034,0,30
1468,89,2,565,9,3043,0,90
1469,89,2,566,6,3049,167,60
1470,89,2,567,2,3051,24,20
1471,89,2,568,4,3055,0,40
1472,89,2,569,5,3060,91,50
1473,89,2,570,3,3063,0,30
1474,89,2,571,5,3068,77,50
1475,89,2,572,2,3070,21,20
1476,89,2,573,6,3076,58,60
1477,89,2,574,6,3082,0,60
1478,89,2,575,6,3088,109,60
1479,89,2,576,4,3092,48,40
1480,89,2,577,5,3097,0,50
1481,89,2,578,3,3100,77,30
1482,89,2,579,7,3107,63,70
1483,89,2,580,6,3113,64,60
1484,89,2,581,2,3115,0,20
1485,89,2,582,6,3121,81,60
1486,89,2,583,9,3130,92,90
1487,89,2,584,9,3139,98,90
1488,89,2,585,6,3145,57,60
1489,89,2,586,4,3149,38,40
1490,89,2,587,2,3151,0,20
1491,89,2,588,9,3160,110,90
1492,89,2,589,4,3164,46,40
1493,89,2,590,6,3170,0,60
1494,89,2,591,5,3175,102,50
1495,89,2,592,9,3184,89,90
1496,89,2,593,7,3191,83,70
1497,89,2,594,6,3197,62,60
1498,89,2,595,8,3205,78,80
1499,89,2,596,7,3212,0,70
1500,89,2,597,9,3221,161,90
1501,89,2,598,9,3230,85,90
1502,89,2,599,5,3235,43,50
1503,89,2,600,6,3241,0,60
1504,89,2,601,7,3248,123,70
1505,89,2,602,7,3255,0,70
1506,89,2,603,8,3263,0,80
1507,89,2,604,3,3266,177,30
1508,89,2,605,9,3275,98,90
1509,89,2,606,4,3279,45,40
1510,89,2,607,4,3283,35,40
1511,89,2,608,4,3287,38,40
1512,89,2,609,7,3294,78,70
1513,89,2,610,5,3299,50,50
1514,89,2,611,8,3307,91,80
1515,89,2,612,5,3312,58,50
1516,89,2,613,3,3315,35,30
1517,89,2,614,3,3318,38,30
1518,89,2,615,3,3321,29,30
1519,89,2,616,4,3325,30,40
1520,89,2,617,7,3332,66,70
1521,89,2,618,9,3341,0,90
1522,89,2,619,8,3349,0,80
1523,89,2,620,6,3355,218,60
1524,89,2,621,5,3360,58,50
1525,89,2,622,3,3363,0,30
1526,89,2,623,7,3370,111,70
1527,89,2,624,9,3379,82,90
1528,89,2,625,4,3383,50,40
1529,89,2,626,9,3392,107,90
1530,89,2,627,7,3399,66,70
1531,89,2,628,9,3408,0,90
1532,89,2,629,3,3411,120,30
1533,89,2,630,2,3413,0,20
1534,89,2,631,4,3417,56,40
1535,89,2,632,2,3419,22,20
1536,89,2,633,5,3424,62,50
1537,89,2,634,8,3432,80,80
1538,89,2,635,2,3434,18,20
1539,89,2,636,6,3440,68,60
1540,89,2,637,4,3444,39,40
1541,89,2,638,3,3447,0,30
1542,89,2,639,7,3454,102,70
1543,89,2,640,2,3456,24,20
1544,89,2,641,2,3458,21,20
1545,89,2,642,3,3461,22,30
1546,89,2,643,9,3470,0,90
1547,89,2,644,2,3472,116,20
1548,89,2,645,9,3481,88,90
1549,89,2,646,3,3484,24,30
1550,89,2,647,8,3492,0,80
1551,89,2,648,4,3496,117,40
1552,89,2,649,8,3504,81,80
1553,89,2,650,4,3508,31,40
1554,89,2,651,2,3510,0,20
1555,89,2,652,2,3512,0,20
1556,89,2,653,4,3516,76,40
1557,89,2,654,3,3519,0,30
1558,89,2,655,9,3528,124,90
1559,89,2,656,6,3534,50,60
1560,89,2,657,8,3542,0,80
1561,89,2,658,7,3549,144,70
1562,89,2,659,7,3556,71,70
1563,89,2,660,5,3561,0,50
1564,89,2,661,4,3565,86,40
1565,89,2,662,9,3574,67,90
1566,89,2,663,5,3579,39,50
1567,89,2,664,5,3584,0,50
1568,89,2,665,3,3587,79,30
1569,89,2,666,5,3592,44,50
1570,89,2,667,6,3598,54,60
1571,89,2,668,4,3602,41,40
1572,89,2,669,8,3610,90,80
1573,89,2,670,3,3613,39,30
1574,89,2,671,4,3617,0,40
1575,89,2,672,3,3620,67,30
1576,89,2,673,9,3629,91,90
1577,89,2,674,6,3635,0,60
1578,89,2,675,9,3644,139,90
1579,89,2,676,8,3652,82,80
1580,89,2,677,4,3656,43,40
1581,89,2,678,6,3662,0,60
1582,89,2,679,5,3667,0,50
1583,89,2,680,5,3672,157,50
1584,89,2,681,8,3680,73,80
1585,89,2,682,8,3688,54,80
1586,89,2,683,9,3697,94,90
1587,89,2,684,9,3706,0,90
1588,89,2,685,2,3708,121,20
1589,89,2,686,5,3713,39,50
1590,89,2,687,6,3719,69,60
1591,89,2,688,6,3725,53,60
1592,89,2,689,8,3733,86,80
1593,89,2,690,2,3735,33,20
1594,89,2,691,3,3738,23,30
1595,89,2,692,5,3743,49,50
1596,89,2,693,2,3745,15,20
1597,89,2,694,7,3752,0,70
1598,89,2,695,4,3756,122,40
1599,89,2,696,2,3758,19,20
1600,89,2,697,2,3760,27,20
1601,89,2,698,7,3767,68,70
1602,89,2,699,8,3775,89,80
1603,89,2,700,8,3783,83,80
1604,89,2,701,2,3785,19,20
1605,89,2,702,4,3789,42,40
1606,89,2,703,8,3797,92,80
1607,89,2,704,3,3800,24,30
1608,89,2,705,8,3808,81,80
1609,89,2,706,8,3816,71,80
1610,89,2,707,7,3823,58,70
1611,89,2,708,2,3825,28,20
1612,89,2,709,2,3827,0,20
1613,89,2,710,8,3835,88,80
1614,89,2,711,2,3837,20,20
1615,89,2,712,3,3840,23,30
1616,89,2,713,9,3849,105,90
1617,89,2,714,4,3853,40,40
1618,89,2,715,8,3861,0,80
1619,89,2,716,9,3870,195,90
1620,89,2,717,8,3878,62,80
1621,89,2,718,9,3887,0,90
1622,89,2,719,9,3896,158,90
1623,89,2,720,6,3902,68,60
1624,89,2,721,4,3906,36,40
1625,89,2,722,7,3913,70,70
1626,89,2,723,4,3917,39,40
1627,89,2,724,7,3924,75,70
1628,89,2,725,6,3930,52,60
1629,89,2,726,3,3933,41,30
1630,89,2,727,4,3937,0,40
1631,89,2,728,9,3946,138,90
1632,89,2,729,3,3949,0,30
1633,89,2,730,4,3953,0,40
1634,89,2,731,4,3957,102,40
1635,89,2,732,7,3964,92,70
1636,89,2,733,9,3973,0,90
1637,89,2,734,2,3975,0,20
1638,89,2,735,2,3977,118,20
1639,89,2,736,4,3981,51,40
1640,89,2,737,2,3983,0,20
1641,89,2,738,8,3991,91,80
1642,89,2,739,7,3998,66,70
1643,89,2,740,7,4005,0,70
1644,89,2,741,8,4013,143,80
1645,89,2,742,8,4021,0,80
1646,89,2,743,3,4024,0,30
1647,89,2,744,2,4026,122,20
1648,89,2,745,9,4035,91,90
1649,89,2,746,5,4040,44,50
1650,89,2,747,7,4047,83,70
1651,89,2,748,4,4051,37,40
1652,89,2,749,7,4058,76,70
1653,89,2,750,4,4062,50,40
1654,89,2,751,7,4069,68,70
1655,89,2,752,2,4071,0,20
1656,89,2,753,9,4080,0,90
1657,89,2,754,7,4087,0,70
1658,89,2,755,2,4089,193,20
1659,89,2,756,3,4092,0,30
1660,89,2,757,9,4101,0,90
1661,89,2,758,2,4103,145,20
1662,89,2,759,6,4109,0,60
1663,89,2,760,8,4117,156,80
1664,89,2,761,9,4126,98,90
1665,89,2,762,8,4134,86,80
1666,89,2,763,3,4137,24,30
1667,89,2,764,2,4139,25,20
1668,89,2,765,4,4143,43,40
1669,89,2,766,6,4149,63,60
1670,89,2,767,5,4154,44,50
1671,89,2,768,5,4159,53,50
1672,89,2,769,3,4162,26,30
1673,89,2,770,6,4168,0,60
1674,89,2,771,2,4170,83,20
1675,89,2,772,6,4176,68,60
1676,89,2,773,2,4178,21,20
1677,89,2,774,2,4180,0,20
1678,89,2,775,5,4185,71,50
1679,89,2,776,2,4187,19,20
1680,89,2,777,4,4191,47,40
1681,89,2,778,7,4198,81,70
1682,89,2,779,8,4206,83,80
1683,89,2,780,8,4214,73,80
1684,89,2,781,9,4223,104,90
1685,89,2,782,4,4227,41,40
1686,89,2,783,4,4231,44,40
1687,89,2,784,7,4238,75,70
1688,89,2,785,2,4240,18,20
1689,89,2,786,8,4248,68,80
1690,89,2,787,5,4253,0,50
1691,89,2,788,2,4255,75,20
1692,89,2,789,9,4264,97,90
1693,89,2,790,4,4268,0,40
1694,89,2,791,9,4277,126,90
1695,89,2,792,5,4282,48,50
1696,89,2,793,3,4285,0,30
1697,89,2,794,8,4293,0,80
1698,89,2,795,2,4295,0,20
1699,89,2,796,5,4300,190,50
1700,89,2,797,9,4309,103,90
1701,89,2,798,3,4312,31,30
1702,89,2,799,5,4317,53,50
1703,89,2,800,8,4325,89,80
1704,89,2,801,4,4329,0,40
1705,89,2,802,7,4336,121,70
1706,89,2,803,4,4340,38,40
1707,89,2,804,5,4345,43,50
1708,89,2,805,9,4354,0,90
1709,89,2,806,7,4361,166,70
1710,89,2,807,6,4367,58,60
1711,89,2,808,6,4373,61,60
1712,89,2,809,8,4381,0,80
1713,89,2,810,7,4388,154,70
1714,89,2,811,8,4396,88,80
1715,89,2,812,3,4399,31,30
1716,89,2,813,5,4404,0,50
1717,89,2,814,6,4410,105,60
1718,89,2,815,5,4415,43,50
1719,89,2,816,5,4420,0,50
1720,89,2,817,2,4422,65,20
1721,89,2,818,7,4429,72,70
1722,89,2,819,3,4432,24,30
1723,89,2,820,6,4438,51,60
1724,89,2,821,4,4442,34,40
1725,89,2,822,9,4451,0,90
1726,89,2,823,5,4456,127,50
1727,89,2,824,4,4460,50,40
1728,89,2,825,5,4465,50,50
1729,89,2,826,7,4472,66,70
1730,89,2,827,7,4479,74,70
1731,89,2,828,6,4485,63,60
1732,89,2,829,2,4487,15,20
1733,89,2,830,9,4496,84,90
1734,89,2,831,2,4498,20,20
1735,89,2,832,2,4500,12,20
1736,89,2,833,4,4504,46,40
1737,89,2,834,2,4506,17,20
1738,89,2,835,3,4509,0,30
1739,89,2,836,7,4516,103,70
1740,89,2,837,5,4521,0,50
1741,89,2,838,8,4529,125,80
1742,89,2,839,9,4538,84,90
1743,89,2,840,9,4547,0,90
1744,89,2,841,2,4549,117,20
1745,89,2,842,8,4557,0,80
1746,89,2,843,5,4562,0,50
1747,89,2,844,5,4567,215,50
1748,89,2,845,2,4569,18,20
1749,89,2,846,4,4573,0,40
1750,89,2,847,8,4581,112,80
1751,89,2,848,3,4584,32,30
1752,89,2,849,4,4588,54,40
1753,89,2,850,5,4593,51,50
1754,89,2,851,5,4598,45,50
1755,89,2,852,5,4603,46,50
1756,89,2,853,5,4608,43,50
1757,89,2,854,3,4611,29,30
1758,89,2,855,4,4615,41,40
1759,89,2,856,7,4622,74,70
1760,89,2,857,5,4627,46,50
1761,89,2,858,5,4632,38,50
1762,89,2,859,4,4636,32,40
1763,89,2,860,4,4640,0,40
1764,89,2,861,5,4645,100,50
1765,89,2,862,7,4652,0,70
1766,89,2,863,8,4660,174,80
1767,89,2,864,2,4662,11,20
1768,89,2,865,7,4669,77,70
1769,89,2,866,9,4678,86,90
1770,89,2,867,9,4687,89,90
1771,89,2,868,2,4689,27,20
1772,89,2,869,9,4698,82,90
1773,89,2,870,4,4702,0,40
1774,89,2,871,9,4711,136,90
1775,89,2,872,6,4717,64,60
1776,89,2,873,3,4720,0,30
1777,89,2,874,2,4722,0,20
1778,89,2,875,8,4730,124,80
1779,89,2,876,8,4738,79,80
1780,89,2,877,5,4743,50,50
1781,89,2,878,6,4749,66,60
1782,89,2,879,5,4754,0,50
1783,89,2,880,6,4760,103,60
1784,89,2,881,3,4763,0,30
1785,89,2,882,8,4771,123,80
1786,89,2,883,9,4780,93,90
1787,89,2,884,4,4784,38,40
1788,89,2,885,5,4789,62,50
1789,89,2,886,7,4796,78,70
1790,89,2,887,5,4801,53,50
1791,89,2,888,5,4806,50,50
1792,89,2,889,4,4810,49,40
1793,89,2,890,3,4813,31,30
1794,89,2,891,6,4819,62,60
1795,89,2,892,2,4821,0,20
1796,89,2,893,6,4827,71,60
1797,89,2,894,9,4836,91,90
1798,89,2,895,6,4842,64,60
1799,89,2,896,4,4846,41,40
1800,89,2,897,7,4853,72,70
1801,89,2,898,9,4862,0,90
1802,89,2,899,6,4868,176,60
1803,89,2,900,3,4871,19,30
1804,89,2,901,5,4876,48,50
1805,89,2,902,9,4885,90,90
1806,89,2,903,9,4894,99,90
1807,89,2,904,7,4901,79,70
1808,89,2,905,8,4909,100,80
1809,89,2,906,3,4912,26,30
1810,89,2,907,8,4920,0,80
1811,89,2,908,9,4929,195,90
1812,89,2,909,5,4934,0,50
1813,89,2,910,9,4943,139,90
1814,89,2,911,8,4951,81,80
1815,89,2,912,7,4958,0,70
1816,89,2,913,3,4961,0,30
1817,89,2,914,3,4964,0,30
1818,89,2,915,4,4968,180,40
1819,89,2,916,6,4974,51,60
1820,89,2,917,5,4979,41,50
1821,89,2,918,4,4983,35,40
1822,89,2,919,5,4988,0,50
1823,89,2,920,5,4993,0,50
1824,89,3,1,4,4,0,40
1825,89,3,2,8,12,126,80
1826,89,3,3,3,15,35,30
1827,89,3,4,6,21,51,60
1828,89,3,5,6,27,56,60
1829,89,3,6,5,32,45,50
1830,89,3,7,3,35,29,30
1831,89,3,8,3,38,26,30
1832,89,3,9,8,46,75,80
1833,89,3,10,9,55,84,90
1834,89,3,11,8,63,94,80
1835,89,3,12,6,69,61,60
1836,89,3,13,4,73,30,40
1837,89,3,14,2,75,0,20
1838,89,3,15,7,82,86,70
1839,89,3,16,8,90,68,80
1840,89,3,17,3,93,29,30
1841,89,3,18,8,101,0,80
1842,89,3,19,3,104,95,30
1843,89,3,20,9,113,83,90
1844,89,3,21,6,119,43,60
1845,89,3,22,7,126,84,70
1846,89,3,23,8,134,0,80
1847,89,3,24,2,136,113,20
1848,89,3,25,9,145,95,90
1849,89,3,26,2,147,15,20
1850,89,3,27,4,151,28,40
1851,89,3,28,9,160,70,90
1852,89,3,29,5,165,64,50
1853,89,3,30,7,172,0,70
1854,89,3,31,2,174,112,20
1855,89,3,32,4,178,53,40
1856,89,3,33,4,182,0,40
1857,89,3,34,5,187,102,50
1858,89,3,35,9,196,90,90
1859,89,3,36,5,201,59,50
1860,89,3,37,8,209,0,80
1861,89,3,38,7,216,140,70
1862,89,3,39,9,225,0,90
1863,89,3,40,8,233,0,80
1864,89,3,41,8,241,246,80
1865,89,3,42,6,247,72,60
1866,89,3,43,3,250,25,30
1867,89,3,44,6,256,73,60
1868,89,3,45,7,263,0,70
1869,89,3,46,2,265,83,20
1870,89,3,47,7,272,62,70
1871,89,3,48,2,274,32,20
1872,89,3,49,3,277,26,30
1873,89,3,50,8,285,68,80
1874,89,3,51,5,290,0,50
1875,89,3,52,4,294,95,40
1876,89,3,53,3,297,30,30
1877,89,3,54,5,302,53,50
1878,89,3,55,3,305,31,30
1879,89,3,56,2,307,17,20
1880,89,3,57,9,316,86,90
1881,89,3,58,4,320,0,40
1882,89,3,59,2,322,69,20
1883,89,3,60,4,326,40,40
1884,89,3,61,9,335,0,90
1885,89,3,62,2,337,0,20
1886,89,3,63,4,341,132,40
1887,89,3,64,3,344,36,30
1888,89,3,65,4,348,0,40
1889,89,3,66,7,355,0,70
1890,89,3,67,4,359,0,40
1891,89,3,68,7,366,246,70
1892,89,3,69,9,375,92,90
1893,89,3,70,7,382,68,70
1894,89,3,71,6,388,80,60
1895,89,3,72,7,395,72,70
1896,89,3,73,4,399,43,40
1897,89,3,74,9,408,0,90
1898,89,3,75,4,412,125,40
1899,89,3,76,7,419,63,70
1900,89,3,77,2,421,0,20
1901,89,3,78,6,427,79,60
1902,89,3,79,9,436,89,90
1903,89,3,80,2,438,0,20
1904,89,3,81,2,440,41,20
1905,89,3,82,4,444,42,40
1906,89,3,83,3,447,0,30
1907,89,3,84,7,454,98,70
1908,89,3,85,6,460,63,60
1909,89,3,86,8,468,0,80
1910,89,3,87,9,477,186,90
1911,89,3,88,2,479,23,20
1912,89,3,89,4,483,53,40
1913,89,3,90,5,488,46,50
1914,89,3,91,3,491,37,30
1915,89,3,92,8,499,84,80
1916,89,3,93,2,501,25,20
1917,89,3,94,8,509,92,80
1918,89,3,95,6,515,55,60
1919,89,3,96,7,522,0,70
1920,89,3,97,8,530,0,80
1921,89,3,98,5,535,195,50
1922,89,3,99,5,540,45,50
1923,89,3,100,9,549,92,90
1924,89,3,101,4,553,47,40
1925,89,3,102,2,555,0,20
1926,89,3,103,8,563,79,80
1927,89,3,104,9,572,113,90
1928,89,3,105,2,574,19,20
1929,89,3,106,7,581,0,70
1930,89,3,107,2,583,91,20
1931,89,3,108,7,590,0,70
1932,89,3,109,6,596,129,60
1933,89,3,110,3,599,27,30
1934,89,3,111,4,603,53,40
1935,89,3,112,3,606,27,30
1936,89,3,113,9,615,111,90
1937,89,3,114,4,619,35,40
1938,89,3,115,8,627,70,80
1939,89,3,116,3,630,0,30
1940,89,3,117,5,635,67,50
1941,89,3,118,8,643,80,80
1942,89,3,119,5,648,0,50
1943,89,3,120,5,653,94,50
1944,89,3,121,6,659,66,60
1945,89,3,122,5,664,47,50
1946,89,3,123,8,672,71,80
1947,89,3,124,9,681,88,90
1948,89,3,125,4,685,0,40
1949,89,3,126,4,689,79,40
1950,89,3,127,6,695,65,60
1951,89,3,128,8,703,0,80
1952,89,3,129,8,711,0,80
1953,89,3,130,3,714,197,30
1954,89,3,131,3,717,27,30
1955,89,3,132,2,719,24,20
1956,89,3,133,9,728,98,90
1957,89,3,134,4,732,36,40
1958,89,3,135,4,736,41,40
1959,89,3,136,9,745,86,90
1960,89,3,137,7,752,0,70
1961,89,3,138,3,755,0,30
1962,89,3,139,6,761,0,60
1963,89,3,140,2,763,0,20
1964,89,3,141,3,766,211,30
1965,89,3,142,2,768,25,20
1966,89,3,143,6,774,53,60
1967,89,3,144,2,776,16,20
1968,89,3,145,7,783,0,70
1969,89,3,146,5,788,140,50
1970,89,3,147,6,794,56,60
1971,89,3,148,3,797,0,30
1972,89,3,149,2,799,40,20
1973,89,3,150,3,802,34,30
1974,89,3,151,8,810,82,80
1975,89,3,152,9,819,0,90
1976,89,3,153,9,828,191,90
1977,89,3,154,6,834,56,60
1978,89,3,155,5,839,52,50
1979,89,3,156,2,841,0,20
1980,89,3,157,4,845,0,40
1981,89,3,158,9,854,164,90
1982,89,3,159,2,856,0,20
1983,89,3,160,2,858,42,20
1984,89,3,161,5,863,51,50
1985,89,3,162,8,871,72,80
1986,89,3,163,8,879,93,80
1987,89,3,164,9,888,81,90
1988,89,3,165,3,891,0,30
1989,89,3,166,4,895,81,40
1990,89,3,167,9,904,91,90
1991,89,3,168,8,912,68,80
1992,89,3,169,7,919,58,70
1993,89,3,170,7,926,83,70
1994,89,3,171,4,930,48,40
1995,89,3,172,3,933,23,30
1996,89,3,173,7,940,0,70
1997,89,3,174,8,948,167,80
1998,89,3,175,6,954,55,60
1999,89,3,176,7,961,68,70
2000,89,3,177,7,968,73,70
2001,89,3,178,9,977,0,90
2002,89,3,179,5,982,0,50
2003,89,3,180,3,985,0,30
2004,89,3,181,7,992,212,70
2005,89,3,182,5,997,52,50
2006,89,3,183,5,1002,47,50
2007,89,3,184,4,1006,35,40
2008,89,3,185,8,1014,83,80
2009,89,3,186,4,1018,35,40
2010,89,3,187,7,1025,75,70
2011,89,3,188,7,1032,66,70
2012,89,3,189,4,1036,37,40
2013,89,3,190,9,1045,82,90
2014,89,3,191,6,1051,65,60
2015,89,3,192,3,1054,47,30
2016,89,3,193,8,1062,86,80
2017,89,3,194,5,1067,40,50
2018,89,3,195,3,1070,32,30
2019,89,3,196,3,1073,0,30
2020,89,3,197,7,1080,0,70
2021,89,3,198,2,1082,130,20
2022,89,3,199,5,1087,50,50
2023,89,3,200,5,1092,49,50
2024,89,3,201,8,1100,75,80
2025,89,3,202,2,1102,17,20
2026,89,3,203,7,1109,47,70
2027,89,3,204,7,1116,74,70
2028,89,3,205,9,1125,82,90
2029,89,3,206,6,1131,53,60
2030,89,3,207,6,1137,53,60
2031,89,3,208,9,1146,86,90
2032,89,3,209,4,1150,34,40
2033,89,3,210,7,1157,64,70
2034,89,3,211,7,1164,79,70
2035,89,3,212,2,1166,29,20
2036,89,3,213,4,1170,43,40
2037,89,3,214,6,1176,48,60
2038,89,3,215,3,1179,30,30
2039,89,3,216,7,1186,59,70
2040,89,3,217,3,1189,24,30
2041,89,3,218,7,1196,62,70
2042,89,3,219,2,1198,15,20
2043,89,3,220,9,1207,76,90
2044,89,3,221,3,1210,31,30
2045,89,3,222,5,1215,53,50
2046,89,3,223,6,1221,80,60
2047,89,3,224,5,1226,42,50
2048,89,3,225,4,1230,48,40
2049,89,3,226,8,1238,0,80
2050,89,3,227,9,1247,178,90
2051,89,3,228,3,1250,32,30
2052,89,3,229,3,1253,24,30
2053,89,3,230,9,1262,88,90
2054,89,3,231,4,1266,46,40
2055,89,3,232,9,1275,74,90
2056,89,3,233,2,1277,19,20
2057,89,3,234,7,1284,71,70
2058,89,3,235,9,1293,89,90
2059,89,3,236,5,1298,0,50
2060,89,3,237,6,1304,106,60
2061,89,3,238,8,1312,76,80
2062,89,3,239,4,1316,28,40
2063,89,3,240,3,1319,29,30
2064,89,3,241,2,1321,28,20
2065,89,3,242,5,1326,50,50
2066,89,3,243,3,1329,28,30
2067,89,3,244,4,1333,23,40
2068,89,3,245,4,1337,0,40
2069,89,3,246,4,1341,74,40
2070,89,3,247,5,1346,44,50
2071,89,3,248,3,1349,41,30
2072,89,3,249,9,1358,101,90
2073,89,3,250,5,1363,0,50
2074,89,3,251,8,1371,106,80
2075,89,3,252,6,1377,55,60
2076,89,3,253,4,1381,0,40
2077,89,3,254,7,1388,94,70
2078,89,3,255,8,1396,0,80
2079,89,3,256,8,1404,149,80
2080,89,3,257,7,1411,80,70
2081,89,3,258,7,1418,78,70
2082,89,3,259,4,1422,31,40
2083,89,3,260,6,1428,58,60
2084,89,3,261,7,1435,0,70
2085,89,3,262,8,1443,175,80
2086,89,3,263,6,1449,58,60
2087,89,3,264,7,1456,0,70
2088,89,3,265,8,1464,0,80
2089,89,3,266,2,1466,161,20
2090,89,3,267,8,1474,0,80
2091,89,3,268,2,1476,102,20
2092,89,3,269,9,1485,0,90
2093,89,3,270,9,1494,0,90
2094,89,3,271,4,1498,248,40
2095,89,3,272,4,1502,0,40
2096,89,3,273,5,1507,84,50
2097,89,3,274,5,1512,46,50
2098,89,3,275,4,1516,36,40
2099,89,3,276,5,1521,0,50
2100,89,3,277,5,1526,0,50
2101,89,3,278,7,1533,161,70
2102,89,3,279,7,1540,67,70
2103,89,3,280,8,1548,90,80
2104,89,3,281,5,1553,49,50
2105,89,3,282,6,1559,80,60
2106,89,3,283,5,1564,38,50
2107,89,3,284,2,1566,0,20
2108,89,3,285,7,1573,0,70
2109,89,3,286,6,1579,151,60
2110,89,3,287,3,1582,38,30
2111,89,3,288,5,1587,0,50
2112,89,3,289,3,1590,72,30
2113,89,3,290,3,1593,29,30
2114,89,3,291,7,1600,0,70
2115,89,3,292,3,1603,90,30
2116,89,3,293,5,1608,59,50
2117,89,3,294,3,1611,27,30
2118,89,3,295,5,1616,0,50
2119,89,3,296,5,1621,109,50
2120,89,3,297,9,1630,106,90
2121,89,3,298,8,1638,58,80
2122,89,3,299,3,1641,33,30
2123,89,3,300,5,1646,52,50
2124,89,3,301,8,1654,89,80
2125,89,3,302,3,1657,21,30
2126,89,3,303,7,1664,80,70
2127,89,3,304,5,1669,59,50
2128,89,3,305,7,1676,77,70
2129,89,3,306,2,1678,15,20
2130,89,3,307,3,1681,0,30
2131,89,3,308,9,1690,128,90
2132,89,3,309,8,1698,78,80
2133,89,3,310,6,1704,60,60
2134,89,3,311,3,1707,27,30
2135,89,3,312,3,1710,32,30
2136,89,3,313,8,1718,79,80
2137,89,3,314,2,1720,0,20
2138,89,3,315,4,1724,73,40
2139,89,3,316,7,1731,73,70
2140,89,3,317,6,1737,62,60
2141,89,3,318,8,1745,70,80
2142,89,3,319,4,1749,50,40
2143,89,3,320,3,1752,24,30
2144,89,3,321,8,1760,0,80
2145,89,3,322,3,1763,109,30
2146,89,3,323,5,1768,51,50
2147,89,3,324,2,1770,0,20
2148,89,3,325,4,1774,0,40
2149,89,3,326,8,1782,135,80
2150,89,3,327,6,1788,56,60
2151,89,3,328,2,1790,15,20
2152,89,3,329,4,1794,46,40
2153,89,3,330,9,1803,0,90
2154,89,3,331,9,1812,170,90
2155,89,3,332,9,1821,87,90
2156,89,3,333,8,1829,71,80
2157,89,3,334,8,1837,0,80
2158,89,3,335,4,1841,0,40
2159,89,3,336,9,1850,0,90
2160,89,3,337,5,1855,268,50
2161,89,3,338,8,1863,91,80
2162,89,3,339,4,1867,34,40
2163,89,3,340,9,1876,78,90
2164,89,3,341,5,1881,54,50
2165,89,3,342,7,1888,0,70
2166,89,3,343,5,1893,0,50
2167,89,3,344,6,1899,174,60
2168,89,3,345,4,1903,33,40
2169,89,3,346,3,1906,46,30
2170,89,3,347,5,1911,54,50
2171,89,3,348,8,1919,87,80
2172,89,3,349,8,1927,70,80
2173,89,3,350,8,1935,89,80
2174,89,3,351,8,1943,0,80
2175,89,3,352,8,1951,166,80
2176,89,3,353,3,1954,27,30
2177,89,3,354,8,1962,0,80
2178,89,3,355,8,1970,173,80
2179,89,3,356,6,1976,59,60
2180,89,3,357,9,1985,85,90
2181,89,3,358,7,1992,0,70
2182,89,3,359,2,1994,87,20
2183,89,3,360,2,1996,18,20
2184,89,3,361,8,2004,76,80
2185,89,3,362,6,2010,69,60
2186,89,3,363,6,2016,69,60
2187,89,3,364,6,2022,64,60
2188,89,3,365,5,2027,50,50
2189,89,3,366,5,2032,51,50
2190,89,3,367,3,2035,23,30
2191,89,3,368,5,2040,54,50
2192,89,3,369,3,2043,32,30
2193,89,3,370,6,2049,64,60
2194,89,3,371,7,2056,65,70
2195,89,3,372,4,2060,36,40
2196,89,3,373,9,2069,0,90
2197,89,3,374,3,2072,121,30
2198,89,3,375,3,2075,32,30
2199,89,3,376,2,2077,21,20
2200,89,3,377,7,2084,53,70
2201,89,3,378,5,2089,0,50
2202,89,3,379,4,2093,84,40
2203,89,3,380,4,2097,40,40
2204,89,3,381,8,2105,75,80
2205,89,3,382,8,2113,78,80
2206,89,3,383,9,2122,90,90
2207,89,3,384,9,2131,101,90
2208,89,3,385,4,2135,38,40
2209,89,3,386,4,2139,35,40
2210,89,3,387,7,2146,0,70
2211,89,3,388,2,2148,101,20
2212,89,3,389,8,2156,76,80
2213,89,3,390,3,2159,34,30
2214,89,3,391,4,2163,42,40
2215,89,3,392,6,2169,52,60
2216,89,3,393,6,2175,0,60
2217,89,3,394,9,2184,0,90
2218,89,3,395,5,2189,0,50
2219,89,3,396,6,2195,243,60
2220,89,3,397,3,2198,27,30
2221,89,3,398,3,2201,0,30
2222,89,3,399,2,2203,0,20
2223,89,3,400,9,2212,141,90
2224,89,3,401,2,2214,19,20
2225,89,3,402,4,2218,0,40
2226,89,3,403,2,2220,0,20
2227,89,3,404,9,2229,137,90
2228,89,3,405,2,2231,0,20
2229,89,3,406,7,2238,88,70
2230,89,3,407,7,2245,64,70
2231,89,3,408,9,2254,0,90
2232,89,3,409,3,2257,0,30
2233,89,3,410,4,2261,0,40
2234,89,3,411,2,2263,0,20
2235,89,3,412,6,2269,239,60
2236,89,3,413,4,2273,33,40
2237,89,3,414,9,2282,78,90
2238,89,3,415,2,2284,21,20
2239,89,3,416,7,2291,82,70
2240,89,3,417,9,2300,113,90
2241,89,3,418,8,2308,0,80
2242,89,3,419,5,2313,151,50
2243,89,3,420,4,2317,0,40
2244,89,3,421,7,2324,0,70
2245,89,3,422,4,2328,163,40
2246,89,3,423,5,2333,63,50
2247,89,3,424,6,2339,51,60
2248,89,3,425,8,2347,78,80
2249,89,3,426,6,2353,56,60
2250,89,3,427,9,2362,91,90
2251,89,3,428,9,2371,0,90
2252,89,3,429,5,2376,132,50
2253,89,3,430,7,2383,74,70
2254,89,3,431,5,2388,51,50
2255,89,3,432,7,2395,62,70
2256,89,3,433,2,2397,0,20
2257,89,3,434,2,2399,40,20
2258,89,3,435,2,2401,28,20
2259,89,3,436,5,2406,0,50
2260,89,3,437,9,2415,151,90
2261,89,3,438,6,2421,60,60
2262,89,3,439,2,2423,20,20
2263,89,3,440,3,2426,25,30
2264,89,3,441,7,2433,69,70
2265,89,3,442,7,2440,79,70
2266,89,3,443,3,2443,17,30
2267,89,3,444,6,2449,59,60
2268,89,3,445,7,2456,77,70
2269,89,3,446,3,2459,0,30
2270,89,3,447,3,2462,43,30
2271,89,3,448,3,2465,35,30
2272,89,3,449,2,2467,20,20
2273,89,3,450,7,2474,65,70
2274,89,3,451,6,2480,66,60
2275,89,3,452,2,2482,0,20
2276,89,3,453,6,2488,0,60
2277,89,3,454,6,2494,0,60
2278,89,3,455,7,2501,214,70
2279,89,3,456,2,2503,15,20
2280,89,3,457,5,2508,0,50
2281,89,3,458,8,2516,132,80
2282,89,3,459,9,2525,0,90
2283,89,3,460,4,2529,135,40
2284,89,3,461,5,2534,62,50
2285,89,3,462,5,2539,34,50
2286,89,3,463,4,2543,0,40
2287,89,3,464,7,2550,121,70
2288,89,3,465,5,2555,46,50
2289,89,3,466,8,2563,75,80
2290,89,3,467,3,2566,30,30
2291,89,3,468,7,2573,62,70
2292,89,3,469,9,2582,0,90
2293,89,3,470,9,2591,174,90
2294,89,3,471,3,2594,32,30
2295,89,3,472,8,2602,79,80
2296,89,3,473,2,2604,14,20
2297,89,3,474,8,2612,0,80
2298,89,3,475,7,2619,162,70
2299,89,3,476,3,2622,0,30
2300,89,3,477,9,2631,111,90
2301,89,3,478,7,2638,59,70
2302,89,3,479,6,2644,60,60
2303,89,3,480,8,2652,64,80
2304,89,3,481,3,2655,40,30
2305,89,3,482,3,2658,23,30
2306,89,3,483,6,2664,0,60
2307,89,3,484,7,2671,128,70
2308,89,3,485,8,2679,95,80
2309,89,3,486,5,2684,39,50
2310,89,3,487,2,2686,0,20
2311,89,3,488,4,2690,0,40
2312,89,3,489,6,2696,111,60
2313,89,3,490,4,2700,39,40
2314,89,3,491,3,2703,28,30
2315,89,3,492,2,2705,0,20
2316,89,3,493,5,2710,0,50
2317,89,3,494,6,2716,127,60
2318,89,3,495,4,2720,0,40
2319,89,3,496,6,2726,107,60
2320,89,3,497,2,2728,14,20
2321,89,3,498,5,2733,52,50
2322,89,3,499,7,2740,0,70
2323,89,3,500,6,2746,0,60
2324,89,3,501,4,2750,178,40
2325,89,3,502,7,2757,75,70
2326,89,3,503,5,2762,42,50
2327,89,3,504,9,2771,0,90
2328,89,3,505,8,2779,179,80
2329,89,3,506,7,2786,51,70
2330,89,3,507,5,2791,0,50
2331,89,3,508,6,2797,97,60
2332,89,3,509,7,2804,72,70
2333,89,3,510,4,2808,43,40
2334,89,3,511,6,2814,67,60
2335,89,3,512,5,2819,56,50
2336,89,3,513,4,2823,36,40
2337,89,3,514,6,2829,52,60
2338,89,3,515,3,2832,0,30
2339,89,3,516,4,2836,55,40
2340,89,3,517,4,2840,28,40
2341,89,3,518,4,2844,38,40
2342,89,3,519,6,2850,69,60
2343,89,3,520,8,2858,0,80
2344,89,3,521,5,2863,132,50
2345,89,3,522,5,2868,0,50
2346,89,3,523,6,2874,0,60
2347,89,3,524,3,2877,130,30
2348,89,3,525,9,2886,89,90
2349,89,3,526,2,2888,0,20
2350,89,3,527,9,2897,97,90
2351,89,3,528,4,2901,0,40
2352,89,3,529,5,2906,81,50
2353,89,3,530,8,2914,76,80
2354,89,3,531,6,2920,63,60
2355,89,3,532,5,2925,0,50
2356,89,3,533,5,2930,101,50
2357,89,3,534,8,2938,81,80
2358,89,3,535,4,2942,28,40
2359,89,3,536,5,2947,45,50
2360,89,3,537,6,2953,0,60
2361,89,3,538,9,2962,151,90
2362,89,3,539,4,2966,0,40
2363,89,3,540,8,2974,0,80
2364,89,3,541,8,2982,0,80
2365,89,3,542,8,2990,271,80
2366,89,3,543,2,2992,15,20
2367,89,3,544,3,2995,24,30
2368,89,3,545,8,3003,80,80
2369,89,3,546,5,3008,49,50
2370,89,3,547,6,3014,55,60
2371,89,3,548,2,3016,24,20
2372,89,3,549,3,3019,28,30
2373,89,3,550,2,3021,0,20
2374,89,3,551,3,3024,59,30
2375,89,3,552,2,3026,20,20
2376,89,3,553,4,3030,0,40
2377,89,3,554,9,3039,0,90
2378,89,3,555,3,3042,147,30
2379,89,3,556,5,3047,55,50
2380,89,3,557,2,3049,18,20
2381,89,3,558,6,3055,57,60
2382,89,3,559,9,3064,108,90
2383,89,3,560,8,3072,62,80
2384,89,3,561,5,3077,0,50
2385,89,3,562,8,3085,0,80
2386,89,3,563,9,3094,0,90
2387,89,3,564,6,3100,292,60
2388,89,3,565,5,3105,54,50
2389,89,3,566,7,3112,0,70
2390,89,3,567,2,3114,84,20
2391,89,3,568,2,3116,0,20
2392,89,3,569,2,3118,41,20
2393,89,3,570,3,3121,27,30
2394,89,3,571,6,3127,54,60
2395,89,3,572,2,3129,25,20
2396,89,3,573,5,3134,51,50
2397,89,3,574,4,3138,0,40
2398,89,3,575,4,3142,69,40
2399,89,3,576,9,3151,92,90
2400,89,3,577,4,3155,0,40
2401,89,3,578,4,3159,0,40
2402,89,3,579,3,3162,111,30
2403,89,3,580,6,3168,51,60
2404,89,3,581,5,3173,0,50
2405,89,3,582,6,3179,0,60
2406,89,3,583,6,3185,0,60
2407,89,3,584,8,3193,0,80
2408,89,3,585,3,3196,0,30
2409,89,3,586,9,3205,0,90
2410,89,3,587,9,3214,474,90
2411,89,3,588,9,3223,0,90
2412,89,3,589,6,3229,0,60
2413,89,3,590,2,3231,0,20
2414,89,3,591,9,3240,274,90
2415,89,3,592,2,3242,17,20
2416,89,3,593,6,3248,0,60
2417,89,3,594,5,3253,100,50
2418,89,3,595,8,3261,0,80
2419,89,3,596,4,3265,119,40
2420,89,3,597,4,3269,33,40
2421,89,3,598,2,3271,27,20
2422,89,3,599,8,3279,67,80
2423,89,3,600,7,3286,67,70
2424,89,3,601,5,3291,50,50
2425,89,3,602,7,3298,76,70
2426,89,3,603,3,3301,27,30
2427,89,3,604,4,3305,53,40
2428,89,3,605,9,3314,0,90
2429,89,3,606,4,3318,133,40
2430,89,3,607,9,3327,83,90
2431,89,3,608,6,3333,0,60
2432,89,3,609,2,3335,0,20
2433,89,3,610,7,3342,139,70
2434,89,3,611,2,3344,22,20
2435,89,3,612,8,3352,0,80
2436,89,3,613,8,3360,149,80
2437,89,3,614,8,3368,80,80
2438,89,3,615,2,3370,0,20
2439,89,3,616,7,3377,93,70
2440,89,3,617,5,3382,41,50
2441,89,3,618,3,3385,0,30
2442,89,3,619,5,3390,71,50
2443,89,3,620,9,3399,93,90
2444,89,3,621,2,3401,20,20
2445,89,3,622,6,3407,58,60
2446,89,3,623,5,3412,56,50
2447,89,3,624,8,3420,0,80
2448,89,3,625,3,3423,116,30
2449,89,3,626,4,3427,35,40
2450,89,3,627,7,3434,0,70
2451,89,3,628,4,3438,124,40
2452,89,3,629,8,3446,79,80
2453,89,3,630,2,3448,0,20
2454,89,3,631,8,3456,80,80
2455,89,3,632,5,3461,53,50
2456,89,3,633,9,3470,0,90
2457,89,3,634,6,3476,0,60
2458,89,3,635,4,3480,184,40
2459,89,3,636,6,3486,50,60
2460,89,3,637,8,3494,86,80
2461,89,3,638,7,3501,68,70
2462,89,3,639,3,3504,30,30
2463,89,3,640,3,3507,34,30
2464,89,3,641,7,3514,66,70
2465,89,3,642,2,3516,0,20
2466,89,3,643,3,3519,60,30
2467,89,3,644,7,3526,0,70
2468,89,3,645,2,3528,74,20
2469,89,3,646,2,3530,22,20
2470,89,3,647,9,3539,0,90
2471,89,3,648,3,3542,91,30
2472,89,3,649,9,3551,73,90
2473,89,3,650,5,3556,0,50
2474,89,3,651,3,3559,76,30
2475,89,3,652,6,3565,52,60
2476,89,3,653,6,3571,0,60
2477,89,3,654,9,3580,0,90
2478,89,3,655,3,3583,154,30
2479,89,3,656,6,3589,53,60
2480,89,3,657,4,3593,48,40
2481,89,3,658,4,3597,33,40
2482,89,3,659,3,3600,0,30
2483,89,3,660,6,3606,74,60
2484,89,3,661,7,3613,86,70
2485,89,3,662,3,3616,29,30
2486,89,3,663,9,3625,89,90
2487,89,3,664,4,3629,48,40
2488,89,3,665,6,3635,53,60
2489,89,3,666,8,3643,81,80
2490,89,3,667,4,3647,47,40
2491,89,3,668,3,3650,25,30
2492,89,3,669,9,3659,99,90
2493,89,3,670,9,3668,0,90
2494,89,3,671,4,3672,129,40
2495,89,3,672,8,3680,80,80
2496,89,3,673,8,3688,88,80
2497,89,3,674,6,3694,75,60
2498,89,3,675,3,3697,29,30
2499,89,3,676,3,3700,32,30
2500,89,3,677,3,3703,27,30
2501,89,3,678,6,3709,56,60
2502,89,3,679,5,3714,0,50
2503,89,3,680,9,3723,129,90
2504,89,3,681,4,3727,51,40
2505,89,3,682,6,3733,58,60
2506,89,3,683,4,3737,0,40
2507,89,3,684,7,3744,102,70
2508,89,3,685,6,3750,63,60
2509,89,3,686,4,3754,0,40
2510,89,3,687,8,3762,131,80
2511,89,3,688,2,3764,0,20
2512,89,3,689,8,3772,104,80
2513,89,3,690,5,3777,62,50
2514,89,3,691,3,3780,31,30
2515,89,3,692,4,3784,38,40
2516,89,3,693,5,3789,47,50
2517,89,3,694,7,3796,72,70
2518,89,3,695,6,3802,56,60
2519,89,3,696,8,3810,87,80
2520,89,3,697,8,3818,78,80
2521,89,3,698,4,3822,0,40
2522,89,3,699,4,3826,83,40
2523,89,3,700,3,3829,33,30
2524,89,3,701,7,3836,56,70
2525,89,3,702,5,3841,68,50
2526,89,3,703,7,3848,0,70
2527,89,3,704,4,3852,105,40
2528,89,3,705,2,3854,0,20
2529,89,3,706,7,3861,90,70
2530,89,3,707,3,3864,31,30
2531,89,3,708,2,3866,22,20
2532,89,3,709,3,3869,36,30
2533,89,3,710,2,3871,26,20
2534,89,3,711,4,3875,0,40
2535,89,3,712,6,3881,96,60
2536,89,3,713,2,3883,27,20
2537,89,3,714,4,3887,45,40
2538,89,3,715,9,3896,0,90
2539,89,3,716,2,3898,112,20
2540,89,3,717,8,3906,0,80
2541,89,3,718,5,3911,127,50
2542,89,3,719,6,3917,57,60
2543,89,3,720,4,3921,41,40
2544,89,3,721,5,3926,55,50
2545,89,3,722,2,3928,18,20
2546,89,3,723,3,3931,32,30
2547,89,3,724,3,3934,29,30
2548,89,3,725,7,3941,0,70
2549,89,3,726,2,3943,93,20
2550,89,3,727,3,3946,27,30
2551,89,3,728,7,3953,0,70
2552,89,3,729,8,3961,145,80
2553,89,3,730,9,3970,0,90
2554,89,3,731,2,3972,106,20
2555,89,3,732,2,3974,21,20
2556,89,3,733,9,3983,0,90
2557,89,3,734,8,3991,173,80
2558,89,3,735,7,3998,65,70
2559,89,3,736,8,4006,0,80
2560,89,3,737,3,4009,101,30
2561,89,3,738,4,4013,41,40
2562,89,3,739,8,4021,80,80
2563,89,3,740,9,4030,88,90
2564,89,3,741,2,4032,0,20
2565,89,3,742,6,4038,0,60
2566,89,3,743,2,4040,0,20
2567,89,3,744,3,4043,143,30
2568,89,3,745,8,4051,0,80
2569,89,3,746,6,4057,156,60
2570,89,3,747,9,4066,0,90
2571,89,3,748,8,4074,0,80
2572,89,3,749,9,4083,223,90
2573,89,3,750,2,4085,18,20
2574,89,3,751,8,4093,73,80
2575,89,3,752,6,4099,55,60
2576,89,3,753,3,4102,34,30
2577,89,3,754,9,4111,89,90
2578,89,3,755,5,4116,35,50
2579,89,3,756,9,4125,0,90
2580,89,3,757,8,4133,163,80
2581,89,3,758,9,4142,102,90
2582,89,3,759,6,4148,0,60
2583,89,3,760,4,4152,0,40
2584,89,3,761,7,4159,209,70
2585,89,3,762,9,4168,0,90
2586,89,3,763,3,4171,121,30
2587,89,3,764,7,4178,69,70
2588,89,3,765,6,4184,50,60
2589,89,3,766,8,4192,72,80
2590,89,3,767,3,4195,0,30
2591,89,3,768,2,4197,54,20
2592,89,3,769,2,4199,18,20
2593,89,3,770,8,4207,79,80
2594,89,3,771,9,4216,90,90
2595,89,3,772,5,4221,58,50
2596,89,3,773,4,4225,42,40
2597,89,3,774,5,4230,57,50
2598,89,3,775,7,4237,70,70
2599,89,3,776,3,4240,28,30
2600,89,3,777,7,4247,65,70
2601,89,3,778,3,4250,0,30
2602,89,3,779,9,4259,0,90
2603,89,3,780,8,4267,180,80
2604,89,3,781,6,4273,63,60
2605,89,3,782,5,4278,45,50
2606,89,3,783,8,4286,91,80
2607,89,3,784,9,4295,73,90
2608,89,3,785,2,4297,21,20
2609,89,3,786,2,4299,0,20
2610,89,3,787,2,4301,42,20
2611,89,3,788,4,4305,41,40
2612,89,3,789,7,4312,64,70
2613,89,3,790,9,4321,95,90
2614,89,3,791,7,4328,53,70
2615,89,3,792,9,4337,0,90
2616,89,3,793,3,4340,127,30
2617,89,3,794,4,4344,38,40
2618,89,3,795,7,4351,90,70
2619,89,3,796,5,4356,56,50
2620,89,3,797,4,4360,46,40
2621,89,3,798,9,4369,0,90
2622,89,3,799,5,4374,0,50
2623,89,3,800,3,4377,173,30
2624,89,3,801,2,4379,13,20
2625,89,3,802,9,4388,109,90
2626,89,3,803,2,4390,18,20
2627,89,3,804,5,4395,46,50
2628,89,3,805,7,4402,76,70
2629,89,3,806,5,4407,0,50
2630,89,3,807,7,4414,0,70
2631,89,3,808,4,4418,144,40
2632,89,3,809,2,4420,24,20
2633,89,3,810,4,4424,0,40
2634,89,3,811,5,4429,84,50
2635,89,3,812,2,4431,22,20
2636,89,3,813,9,4440,89,90
2637,89,3,814,6,4446,59,60
2638,89,3,815,2,4448,22,20
2639,89,3,816,6,4454,0,60
2640,89,3,817,3,4457,98,30
2641,89,3,818,9,4466,94,90
2642,89,3,819,7,4473,0,70
2643,89,3,820,4,4477,120,40
2644,89,3,821,8,4485,97,80
2645,89,3,822,6,4491,59,60
2646,89,3,823,4,4495,42,40
2647,89,3,824,7,4502,68,70
2648,89,3,825,4,4506,0,40
2649,89,3,826,2,4508,63,20
2650,89,3,827,9,4517,102,90
2651,89,3,828,9,4526,0,90
2652,89,3,829,9,4535,199,90
2653,89,3,830,4,4539,52,40
2654,89,3,831,4,4543,40,40
2655,89,3,832,2,4545,22,20
2656,89,3,833,3,4548,35,30
2657,89,3,834,3,4551,25,30
2658,89,3,835,7,4558,76,70
2659,89,3,836,4,4562,0,40
2660,89,3,837,2,4564,60,20
2661,89,3,838,5,4569,51,50
2662,89,3,839,9,4578,93,90
2663,89,3,840,4,4582,27,40
2664,89,3,841,4,4586,0,40
2665,89,3,842,5,4591,81,50
2666,89,3,843,3,4594,33,30
2667,89,3,844,9,4603,0,90
2668,89,3,845,6,4609,0,60
2669,89,3,846,5,4614,188,50
2670,89,3,847,3,4617,30,30
2671,89,3,848,6,4623,57,60
2672,89,3,849,8,4631,75,80
2673,89,3,850,7,4638,0,70
2674,89,3,851,5,4643,124,50
2675,89,3,852,4,4647,37,40
2676,89,3,853,7,4654,78,70
2677,89,3,854,8,4662,76,80
2678,89,3,855,6,4668,58,60
2679,89,3,856,8,4676,81,80
2680,89,3,857,9,4685,93,90
2681,89,3,858,8,4693,96,80
2682,89,3,859,4,4697,43,40
2683,89,3,860,4,4701,44,40
2684,89,3,861,7,4708,61,70
2685,89,3,862,6,4714,61,60
2686,89,3,863,8,4722,85,80
2687,89,3,864,4,4726,45,40
2688,89,3,865,8,4734,77,80
2689,89,3,866,9,4743,89,90
2690,89,3,867,3,4746,35,30
2691,89,3,868,3,4749,0,30
2692,89,3,869,2,4751,51,20
2693,89,3,870,9,4760,96,90
2694,89,3,871,5,4765,44,50
2695,89,3,872,9,4774,96,90
2696,89,3,873,6,4780,0,60
2697,89,3,874,3,4783,85,30
2698,89,3,875,4,4787,0,40
2699,89,3,876,4,4791,82,40
2700,89,3,877,3,4794,30,30
2701,89,3,878,5,4799,49,50
2702,89,3,879,9,4808,0,90
2703,89,3,880,3,4811,107,30
2704,89,3,881,3,4814,35,30
2705,89,3,882,3,4817,0,30
2706,89,3,883,7,4824,93,70
2707,89,3,884,7,4831,0,70
2708,89,3,885,9,4840,186,90
2709,89,3,886,4,4844,29,40
2710,89,3,887,4,4848,34,40
2711,89,3,888,9,4857,92,90
2712,89,3,889,6,4863,57,60
2713,89,3,890,2,4865,0,20
2714,89,3,891,3,4868,0,30
2715,89,3,892,5,4873,104,50
2716,89,3,893,9,4882,85,90
2717,89,3,894,9,4891,93,90
2718,89,3,895,2,4893,20,20
2719,89,3,896,4,4897,48,40
2720,89,3,897,8,4905,0,80
2721,89,3,898,7,4912,132,70
2722,89,3,899,7,4919,57,70
2723,89,3,900,8,4927,69,80
2724,89,3,901,2,4929,21,20
2725,89,3,902,6,4935,0,60
2726,89,3,903,7,4942,136,70
2727,89,3,904,3,4945,0,30
2728,89,3,905,9,4954,114,90
2729,89,3,906,2,4956,20,20
2730,89,3,907,4,4960,34,40
2731,89,3,908,3,4963,0,30
2732,89,3,909,2,4965,0,20
2733,89,3,910,9,4974,128,90
2734,89,3,911,6,4980,61,60
2735,89,3,912,7,4987,64,70
2736,89,3,913,2,4989,0,20
2737,89,3,914,9,4998,103,90
