,Scenario,Trial,Inspection,Interval,Time,Defects,Rate
0,87,1,1,5,5,55,50
1,87,1,2,9,14,0,90
2,87,1,3,4,18,137,40
3,87,1,4,6,24,58,60
4,87,1,5,8,32,79,80
5,87,1,6,6,38,55,60
6,87,1,7,3,41,34,30
7,87,1,8,2,43,22,20
8,87,1,9,6,49,0,60
9,87,1,10,5,54,0,50
10,87,1,11,7,61,194,70
11,87,1,12,6,67,70,60
12,87,1,13,3,70,0,30
13,87,1,14,4,74,0,40
14,87,1,15,5,79,126,50
15,87,1,16,5,84,52,50
16,87,1,17,6,90,0,60
17,87,1,18,8,98,142,80
18,87,1,19,9,107,88,90
19,87,1,20,5,112,53,50
20,87,1,21,2,114,19,20
21,87,1,22,7,121,67,70
22,87,1,23,9,130,0,90
23,87,1,24,8,138,161,80
24,87,1,25,3,141,30,30
25,87,1,26,7,148,77,70
26,87,1,27,7,155,68,70
27,87,1,28,5,160,0,50
28,87,1,29,2,162,77,20
29,87,1,30,7,169,77,70
30,87,1,31,9,178,101,90
31,87,1,32,2,180,20,20
32,87,1,33,4,184,44,40
33,87,1,34,3,187,0,30
34,87,1,35,6,193,0,60
35,87,1,36,7,200,0,70
36,87,1,37,7,207,213,70
37,87,1,38,5,212,40,50
38,87,1,39,8,220,76,80
39,87,1,40,3,223,36,30
40,87,1,41,2,225,20,20
41,87,1,42,6,231,0,60
42,87,1,43,2,233,95,20
43,87,1,44,9,242,77,90
44,87,1,45,2,244,21,20
45,87,1,46,4,248,41,40
46,87,1,47,7,255,74,70
47,87,1,48,8,263,75,80
48,87,1,49,7,270,0,70
49,87,1,50,8,278,148,80
50,87,1,51,2,280,17,20
51,87,1,52,2,282,0,20
52,87,1,53,9,291,112,90
53,87,1,54,6,297,61,60
54,87,1,55,9,306,0,90
55,87,1,56,8,314,0,80
56,87,1,57,5,319,0,50
57,87,1,58,7,326,0,70
58,87,1,59,4,330,0,40
59,87,1,60,4,334,339,40
60,87,1,61,6,340,47,60
61,87,1,62,6,346,0,60
62,87,1,63,3,349,93,30
63,87,1,64,3,352,42,30
64,87,1,65,7,359,85,70
65,87,1,66,7,366,96,70
66,87,1,67,9,375,86,90
67,87,1,68,3,378,15,30
68,87,1,69,7,385,74,70
69,87,1,70,6,391,61,60
70,87,1,71,8,399,75,80
71,87,1,72,3,402,30,30
72,87,1,73,6,408,71,60
73,87,1,74,3,411,42,30
74,87,1,75,3,414,32,30
75,87,1,76,3,417,0,30
76,87,1,77,3,420,61,30
77,87,1,78,6,426,69,60
78,87,1,79,3,429,28,30
79,87,1,80,7,436,60,70
80,87,1,81,9,445,84,90
81,87,1,82,7,452,86,70
82,87,1,83,3,455,18,30
83,87,1,84,7,462,0,70
84,87,1,85,8,470,155,80
85,87,1,86,4,474,0,40
86,87,1,87,4,478,101,40
87,87,1,88,8,486,80,80
88,87,1,89,9,495,101,90
89,87,1,90,9,504,0,90
90,87,1,91,3,507,109,30
91,87,1,92,5,512,51,50
92,87,1,93,8,520,93,80
93,87,1,94,5,525,43,50
94,87,1,95,9,534,70,90
95,87,1,96,9,543,90,90
96,87,1,97,9,552,79,90
97,87,1,98,5,557,43,50
98,87,1,99,4,561,0,40
99,87,1,100,9,570,145,90
100,87,1,101,9,579,106,90
101,87,1,102,9,588,90,90
102,87,1,103,7,595,76,70
103,87,1,104,9,604,86,90
104,87,1,105,6,610,71,60
105,87,1,106,4,614,36,40
106,87,1,107,9,623,0,90
107,87,1,108,2,625,120,20
108,87,1,109,5,630,46,50
109,87,1,110,7,637,0,70
110,87,1,111,8,645,170,80
111,87,1,112,9,654,86,90
112,87,1,113,2,656,19,20
113,87,1,114,4,660,38,40
114,87,1,115,5,665,49,50
115,87,1,116,3,668,28,30
116,87,1,117,3,671,0,30
117,87,1,118,8,679,131,80
118,87,1,119,9,688,0,90
119,87,1,120,5,693,129,50
120,87,1,121,7,700,58,70
121,87,1,122,9,709,82,90
122,87,1,123,2,711,26,20
123,87,1,124,8,719,0,80
124,87,1,125,6,725,0,60
125,87,1,126,2,727,162,20
126,87,1,127,2,729,0,20
127,87,1,128,4,733,61,40
128,87,1,129,3,736,43,30
129,87,1,130,8,744,0,80
130,87,1,131,4,748,0,40
131,87,1,132,2,750,114,20
132,87,1,133,7,757,74,70
133,87,1,134,6,763,0,60
134,87,1,135,3,766,103,30
135,87,1,136,2,768,23,20
136,87,1,137,3,771,26,30
137,87,1,138,3,774,38,30
138,87,1,139,6,780,56,60
139,87,1,140,7,787,73,70
140,87,1,141,7,794,76,70
141,87,1,142,4,798,44,40
142,87,1,143,8,806,98,80
143,87,1,144,9,815,96,90
144,87,1,145,7,822,0,70
145,87,1,146,5,827,0,50
146,87,1,147,6,833,165,60
147,87,1,148,7,840,57,70
148,87,1,149,7,847,0,70
149,87,1,150,8,855,164,80
150,87,1,151,5,860,47,50
151,87,1,152,2,862,31,20
152,87,1,153,2,864,17,20
153,87,1,154,9,873,96,90
154,87,1,155,9,882,92,90
155,87,1,156,6,888,55,60
156,87,1,157,6,894,0,60
157,87,1,158,5,899,113,50
158,87,1,159,3,902,33,30
159,87,1,160,8,910,0,80
160,87,1,161,4,914,141,40
161,87,1,162,6,920,63,60
162,87,1,163,3,923,0,30
163,87,1,164,6,929,0,60
164,87,1,165,4,933,147,40
165,87,1,166,4,937,44,40
166,87,1,167,6,943,74,60
167,87,1,168,5,948,47,50
168,87,1,169,3,951,28,30
169,87,1,170,9,960,117,90
170,87,1,171,7,967,71,70
171,87,1,172,6,973,62,60
172,87,1,173,8,981,84,80
173,87,1,174,2,983,13,20
174,87,1,175,8,991,89,80
175,87,1,176,8,999,97,80
176,87,1,177,9,1008,0,90
177,87,1,178,5,1013,137,50
178,87,1,179,8,1021,0,80
179,87,1,180,7,1028,163,70
180,87,1,181,9,1037,0,90
181,87,1,182,3,1040,0,30
182,87,1,183,2,1042,144,20
183,87,1,184,4,1046,40,40
184,87,1,185,2,1048,14,20
185,87,1,186,2,1050,15,20
186,87,1,187,5,1055,53,50
187,87,1,188,2,1057,23,20
188,87,1,189,7,1064,0,70
189,87,1,190,9,1073,129,90
190,87,1,191,3,1076,29,30
191,87,1,192,7,1083,68,70
192,87,1,193,4,1087,0,40
193,87,1,194,9,1096,139,90
194,87,1,195,9,1105,110,90
195,87,1,196,5,1110,48,50
196,87,1,197,4,1114,36,40
197,87,1,198,7,1121,72,70
198,87,1,199,5,1126,54,50
199,87,1,200,5,1131,0,50
200,87,1,201,8,1139,124,80
201,87,1,202,5,1144,49,50
202,87,1,203,6,1150,0,60
203,87,1,204,3,1153,96,30
204,87,1,205,6,1159,58,60
205,87,1,206,6,1165,59,60
206,87,1,207,3,1168,0,30
207,87,1,208,2,1170,0,20
208,87,1,209,2,1172,65,20
209,87,1,210,8,1180,87,80
210,87,1,211,5,1185,56,50
211,87,1,212,2,1187,0,20
212,87,1,213,4,1191,0,40
213,87,1,214,8,1199,0,80
214,87,1,215,2,1201,153,20
215,87,1,216,5,1206,55,50
216,87,1,217,5,1211,56,50
217,87,1,218,9,1220,96,90
218,87,1,219,2,1222,0,20
219,87,1,220,9,1231,113,90
220,87,1,221,5,1236,0,50
221,87,1,222,5,1241,0,50
222,87,1,223,9,1250,0,90
223,87,1,224,2,1252,195,20
224,87,1,225,7,1259,0,70
225,87,1,226,7,1266,151,70
226,87,1,227,2,1268,20,20
227,87,1,228,3,1271,27,30
228,87,1,229,8,1279,0,80
229,87,1,230,5,1284,0,50
230,87,1,231,9,1293,194,90
231,87,1,232,6,1299,55,60
232,87,1,233,7,1306,62,70
233,87,1,234,5,1311,48,50
234,87,1,235,4,1315,0,40
235,87,1,236,9,1324,0,90
236,87,1,237,9,1333,211,90
237,87,1,238,5,1338,0,50
238,87,1,239,6,1344,0,60
239,87,1,240,6,1350,163,60
240,87,1,241,6,1356,59,60
241,87,1,242,9,1365,100,90
242,87,1,243,2,1367,17,20
243,87,1,244,8,1375,71,80
244,87,1,245,6,1381,0,60
245,87,1,246,8,1389,147,80
246,87,1,247,4,1393,37,40
247,87,1,248,7,1400,73,70
248,87,1,249,8,1408,77,80
249,87,1,250,9,1417,82,90
250,87,1,251,4,1421,47,40
251,87,1,252,8,1429,0,80
252,87,1,253,2,1431,96,20
253,87,1,254,8,1439,78,80
254,87,1,255,9,1448,98,90
255,87,1,256,7,1455,0,70
256,87,1,257,3,1458,113,30
257,87,1,258,9,1467,102,90
258,87,1,259,8,1475,80,80
259,87,1,260,9,1484,82,90
260,87,1,261,9,1493,90,90
261,87,1,262,9,1502,0,90
262,87,1,263,3,1505,142,30
263,87,1,264,5,1510,49,50
264,87,1,265,6,1516,65,60
265,87,1,266,8,1524,0,80
266,87,1,267,3,1527,91,30
267,87,1,268,5,1532,0,50
268,87,1,269,7,1539,0,70
269,87,1,270,2,1541,155,20
270,87,1,271,7,1548,86,70
271,87,1,272,4,1552,37,40
272,87,1,273,6,1558,54,60
273,87,1,274,9,1567,0,90
274,87,1,275,9,1576,0,90
275,87,1,276,4,1580,213,40
276,87,1,277,5,1585,60,50
277,87,1,278,9,1594,107,90
278,87,1,279,3,1597,0,30
279,87,1,280,5,1602,91,50
280,87,1,281,3,1605,25,30
281,87,1,282,5,1610,59,50
282,87,1,283,5,1615,53,50
283,87,1,284,5,1620,39,50
284,87,1,285,6,1626,69,60
285,87,1,286,5,1631,55,50
286,87,1,287,3,1634,23,30
287,87,1,288,8,1642,76,80
288,87,1,289,5,1647,42,50
289,87,1,290,2,1649,18,20
290,87,1,291,6,1655,52,60
291,87,1,292,6,1661,64,60
292,87,1,293,4,1665,36,40
293,87,1,294,5,1670,43,50
294,87,1,295,6,1676,0,60
295,87,1,296,9,1685,153,90
296,87,1,297,3,1688,27,30
297,87,1,298,4,1692,40,40
298,87,1,299,6,1698,0,60
299,87,1,300,5,1703,119,50
300,87,1,301,6,1709,78,60
301,87,1,302,9,1718,91,90
302,87,1,303,9,1727,94,90
303,87,1,304,7,1734,79,70
304,87,1,305,2,1736,16,20
305,87,1,306,7,1743,57,70
306,87,1,307,7,1750,72,70
307,87,1,308,3,1753,27,30
308,87,1,309,9,1762,95,90
309,87,1,310,9,1771,66,90
310,87,1,311,6,1777,60,60
311,87,1,312,4,1781,0,40
312,87,1,313,3,1784,0,30
313,87,1,314,4,1788,105,40
314,87,1,315,2,1790,14,20
315,87,1,316,7,1797,69,70
316,87,1,317,3,1800,0,30
317,87,1,318,4,1804,0,40
318,87,1,319,6,1810,120,60
319,87,1,320,8,1818,95,80
320,87,1,321,4,1822,48,40
321,87,1,322,3,1825,40,30
322,87,1,323,6,1831,65,60
323,87,1,324,2,1833,0,20
324,87,1,325,6,1839,77,60
325,87,1,326,2,1841,29,20
326,87,1,327,9,1850,97,90
327,87,1,328,9,1859,86,90
328,87,1,329,5,1864,52,50
329,87,1,330,4,1868,24,40
330,87,1,331,5,1873,0,50
331,87,1,332,9,1882,151,90
332,87,1,333,6,1888,65,60
333,87,1,334,7,1895,75,70
334,87,1,335,6,1901,72,60
335,87,1,336,4,1905,45,40
336,87,1,337,8,1913,74,80
337,87,1,338,8,1921,74,80
338,87,1,339,4,1925,41,40
339,87,1,340,7,1932,79,70
340,87,1,341,5,1937,62,50
341,87,1,342,8,1945,61,80
342,87,1,343,8,1953,84,80
343,87,1,344,3,1956,0,30
344,87,1,345,9,1965,0,90
345,87,1,346,3,1968,0,30
346,87,1,347,2,1970,179,20
347,87,1,348,7,1977,68,70
348,87,1,349,9,1986,95,90
349,87,1,350,3,1989,35,30
350,87,1,351,8,1997,82,80
351,87,1,352,2,1999,23,20
352,87,1,353,6,2005,53,60
353,87,1,354,2,2007,22,20
354,87,1,355,6,2013,51,60
355,87,1,356,6,2019,70,60
356,87,1,357,6,2025,54,60
357,87,1,358,7,2032,78,70
358,87,1,359,2,2034,0,20
359,87,1,360,4,2038,59,40
360,87,1,361,3,2041,34,30
361,87,1,362,2,2043,22,20
362,87,1,363,4,2047,0,40
363,87,1,364,6,2053,83,60
364,87,1,365,7,2060,0,70
365,87,1,366,5,2065,112,50
366,87,1,367,7,2072,0,70
367,87,1,368,7,2079,158,70
368,87,1,369,9,2088,0,90
369,87,1,370,2,2090,120,20
370,87,1,371,7,2097,60,70
371,87,1,372,6,2103,0,60
372,87,1,373,2,2105,67,20
373,87,1,374,8,2113,91,80
374,87,1,375,9,2122,0,90
375,87,1,376,6,2128,0,60
376,87,1,377,8,2136,0,80
377,87,1,378,5,2141,0,50
378,87,1,379,6,2147,0,60
379,87,1,380,4,2151,390,40
380,87,1,381,4,2155,42,40
381,87,1,382,6,2161,0,60
382,87,1,383,4,2165,101,40
383,87,1,384,2,2167,17,20
384,87,1,385,8,2175,87,80
385,87,1,386,5,2180,41,50
386,87,1,387,3,2183,25,30
387,87,1,388,7,2190,0,70
388,87,1,389,2,2192,93,20
389,87,1,390,7,2199,61,70
390,87,1,391,3,2202,24,30
391,87,1,392,9,2211,86,90
392,87,1,393,9,2220,0,90
393,87,1,394,7,2227,141,70
394,87,1,395,2,2229,18,20
395,87,1,396,3,2232,37,30
396,87,1,397,5,2237,0,50
397,87,1,398,2,2239,70,20
398,87,1,399,8,2247,79,80
399,87,1,400,9,2256,101,90
400,87,1,401,2,2258,11,20
401,87,1,402,3,2261,28,30
402,87,1,403,9,2270,86,90
403,87,1,404,8,2278,84,80
404,87,1,405,3,2281,25,30
405,87,1,406,4,2285,33,40
406,87,1,407,2,2287,10,20
407,87,1,408,4,2291,40,40
408,87,1,409,5,2296,0,50
409,87,1,410,5,2301,95,50
410,87,1,411,3,2304,18,30
411,87,1,412,4,2308,0,40
412,87,1,413,3,2311,73,30
413,87,1,414,8,2319,67,80
414,87,1,415,6,2325,53,60
415,87,1,416,9,2334,93,90
416,87,1,417,8,2342,0,80
417,87,1,418,5,2347,117,50
418,87,1,419,4,2351,49,40
419,87,1,420,5,2356,54,50
420,87,1,421,3,2359,40,30
421,87,1,422,3,2362,33,30
422,87,1,423,4,2366,38,40
423,87,1,424,4,2370,51,40
424,87,1,425,4,2374,0,40
425,87,1,426,8,2382,125,80
426,87,1,427,5,2387,44,50
427,87,1,428,3,2390,0,30
428,87,1,429,4,2394,0,40
429,87,1,430,4,2398,96,40
430,87,1,431,3,2401,0,30
431,87,1,432,3,2404,0,30
432,87,1,433,3,2407,88,30
433,87,1,434,2,2409,29,20
434,87,1,435,3,2412,25,30
435,87,1,436,3,2415,33,30
436,87,1,437,6,2421,57,60
437,87,1,438,8,2429,0,80
438,87,1,439,2,2431,97,20
439,87,1,440,8,2439,82,80
440,87,1,441,7,2446,51,70
441,87,1,442,3,2449,0,30
442,87,1,443,7,2456,111,70
443,87,1,444,4,2460,42,40
444,87,1,445,7,2467,0,70
445,87,1,446,3,2470,113,30
446,87,1,447,5,2475,0,50
447,87,1,448,7,2482,144,70
448,87,1,449,9,2491,0,90
449,87,1,450,9,2500,0,90
450,87,1,451,6,2506,220,60
451,87,1,452,5,2511,42,50
452,87,1,453,6,2517,52,60
453,87,1,454,7,2524,0,70
454,87,1,455,3,2527,97,30
455,87,1,456,5,2532,48,50
456,87,1,457,3,2535,30,30
457,87,1,458,9,2544,96,90
458,87,1,459,6,2550,67,60
459,87,1,460,4,2554,31,40
460,87,1,461,5,2559,57,50
461,87,1,462,8,2567,80,80
462,87,1,463,3,2570,22,30
463,87,1,464,8,2578,79,80
464,87,1,465,8,2586,80,80
465,87,1,466,7,2593,0,70
466,87,1,467,9,2602,0,90
467,87,1,468,2,2604,210,20
468,87,1,469,5,2609,0,50
469,87,1,470,5,2614,105,50
470,87,1,471,7,2621,69,70
471,87,1,472,3,2624,44,30
472,87,1,473,3,2627,30,30
473,87,1,474,3,2630,32,30
474,87,1,475,8,2638,0,80
475,87,1,476,9,2647,0,90
476,87,1,477,8,2655,231,80
477,87,1,478,8,2663,0,80
478,87,1,479,7,2670,136,70
479,87,1,480,2,2672,13,20
480,87,1,481,2,2674,15,20
481,87,1,482,6,2680,59,60
482,87,1,483,5,2685,0,50
483,87,1,484,4,2689,88,40
484,87,1,485,6,2695,0,60
485,87,1,486,5,2700,107,50
486,87,1,487,3,2703,33,30
487,87,1,488,3,2706,0,30
488,87,1,489,6,2712,0,60
489,87,1,490,9,2721,0,90
490,87,1,491,2,2723,215,20
491,87,1,492,8,2731,76,80
492,87,1,493,7,2738,0,70
493,87,1,494,7,2745,131,70
494,87,1,495,3,2748,35,30
495,87,1,496,4,2752,53,40
496,87,1,497,4,2756,38,40
497,87,1,498,2,2758,26,20
498,87,1,499,7,2765,0,70
499,87,1,500,6,2771,102,60
500,87,1,501,2,2773,0,20
501,87,1,502,2,2775,39,20
502,87,1,503,3,2778,0,30
503,87,1,504,5,2783,80,50
504,87,1,505,6,2789,49,60
505,87,1,506,5,2794,52,50
506,87,1,507,6,2800,0,60
507,87,1,508,8,2808,0,80
508,87,1,509,8,2816,235,80
509,87,1,510,3,2819,28,30
510,87,1,511,8,2827,84,80
511,87,1,512,4,2831,39,40
512,87,1,513,6,2837,65,60
513,87,1,514,9,2846,80,90
514,87,1,515,3,2849,0,30
515,87,1,516,8,2857,102,80
516,87,1,517,4,2861,40,40
517,87,1,518,9,2870,101,90
518,87,1,519,4,2874,0,40
519,87,1,520,4,2878,78,40
520,87,1,521,6,2884,0,60
521,87,1,522,3,2887,96,30
522,87,1,523,3,2890,39,30
523,87,1,524,6,2896,55,60
524,87,1,525,3,2899,32,30
525,87,1,526,2,2901,21,20
526,87,1,527,6,2907,0,60
527,87,1,528,8,2915,133,80
528,87,1,529,9,2924,90,90
529,87,1,530,9,2933,95,90
530,87,1,531,9,2942,85,90
531,87,1,532,4,2946,43,40
532,87,1,533,2,2948,17,20
533,87,1,534,2,2950,0,20
534,87,1,535,3,2953,57,30
535,87,1,536,8,2961,79,80
536,87,1,537,8,2969,91,80
537,87,1,538,7,2976,73,70
538,87,1,539,9,2985,94,90
539,87,1,540,6,2991,58,60
540,87,1,541,9,3000,87,90
541,87,1,542,5,3005,43,50
542,87,1,543,5,3010,51,50
543,87,1,544,6,3016,66,60
544,87,1,545,9,3025,82,90
545,87,1,546,4,3029,46,40
546,87,1,547,3,3032,32,30
547,87,1,548,3,3035,34,30
548,87,1,549,6,3041,66,60
549,87,1,550,4,3045,0,40
550,87,1,551,2,3047,60,20
551,87,1,552,9,3056,96,90
552,87,1,553,8,3064,81,80
553,87,1,554,9,3073,0,90
554,87,1,555,9,3082,199,90
555,87,1,556,9,3091,82,90
556,87,1,557,2,3093,0,20
557,87,1,558,5,3098,0,50
558,87,1,559,4,3102,114,40
559,87,1,560,6,3108,50,60
560,87,1,561,6,3114,51,60
561,87,1,562,2,3116,0,20
562,87,1,563,8,3124,99,80
563,87,1,564,9,3133,94,90
564,87,1,565,5,3138,56,50
565,87,1,566,2,3140,0,20
566,87,1,567,2,3142,0,20
567,87,1,568,8,3150,112,80
568,87,1,569,5,3155,63,50
569,87,1,570,9,3164,92,90
570,87,1,571,7,3171,0,70
571,87,1,572,6,3177,147,60
572,87,1,573,6,3183,67,60
573,87,1,574,2,3185,27,20
574,87,1,575,8,3193,87,80
575,87,1,576,5,3198,53,50
576,87,1,577,4,3202,34,40
577,87,1,578,2,3204,23,20
578,87,1,579,8,3212,0,80
579,87,1,580,8,3220,166,80
580,87,1,581,5,3225,55,50
581,87,1,582,8,3233,98,80
582,87,1,583,2,3235,29,20
583,87,1,584,8,3243,0,80
584,87,1,585,9,3252,0,90
585,87,1,586,2,3254,178,20
586,87,1,587,5,3259,44,50
587,87,1,588,4,3263,39,40
588,87,1,589,7,3270,0,70
589,87,1,590,5,3275,110,50
590,87,1,591,9,3284,96,90
591,87,1,592,7,3291,86,70
592,87,1,593,5,3296,0,50
593,87,1,594,7,3303,127,70
594,87,1,595,4,3307,0,40
595,87,1,596,3,3310,0,30
596,87,1,597,6,3316,0,60
597,87,1,598,4,3320,167,40
598,87,1,599,5,3325,53,50
599,87,1,600,8,3333,92,80
600,87,1,601,9,3342,0,90
601,87,1,602,4,3346,132,40
602,87,1,603,6,3352,62,60
603,87,1,604,9,3361,95,90
604,87,1,605,8,3369,88,80
605,87,1,606,7,3376,0,70
606,87,1,607,5,3381,117,50
607,87,1,608,6,3387,42,60
608,87,1,609,6,3393,47,60
609,87,1,610,2,3395,24,20
610,87,1,611,8,3403,0,80
611,87,1,612,7,3410,156,70
612,87,1,613,5,3415,52,50
613,87,1,614,7,3422,62,70
614,87,1,615,9,3431,86,90
615,87,1,616,2,3433,21,20
616,87,1,617,4,3437,26,40
617,87,1,618,2,3439,23,20
618,87,1,619,7,3446,69,70
619,87,1,620,3,3449,25,30
620,87,1,621,4,3453,40,40
621,87,1,622,6,3459,0,60
622,87,1,623,4,3463,0,40
623,87,1,624,7,3470,155,70
624,87,1,625,6,3476,44,60
625,87,1,626,6,3482,57,60
626,87,1,627,7,3489,85,70
627,87,1,628,8,3497,71,80
628,87,1,629,4,3501,0,40
629,87,1,630,3,3504,61,30
630,87,1,631,6,3510,0,60
631,87,1,632,4,3514,111,40
632,87,1,633,3,3517,26,30
633,87,1,634,8,3525,58,80
634,87,1,635,4,3529,41,40
635,87,1,636,6,3535,53,60
636,87,1,637,2,3537,22,20
637,87,1,638,7,3544,63,70
638,87,1,639,8,3552,81,80
639,87,1,640,8,3560,86,80
640,87,1,641,9,3569,94,90
641,87,1,642,3,3572,0,30
642,87,1,643,8,3580,97,80
643,87,1,644,4,3584,39,40
644,87,1,645,9,3593,0,90
645,87,1,646,2,3595,103,20
646,87,1,647,9,3604,0,90
647,87,1,648,9,3613,0,90
648,87,1,649,5,3618,234,50
649,87,1,650,3,3621,25,30
650,87,1,651,3,3624,34,30
651,87,1,652,2,3626,22,20
652,87,1,653,4,3630,30,40
653,87,1,654,9,3639,0,90
654,87,1,655,3,3642,103,30
655,87,1,656,5,3647,44,50
656,87,1,657,2,3649,18,20
657,87,1,658,7,3656,0,70
658,87,1,659,9,3665,180,90
659,87,1,660,5,3670,51,50
660,87,1,661,4,3674,23,40
661,87,1,662,5,3679,39,50
662,87,1,663,5,3684,53,50
663,87,1,664,7,3691,67,70
664,87,1,665,8,3699,0,80
665,87,1,666,9,3708,153,90
666,87,1,667,6,3714,65,60
667,87,1,668,5,3719,0,50
668,87,1,669,7,3726,115,70
669,87,1,670,8,3734,81,80
670,87,1,671,9,3743,0,90
671,87,1,672,8,3751,157,80
672,87,1,673,9,3760,0,90
673,87,1,674,5,3765,131,50
674,87,1,675,9,3774,96,90
675,87,1,676,9,3783,75,90
676,87,1,677,8,3791,0,80
677,87,1,678,4,3795,124,40
678,87,1,679,2,3797,19,20
679,87,1,680,9,3806,0,90
680,87,1,681,3,3809,146,30
681,87,1,682,5,3814,44,50
682,87,1,683,8,3822,66,80
683,87,1,684,2,3824,8,20
684,87,1,685,3,3827,0,30
685,87,1,686,6,3833,102,60
686,87,1,687,7,3840,68,70
687,87,1,688,3,3843,29,30
688,87,1,689,2,3845,27,20
689,87,1,690,8,3853,0,80
690,87,1,691,9,3862,180,90
691,87,1,692,8,3870,83,80
692,87,1,693,2,3872,15,20
693,87,1,694,9,3881,90,90
694,87,1,695,9,3890,89,90
695,87,1,696,8,3898,80,80
696,87,1,697,7,3905,0,70
697,87,1,698,6,3911,0,60
698,87,1,699,4,3915,142,40
699,87,1,700,5,3920,50,50
700,87,1,701,4,3924,0,40
701,87,1,702,8,3932,123,80
702,87,1,703,2,3934,12,20
703,87,1,704,7,3941,74,70
704,87,1,705,2,3943,24,20
705,87,1,706,7,3950,65,70
706,87,1,707,6,3956,71,60
707,87,1,708,4,3960,0,40
708,87,1,709,9,3969,121,90
709,87,1,710,9,3978,0,90
710,87,1,711,2,3980,112,20
711,87,1,712,7,3987,66,70
712,87,1,713,9,3996,98,90
713,87,1,714,6,4002,50,60
714,87,1,715,7,4009,74,70
715,87,1,716,8,4017,70,80
716,87,1,717,9,4026,82,90
717,87,1,718,5,4031,0,50
718,87,1,719,2,4033,77,20
719,87,1,720,3,4036,29,30
720,87,1,721,2,4038,0,20
721,87,1,722,4,4042,75,40
722,87,1,723,2,4044,20,20
723,87,1,724,3,4047,0,30
724,87,1,725,3,4050,58,30
725,87,1,726,8,4058,75,80
726,87,1,727,6,4064,69,60
727,87,1,728,9,4073,91,90
728,87,1,729,2,4075,0,20
729,87,1,730,9,4084,115,90
730,87,1,731,5,4089,0,50
731,87,1,732,2,4091,0,20
732,87,1,733,2,4093,0,20
733,87,1,734,7,4100,177,70
734,87,1,735,7,4107,0,70
735,87,1,736,8,4115,162,80
736,87,1,737,8,4123,88,80
737,87,1,738,5,4128,43,50
738,87,1,739,6,4134,0,60
739,87,1,740,7,4141,134,70
740,87,1,741,7,4148,0,70
741,87,1,742,9,4157,162,90
742,87,1,743,7,4164,78,70
743,87,1,744,8,4172,78,80
744,87,1,745,8,4180,77,80
745,87,1,746,3,4183,34,30
746,87,1,747,4,4187,0,40
747,87,1,748,5,4192,78,50
748,87,1,749,8,4200,94,80
749,87,1,750,3,4203,24,30
750,87,1,751,8,4211,0,80
751,87,1,752,9,4220,183,90
752,87,1,753,2,4222,19,20
753,87,1,754,7,4229,69,70
754,87,1,755,3,4232,35,30
755,87,1,756,3,4235,0,30
756,87,1,757,8,4243,100,80
757,87,1,758,4,4247,38,40
758,87,1,759,7,4254,78,70
759,87,1,760,6,4260,0,60
760,87,1,761,8,4268,150,80
761,87,1,762,6,4274,0,60
762,87,1,763,4,4278,107,40
763,87,1,764,9,4287,92,90
764,87,1,765,9,4296,0,90
765,87,1,766,8,4304,0,80
766,87,1,767,3,4307,200,30
767,87,1,768,4,4311,41,40
768,87,1,769,8,4319,0,80
769,87,1,770,4,4323,116,40
770,87,1,771,5,4328,53,50
771,87,1,772,8,4336,73,80
772,87,1,773,2,4338,19,20
773,87,1,774,7,4345,0,70
774,87,1,775,6,4351,137,60
775,87,1,776,2,4353,26,20
776,87,1,777,6,4359,76,60
777,87,1,778,9,4368,88,90
778,87,1,779,4,4372,34,40
779,87,1,780,3,4375,28,30
780,87,1,781,9,4384,91,90
781,87,1,782,9,4393,0,90
782,87,1,783,7,4400,0,70
783,87,1,784,4,4404,217,40
784,87,1,785,4,4408,35,40
785,87,1,786,9,4417,0,90
786,87,1,787,4,4421,120,40
787,87,1,788,3,4424,34,30
788,87,1,789,7,4431,0,70
789,87,1,790,8,4439,0,80
790,87,1,791,7,4446,231,70
791,87,1,792,3,4449,28,30
792,87,1,793,2,4451,22,20
793,87,1,794,8,4459,89,80
794,87,1,795,3,4462,29,30
795,87,1,796,9,4471,115,90
796,87,1,797,3,4474,27,30
797,87,1,798,6,4480,59,60
798,87,1,799,8,4488,0,80
799,87,1,800,5,4493,126,50
800,87,1,801,2,4495,24,20
801,87,1,802,2,4497,0,20
802,87,1,803,9,4506,0,90
803,87,1,804,6,4512,162,60
804,87,1,805,4,4516,42,40
805,87,1,806,5,4521,0,50
806,87,1,807,3,4524,71,30
807,87,1,808,4,4528,56,40
808,87,1,809,3,4531,29,30
809,87,1,810,4,4535,37,40
810,87,1,811,7,4542,79,70
811,87,1,812,8,4550,60,80
812,87,1,813,2,4552,16,20
813,87,1,814,7,4559,83,70
814,87,1,815,3,4562,32,30
815,87,1,816,9,4571,86,90
816,87,1,817,4,4575,0,40
817,87,1,818,5,4580,84,50
818,87,1,819,7,4587,64,70
819,87,1,820,7,4594,72,70
820,87,1,821,2,4596,27,20
821,87,1,822,4,4600,51,40
822,87,1,823,5,4605,44,50
823,87,1,824,5,4610,41,50
824,87,1,825,7,4617,74,70
825,87,1,826,8,4625,0,80
826,87,1,827,4,4629,121,40
827,87,1,828,6,4635,51,60
828,87,1,829,2,4637,0,20
829,87,1,830,9,4646,0,90
830,87,1,831,2,4648,139,20
831,87,1,832,3,4651,34,30
832,87,1,833,9,4660,73,90
833,87,1,834,2,4662,16,20
834,87,1,835,5,4667,44,50
835,87,1,836,8,4675,73,80
836,87,1,837,5,4680,40,50
837,87,1,838,8,4688,0,80
838,87,1,839,5,4693,131,50
839,87,1,840,5,4698,0,50
840,87,1,841,6,4704,0,60
841,87,1,842,4,4708,146,40
842,87,1,843,7,4715,60,70
843,87,1,844,4,4719,35,40
844,87,1,845,5,4724,60,50
845,87,1,846,4,4728,47,40
846,87,1,847,8,4736,76,80
847,87,1,848,3,4739,26,30
848,87,1,849,8,4747,61,80
849,87,1,850,8,4755,90,80
850,87,1,851,6,4761,0,60
851,87,1,852,5,4766,103,50
852,87,1,853,3,4769,17,30
853,87,1,854,8,4777,85,80
854,87,1,855,2,4779,19,20
855,87,1,856,3,4782,33,30
856,87,1,857,8,4790,0,80
857,87,1,858,9,4799,0,90
858,87,1,859,2,4801,205,20
859,87,1,860,5,4806,45,50
860,87,1,861,6,4812,63,60
861,87,1,862,9,4821,91,90
862,87,1,863,2,4823,16,20
863,87,1,864,6,4829,57,60
864,87,1,865,9,4838,94,90
865,87,1,866,9,4847,100,90
866,87,1,867,7,4854,0,70
867,87,1,868,4,4858,113,40
868,87,1,869,2,4860,0,20
869,87,1,870,7,4867,0,70
870,87,1,871,7,4874,147,70
871,87,1,872,5,4879,53,50
872,87,1,873,8,4887,83,80
873,87,1,874,9,4896,0,90
874,87,1,875,8,4904,183,80
875,87,1,876,5,4909,50,50
876,87,1,877,7,4916,58,70
877,87,1,878,4,4920,0,40
878,87,1,879,2,4922,59,20
879,87,1,880,6,4928,81,60
880,87,1,881,3,4931,27,30
881,87,1,882,2,4933,0,20
882,87,1,883,5,4938,75,50
883,87,1,884,3,4941,29,30
884,87,1,885,3,4944,36,30
885,87,1,886,4,4948,0,40
886,87,1,887,9,4957,121,90
887,87,1,888,4,4961,0,40
888,87,1,889,4,4965,0,40
889,87,1,890,4,4969,115,40
890,87,1,891,5,4974,0,50
891,87,1,892,9,4983,140,90
892,87,1,893,9,4992,76,90
893,87,2,1,6,6,62,60
894,87,2,2,8,14,82,80
895,87,2,3,2,16,0,20
896,87,2,4,4,20,59,40
897,87,2,5,5,25,53,50
898,87,2,6,5,30,0,50
899,87,2,7,3,33,94,30
900,87,2,8,3,36,30,30
901,87,2,9,4,40,0,40
902,87,2,10,2,42,72,20
903,87,2,11,5,47,39,50
904,87,2,12,9,56,100,90
905,87,2,13,4,60,31,40
906,87,2,14,8,68,70,80
907,87,2,15,6,74,57,60
908,87,2,16,9,83,85,90
909,87,2,17,7,90,79,70
910,87,2,18,3,93,28,30
911,87,2,19,7,100,78,70
912,87,2,20,6,106,0,60
913,87,2,21,8,114,147,80
914,87,2,22,2,116,21,20
915,87,2,23,7,123,0,70
916,87,2,24,6,129,127,60
917,87,2,25,2,131,25,20
918,87,2,26,6,137,73,60
919,87,2,27,5,142,49,50
920,87,2,28,2,144,0,20
921,87,2,29,8,152,0,80
922,87,2,30,3,155,115,30
923,87,2,31,5,160,59,50
924,87,2,32,3,163,40,30
925,87,2,33,7,170,0,70
926,87,2,34,9,179,164,90
927,87,2,35,8,187,71,80
928,87,2,36,3,190,0,30
929,87,2,37,3,193,60,30
930,87,2,38,9,202,0,90
931,87,2,39,4,206,0,40
932,87,2,40,4,210,179,40
933,87,2,41,4,214,0,40
934,87,2,42,7,221,104,70
935,87,2,43,5,226,34,50
936,87,2,44,3,229,38,30
937,87,2,45,7,236,63,70
938,87,2,46,2,238,0,20
939,87,2,47,9,247,109,90
940,87,2,48,2,249,15,20
941,87,2,49,9,258,0,90
942,87,2,50,8,266,166,80
943,87,2,51,8,274,82,80
944,87,2,52,7,281,77,70
945,87,2,53,6,287,57,60
946,87,2,54,7,294,66,70
947,87,2,55,2,296,14,20
948,87,2,56,4,300,0,40
949,87,2,57,8,308,124,80
950,87,2,58,6,314,60,60
951,87,2,59,3,317,0,30
952,87,2,60,5,322,73,50
953,87,2,61,3,325,0,30
954,87,2,62,5,330,79,50
955,87,2,63,7,337,66,70
956,87,2,64,7,344,77,70
957,87,2,65,3,347,31,30
958,87,2,66,3,350,34,30
959,87,2,67,6,356,0,60
960,87,2,68,6,362,110,60
961,87,2,69,6,368,68,60
962,87,2,70,3,371,40,30
963,87,2,71,2,373,16,20
964,87,2,72,4,377,47,40
965,87,2,73,9,386,84,90
966,87,2,74,2,388,16,20
967,87,2,75,3,391,28,30
968,87,2,76,9,400,96,90
969,87,2,77,9,409,92,90
970,87,2,78,6,415,67,60
971,87,2,79,4,419,44,40
972,87,2,80,3,422,25,30
973,87,2,81,8,430,81,80
974,87,2,82,4,434,34,40
975,87,2,83,3,437,0,30
976,87,2,84,7,444,108,70
977,87,2,85,3,447,37,30
978,87,2,86,9,456,0,90
979,87,2,87,6,462,148,60
980,87,2,88,9,471,88,90
981,87,2,89,5,476,56,50
982,87,2,90,4,480,0,40
983,87,2,91,5,485,0,50
984,87,2,92,7,492,155,70
985,87,2,93,3,495,30,30
986,87,2,94,2,497,22,20
987,87,2,95,9,506,91,90
988,87,2,96,3,509,38,30
989,87,2,97,2,511,17,20
990,87,2,98,6,517,0,60
991,87,2,99,7,524,124,70
992,87,2,100,4,528,30,40
993,87,2,101,4,532,0,40
994,87,2,102,3,535,0,30
995,87,2,103,8,543,134,80
996,87,2,104,3,546,31,30
997,87,2,105,8,554,75,80
998,87,2,106,8,562,0,80
999,87,2,107,2,564,108,20
1000,87,2,108,3,567,0,30
1001,87,2,109,8,575,115,80
1002,87,2,110,9,584,96,90
1003,87,2,111,2,586,0,20
1004,87,2,112,9,595,108,90
1005,87,2,113,4,599,46,40
1006,87,2,114,4,603,45,40
1007,87,2,115,5,608,61,50
1008,87,2,116,8,616,71,80
1009,87,2,117,7,623,57,70
1010,87,2,118,6,629,0,60
1011,87,2,119,4,633,102,40
1012,87,2,120,5,638,49,50
1013,87,2,121,6,644,59,60
1014,87,2,122,6,650,0,60
1015,87,2,123,7,657,147,70
1016,87,2,124,7,664,69,70
1017,87,2,125,9,673,0,90
1018,87,2,126,9,682,197,90
1019,87,2,127,2,684,23,20
1020,87,2,128,6,690,47,60
1021,87,2,129,8,698,77,80
1022,87,2,130,4,702,31,40
1023,87,2,131,9,711,71,90
1024,87,2,132,3,714,31,30
1025,87,2,133,3,717,35,30
1026,87,2,134,6,723,57,60
1027,87,2,135,9,732,89,90
1028,87,2,136,7,739,0,70
1029,87,2,137,4,743,109,40
1030,87,2,138,6,749,48,60
1031,87,2,139,4,753,35,40
1032,87,2,140,6,759,56,60
1033,87,2,141,7,766,59,70
1034,87,2,142,2,768,21,20
1035,87,2,143,3,771,26,30
1036,87,2,144,3,774,19,30
1037,87,2,145,4,778,0,40
1038,87,2,146,5,783,80,50
1039,87,2,147,7,790,0,70
1040,87,2,148,7,797,131,70
1041,87,2,149,6,803,0,60
1042,87,2,150,2,805,90,20
1043,87,2,151,6,811,51,60
1044,87,2,152,7,818,0,70
1045,87,2,153,4,822,110,40
1046,87,2,154,2,824,0,20
1047,87,2,155,3,827,51,30
1048,87,2,156,2,829,17,20
1049,87,2,157,4,833,40,40
1050,87,2,158,4,837,34,40
1051,87,2,159,9,846,86,90
1052,87,2,160,2,848,16,20
1053,87,2,161,2,850,0,20
1054,87,2,162,8,858,0,80
1055,87,2,163,3,861,141,30
1056,87,2,164,6,867,67,60
1057,87,2,165,2,869,15,20
1058,87,2,166,6,875,69,60
1059,87,2,167,8,883,77,80
1060,87,2,168,4,887,48,40
1061,87,2,169,7,894,66,70
1062,87,2,170,4,898,0,40
1063,87,2,171,7,905,0,70
1064,87,2,172,8,913,182,80
1065,87,2,173,8,921,83,80
1066,87,2,174,4,925,38,40
1067,87,2,175,4,929,37,40
1068,87,2,176,6,935,64,60
1069,87,2,177,4,939,36,40
1070,87,2,178,7,946,76,70
1071,87,2,179,9,955,86,90
1072,87,2,180,3,958,0,30
1073,87,2,181,6,964,97,60
1074,87,2,182,9,973,98,90
1075,87,2,183,3,976,32,30
1076,87,2,184,4,980,40,40
1077,87,2,185,5,985,63,50
1078,87,2,186,2,987,0,20
1079,87,2,187,3,990,56,30
1080,87,2,188,3,993,28,30
1081,87,2,189,9,1002,92,90
1082,87,2,190,6,1008,53,60
1083,87,2,191,6,1014,0,60
1084,87,2,192,3,1017,0,30
1085,87,2,193,8,1025,187,80
1086,87,2,194,2,1027,24,20
1087,87,2,195,6,1033,65,60
1088,87,2,196,7,1040,78,70
1089,87,2,197,9,1049,96,90
1090,87,2,198,5,1054,56,50
1091,87,2,199,9,1063,79,90
1092,87,2,200,5,1068,57,50
1093,87,2,201,4,1072,37,40
1094,87,2,202,4,1076,52,40
1095,87,2,203,7,1083,77,70
1096,87,2,204,5,1088,48,50
1097,87,2,205,5,1093,47,50
1098,87,2,206,2,1095,19,20
1099,87,2,207,9,1104,77,90
1100,87,2,208,6,1110,52,60
1101,87,2,209,9,1119,87,90
1102,87,2,210,5,1124,40,50
1103,87,2,211,5,1129,51,50
1104,87,2,212,3,1132,19,30
1105,87,2,213,3,1135,31,30
1106,87,2,214,7,1142,73,70
1107,87,2,215,3,1145,28,30
1108,87,2,216,7,1152,0,70
1109,87,2,217,8,1160,152,80
1110,87,2,218,6,1166,64,60
1111,87,2,219,6,1172,51,60
1112,87,2,220,6,1178,66,60
1113,87,2,221,4,1182,0,40
1114,87,2,222,3,1185,71,30
1115,87,2,223,3,1188,26,30
1116,87,2,224,7,1195,62,70
1117,87,2,225,8,1203,0,80
1118,87,2,226,2,1205,0,20
1119,87,2,227,4,1209,148,40
1120,87,2,228,4,1213,31,40
1121,87,2,229,7,1220,65,70
1122,87,2,230,5,1225,0,50
1123,87,2,231,5,1230,82,50
1124,87,2,232,6,1236,55,60
1125,87,2,233,2,1238,23,20
1126,87,2,234,9,1247,105,90
1127,87,2,235,9,1256,112,90
1128,87,2,236,4,1260,40,40
1129,87,2,237,5,1265,0,50
1130,87,2,238,2,1267,71,20
1131,87,2,239,9,1276,0,90
1132,87,2,240,4,1280,127,40
1133,87,2,241,9,1289,91,90
1134,87,2,242,4,1293,33,40
1135,87,2,243,3,1296,0,30
1136,87,2,244,4,1300,78,40
1137,87,2,245,9,1309,100,90
1138,87,2,246,4,1313,33,40
1139,87,2,247,9,1322,88,90
1140,87,2,248,3,1325,0,30
1141,87,2,249,6,1331,112,60
1142,87,2,250,5,1336,47,50
1143,87,2,251,5,1341,61,50
1144,87,2,252,5,1346,50,50
1145,87,2,253,2,1348,19,20
1146,87,2,254,5,1353,54,50
1147,87,2,255,8,1361,0,80
1148,87,2,256,4,1365,116,40
1149,87,2,257,7,1372,66,70
1150,87,2,258,6,1378,0,60
1151,87,2,259,8,1386,131,80
1152,87,2,260,2,1388,21,20
1153,87,2,261,8,1396,84,80
1154,87,2,262,7,1403,61,70
1155,87,2,263,4,1407,29,40
1156,87,2,264,5,1412,51,50
1157,87,2,265,8,1420,0,80
1158,87,2,266,8,1428,172,80
1159,87,2,267,9,1437,0,90
1160,87,2,268,7,1444,150,70
1161,87,2,269,2,1446,0,20
1162,87,2,270,6,1452,90,60
1163,87,2,271,5,1457,0,50
1164,87,2,272,7,1464,0,70
1165,87,2,273,5,1469,179,50
1166,87,2,274,9,1478,0,90
1167,87,2,275,4,1482,136,40
1168,87,2,276,5,1487,0,50
1169,87,2,277,3,1490,75,30
1170,87,2,278,8,1498,0,80
1171,87,2,279,9,1507,168,90
1172,87,2,280,8,1515,69,80
1173,87,2,281,5,1520,0,50
1174,87,2,282,5,1525,120,50
1175,87,2,283,9,1534,0,90
1176,87,2,284,4,1538,126,40
1177,87,2,285,8,1546,80,80
1178,87,2,286,4,1550,0,40
1179,87,2,287,7,1557,0,70
1180,87,2,288,2,1559,139,20
1181,87,2,289,8,1567,86,80
1182,87,2,290,2,1569,23,20
1183,87,2,291,5,1574,49,50
1184,87,2,292,7,1581,76,70
1185,87,2,293,9,1590,99,90
1186,87,2,294,9,1599,84,90
1187,87,2,295,2,1601,22,20
1188,87,2,296,9,1610,0,90
1189,87,2,297,9,1619,181,90
1190,87,2,298,2,1621,18,20
1191,87,2,299,3,1624,22,30
1192,87,2,300,8,1632,0,80
1193,87,2,301,8,1640,173,80
1194,87,2,302,2,1642,12,20
1195,87,2,303,6,1648,51,60
1196,87,2,304,5,1653,43,50
1197,87,2,305,4,1657,39,40
1198,87,2,306,9,1666,90,90
1199,87,2,307,3,1669,30,30
1200,87,2,308,9,1678,76,90
1201,87,2,309,9,1687,80,90
1202,87,2,310,7,1694,56,70
1203,87,2,311,6,1700,0,60
1204,87,2,312,5,1705,111,50
1205,87,2,313,3,1708,27,30
1206,87,2,314,6,1714,0,60
1207,87,2,315,7,1721,130,70
1208,87,2,316,2,1723,24,20
1209,87,2,317,5,1728,0,50
1210,87,2,318,6,1734,109,60
1211,87,2,319,6,1740,0,60
1212,87,2,320,2,1742,89,20
1213,87,2,321,4,1746,46,40
1214,87,2,322,8,1754,0,80
1215,87,2,323,8,1762,168,80
1216,87,2,324,2,1764,18,20
1217,87,2,325,8,1772,92,80
1218,87,2,326,7,1779,67,70
1219,87,2,327,6,1785,54,60
1220,87,2,328,3,1788,0,30
1221,87,2,329,6,1794,0,60
1222,87,2,330,4,1798,129,40
1223,87,2,331,9,1807,93,90
1224,87,2,332,7,1814,88,70
1225,87,2,333,8,1822,69,80
1226,87,2,334,3,1825,28,30
1227,87,2,335,3,1828,36,30
1228,87,2,336,2,1830,17,20
1229,87,2,337,4,1834,44,40
1230,87,2,338,2,1836,20,20
1231,87,2,339,9,1845,97,90
1232,87,2,340,7,1852,82,70
1233,87,2,341,6,1858,50,60
1234,87,2,342,2,1860,25,20
1235,87,2,343,5,1865,33,50
1236,87,2,344,9,1874,95,90
1237,87,2,345,6,1880,72,60
1238,87,2,346,2,1882,20,20
1239,87,2,347,3,1885,29,30
1240,87,2,348,8,1893,87,80
1241,87,2,349,9,1902,79,90
1242,87,2,350,8,1910,93,80
1243,87,2,351,9,1919,86,90
1244,87,2,352,7,1926,0,70
1245,87,2,353,6,1932,113,60
1246,87,2,354,9,1941,0,90
1247,87,2,355,6,1947,156,60
1248,87,2,356,4,1951,35,40
1249,87,2,357,4,1955,0,40
1250,87,2,358,2,1957,63,20
1251,87,2,359,3,1960,19,30
1252,87,2,360,5,1965,60,50
1253,87,2,361,2,1967,25,20
1254,87,2,362,8,1975,90,80
1255,87,2,363,7,1982,0,70
1256,87,2,364,8,1990,166,80
1257,87,2,365,5,1995,42,50
1258,87,2,366,6,2001,71,60
1259,87,2,367,8,2009,0,80
1260,87,2,368,9,2018,0,90
1261,87,2,369,6,2024,0,60
1262,87,2,370,9,2033,0,90
1263,87,2,371,3,2036,352,30
1264,87,2,372,3,2039,36,30
1265,87,2,373,9,2048,83,90
1266,87,2,374,7,2055,71,70
1267,87,2,375,5,2060,57,50
1268,87,2,376,9,2069,88,90
1269,87,2,377,8,2077,81,80
1270,87,2,378,6,2083,0,60
1271,87,2,379,5,2088,0,50
1272,87,2,380,9,2097,202,90
1273,87,2,381,7,2104,0,70
1274,87,2,382,2,2106,85,20
1275,87,2,383,2,2108,21,20
1276,87,2,384,4,2112,46,40
1277,87,2,385,3,2115,0,30
1278,87,2,386,2,2117,41,20
1279,87,2,387,5,2122,0,50
1280,87,2,388,8,2130,111,80
1281,87,2,389,5,2135,0,50
1282,87,2,390,8,2143,131,80
1283,87,2,391,6,2149,0,60
1284,87,2,392,8,2157,134,80
1285,87,2,393,4,2161,30,40
1286,87,2,394,3,2164,0,30
1287,87,2,395,9,2173,138,90
1288,87,2,396,8,2181,87,80
1289,87,2,397,5,2186,43,50
1290,87,2,398,3,2189,33,30
1291,87,2,399,6,2195,68,60
1292,87,2,400,3,2198,23,30
1293,87,2,401,2,2200,0,20
1294,87,2,402,8,2208,110,80
1295,87,2,403,5,2213,0,50
1296,87,2,404,6,2219,114,60
1297,87,2,405,5,2224,0,50
1298,87,2,406,3,2227,0,30
1299,87,2,407,8,2235,0,80
1300,87,2,408,7,2242,0,70
1301,87,2,409,8,2250,325,80
1302,87,2,410,6,2256,67,60
1303,87,2,411,3,2259,0,30
1304,87,2,412,3,2262,48,30
1305,87,2,413,2,2264,20,20
1306,87,2,414,4,2268,30,40
1307,87,2,415,2,2270,0,20
1308,87,2,416,9,2279,111,90
1309,87,2,417,4,2283,40,40
1310,87,2,418,2,2285,18,20
1311,87,2,419,5,2290,72,50
1312,87,2,420,3,2293,22,30
1313,87,2,421,4,2297,43,40
1314,87,2,422,9,2306,0,90
1315,87,2,423,2,2308,100,20
1316,87,2,424,4,2312,40,40
1317,87,2,425,2,2314,15,20
1318,87,2,426,6,2320,0,60
1319,87,2,427,8,2328,0,80
1320,87,2,428,6,2334,191,60
1321,87,2,429,5,2339,43,50
1322,87,2,430,8,2347,76,80
1323,87,2,431,3,2350,23,30
1324,87,2,432,7,2357,0,70
1325,87,2,433,3,2360,83,30
1326,87,2,434,7,2367,67,70
1327,87,2,435,9,2376,0,90
1328,87,2,436,8,2384,189,80
1329,87,2,437,7,2391,0,70
1330,87,2,438,4,2395,118,40
1331,87,2,439,3,2398,21,30
1332,87,2,440,6,2404,55,60
1333,87,2,441,2,2406,17,20
1334,87,2,442,3,2409,0,30
1335,87,2,443,8,2417,122,80
1336,87,2,444,9,2426,0,90
1337,87,2,445,3,2429,113,30
1338,87,2,446,8,2437,83,80
1339,87,2,447,4,2441,43,40
1340,87,2,448,6,2447,0,60
1341,87,2,449,8,2455,148,80
1342,87,2,450,5,2460,54,50
1343,87,2,451,5,2465,59,50
1344,87,2,452,4,2469,36,40
1345,87,2,453,7,2476,0,70
1346,87,2,454,9,2485,135,90
1347,87,2,455,2,2487,22,20
1348,87,2,456,6,2493,0,60
1349,87,2,457,8,2501,154,80
1350,87,2,458,2,2503,18,20
1351,87,2,459,8,2511,0,80
1352,87,2,460,7,2518,0,70
1353,87,2,461,6,2524,184,60
1354,87,2,462,6,2530,0,60
1355,87,2,463,4,2534,0,40
1356,87,2,464,5,2539,0,50
1357,87,2,465,2,2541,162,20
1358,87,2,466,3,2544,33,30
1359,87,2,467,2,2546,22,20
1360,87,2,468,3,2549,29,30
1361,87,2,469,9,2558,93,90
1362,87,2,470,8,2566,93,80
1363,87,2,471,7,2573,68,70
1364,87,2,472,5,2578,46,50
1365,87,2,473,6,2584,54,60
1366,87,2,474,5,2589,43,50
1367,87,2,475,7,2596,0,70
1368,87,2,476,7,2603,139,70
1369,87,2,477,8,2611,0,80
1370,87,2,478,3,2614,102,30
1371,87,2,479,5,2619,48,50
1372,87,2,480,6,2625,64,60
1373,87,2,481,5,2630,0,50
1374,87,2,482,2,2632,71,20
1375,87,2,483,8,2640,82,80
1376,87,2,484,9,2649,90,90
1377,87,2,485,3,2652,34,30
1378,87,2,486,5,2657,53,50
1379,87,2,487,5,2662,40,50
1380,87,2,488,8,2670,87,80
1381,87,2,489,9,2679,0,90
1382,87,2,490,5,2684,0,50
1383,87,2,491,5,2689,211,50
1384,87,2,492,5,2694,0,50
1385,87,2,493,7,2701,149,70
1386,87,2,494,3,2704,26,30
1387,87,2,495,7,2711,58,70
1388,87,2,496,3,2714,35,30
1389,87,2,497,4,2718,46,40
1390,87,2,498,3,2721,29,30
1391,87,2,499,9,2730,89,90
1392,87,2,500,2,2732,19,20
1393,87,2,501,9,2741,84,90
1394,87,2,502,8,2749,83,80
1395,87,2,503,5,2754,51,50
1396,87,2,504,8,2762,85,80
1397,87,2,505,9,2771,83,90
1398,87,2,506,5,2776,53,50
1399,87,2,507,5,2781,45,50
1400,87,2,508,6,2787,55,60
1401,87,2,509,7,2794,65,70
1402,87,2,510,8,2802,64,80
1403,87,2,511,5,2807,48,50
1404,87,2,512,7,2814,68,70
1405,87,2,513,3,2817,19,30
1406,87,2,514,9,2826,0,90
1407,87,2,515,2,2828,97,20
1408,87,2,516,8,2836,0,80
1409,87,2,517,2,2838,96,20
1410,87,2,518,9,2847,81,90
1411,87,2,519,6,2853,67,60
1412,87,2,520,4,2857,0,40
1413,87,2,521,7,2864,117,70
1414,87,2,522,9,2873,0,90
1415,87,2,523,2,2875,123,20
1416,87,2,524,5,2880,46,50
1417,87,2,525,3,2883,0,30
1418,87,2,526,2,2885,52,20
1419,87,2,527,7,2892,72,70
1420,87,2,528,8,2900,0,80
1421,87,2,529,7,2907,145,70
1422,87,2,530,3,2910,0,30
1423,87,2,531,5,2915,77,50
1424,87,2,532,4,2919,0,40
1425,87,2,533,4,2923,81,40
1426,87,2,534,7,2930,70,70
1427,87,2,535,7,2937,63,70
1428,87,2,536,8,2945,103,80
1429,87,2,537,9,2954,0,90
1430,87,2,538,7,2961,155,70
1431,87,2,539,5,2966,0,50
1432,87,2,540,5,2971,94,50
1433,87,2,541,5,2976,60,50
1434,87,2,542,7,2983,69,70
1435,87,2,543,4,2987,30,40
1436,87,2,544,8,2995,97,80
1437,87,2,545,6,3001,0,60
1438,87,2,546,2,3003,65,20
1439,87,2,547,6,3009,51,60
1440,87,2,548,4,3013,38,40
1441,87,2,549,3,3016,30,30
1442,87,2,550,6,3022,0,60
1443,87,2,551,5,3027,107,50
1444,87,2,552,6,3033,0,60
1445,87,2,553,7,3040,112,70
1446,87,2,554,2,3042,17,20
1447,87,2,555,5,3047,49,50
1448,87,2,556,3,3050,33,30
1449,87,2,557,4,3054,0,40
1450,87,2,558,6,3060,94,60
1451,87,2,559,8,3068,87,80
1452,87,2,560,7,3075,60,70
1453,87,2,561,2,3077,18,20
1454,87,2,562,8,3085,0,80
1455,87,2,563,6,3091,144,60
1456,87,2,564,8,3099,73,80
1457,87,2,565,9,3108,0,90
1458,87,2,566,6,3114,145,60
1459,87,2,567,6,3120,75,60
1460,87,2,568,2,3122,0,20
1461,87,2,569,8,3130,98,80
1462,87,2,570,8,3138,69,80
1463,87,2,571,2,3140,0,20
1464,87,2,572,3,3143,51,30
1465,87,2,573,8,3151,77,80
1466,87,2,574,5,3156,39,50
1467,87,2,575,5,3161,0,50
1468,87,2,576,5,3166,0,50
1469,87,2,577,4,3170,139,40
1470,87,2,578,9,3179,0,90
1471,87,2,579,3,3182,123,30
1472,87,2,580,4,3186,0,40
1473,87,2,581,7,3193,100,70
1474,87,2,582,9,3202,0,90
1475,87,2,583,6,3208,146,60
1476,87,2,584,3,3211,30,30
1477,87,2,585,6,3217,71,60
1478,87,2,586,6,3223,65,60
1479,87,2,587,6,3229,58,60
1480,87,2,588,6,3235,61,60
1481,87,2,589,5,3240,54,50
1482,87,2,590,2,3242,12,20
1483,87,2,591,3,3245,34,30
1484,87,2,592,8,3253,85,80
1485,87,2,593,3,3256,37,30
1486,87,2,594,6,3262,57,60
1487,87,2,595,7,3269,57,70
1488,87,2,596,3,3272,35,30
1489,87,2,597,4,3276,42,40
1490,87,2,598,9,3285,88,90
1491,87,2,599,9,3294,82,90
1492,87,2,600,8,3302,0,80
1493,87,2,601,8,3310,147,80
1494,87,2,602,7,3317,69,70
1495,87,2,603,7,3324,62,70
1496,87,2,604,4,3328,30,40
1497,87,2,605,4,3332,0,40
1498,87,2,606,2,3334,57,20
1499,87,2,607,5,3339,41,50
1500,87,2,608,9,3348,96,90
1501,87,2,609,5,3353,54,50
1502,87,2,610,8,3361,97,80
1503,87,2,611,2,3363,20,20
1504,87,2,612,4,3367,0,40
1505,87,2,613,4,3371,85,40
1506,87,2,614,9,3380,76,90
1507,87,2,615,8,3388,89,80
1508,87,2,616,4,3392,0,40
1509,87,2,617,8,3400,0,80
1510,87,2,618,2,3402,158,20
1511,87,2,619,4,3406,38,40
1512,87,2,620,8,3414,86,80
1513,87,2,621,6,3420,62,60
1514,87,2,622,4,3424,45,40
1515,87,2,623,6,3430,0,60
1516,87,2,624,3,3433,88,30
1517,87,2,625,4,3437,37,40
1518,87,2,626,8,3445,89,80
1519,87,2,627,9,3454,81,90
1520,87,2,628,2,3456,22,20
1521,87,2,629,4,3460,40,40
1522,87,2,630,2,3462,26,20
1523,87,2,631,2,3464,20,20
1524,87,2,632,5,3469,35,50
1525,87,2,633,3,3472,0,30
1526,87,2,634,5,3477,84,50
1527,87,2,635,5,3482,0,50
1528,87,2,636,5,3487,99,50
1529,87,2,637,2,3489,0,20
1530,87,2,638,3,3492,0,30
1531,87,2,639,4,3496,73,40
1532,87,2,640,9,3505,90,90
1533,87,2,641,7,3512,86,70
1534,87,2,642,9,3521,96,90
1535,87,2,643,4,3525,43,40
1536,87,2,644,3,3528,0,30
1537,87,2,645,8,3536,104,80
1538,87,2,646,7,3543,65,70
1539,87,2,647,5,3548,0,50
1540,87,2,648,5,3553,95,50
1541,87,2,649,7,3560,66,70
1542,87,2,650,3,3563,31,30
1543,87,2,651,6,3569,49,60
1544,87,2,652,9,3578,73,90
1545,87,2,653,8,3586,89,80
1546,87,2,654,3,3589,31,30
1547,87,2,655,9,3598,0,90
1548,87,2,656,7,3605,155,70
1549,87,2,657,2,3607,25,20
1550,87,2,658,2,3609,22,20
1551,87,2,659,9,3618,95,90
1552,87,2,660,8,3626,66,80
1553,87,2,661,7,3633,78,70
1554,87,2,662,4,3637,44,40
1555,87,2,663,2,3639,0,20
1556,87,2,664,3,3642,0,30
1557,87,2,665,9,3651,136,90
1558,87,2,666,9,3660,86,90
1559,87,2,667,2,3662,24,20
1560,87,2,668,5,3667,0,50
1561,87,2,669,4,3671,0,40
1562,87,2,670,4,3675,0,40
1563,87,2,671,7,3682,207,70
1564,87,2,672,2,3684,21,20
1565,87,2,673,4,3688,41,40
1566,87,2,674,9,3697,94,90
1567,87,2,675,4,3701,0,40
1568,87,2,676,6,3707,88,60
1569,87,2,677,2,3709,17,20
1570,87,2,678,4,3713,44,40
1571,87,2,679,8,3721,0,80
1572,87,2,680,7,3728,158,70
1573,87,2,681,9,3737,87,90
1574,87,2,682,8,3745,82,80
1575,87,2,683,4,3749,48,40
1576,87,2,684,8,3757,74,80
1577,87,2,685,4,3761,46,40
1578,87,2,686,3,3764,0,30
1579,87,2,687,9,3773,119,90
1580,87,2,688,3,3776,29,30
1581,87,2,689,4,3780,31,40
1582,87,2,690,6,3786,0,60
1583,87,2,691,3,3789,89,30
1584,87,2,692,2,3791,22,20
1585,87,2,693,3,3794,27,30
1586,87,2,694,8,3802,98,80
1587,87,2,695,4,3806,0,40
1588,87,2,696,7,3813,97,70
1589,87,2,697,2,3815,21,20
1590,87,2,698,8,3823,76,80
1591,87,2,699,9,3832,88,90
1592,87,2,700,2,3834,21,20
1593,87,2,701,5,3839,47,50
1594,87,2,702,2,3841,0,20
1595,87,2,703,6,3847,83,60
1596,87,2,704,8,3855,75,80
1597,87,2,705,2,3857,15,20
1598,87,2,706,2,3859,21,20
1599,87,2,707,7,3866,66,70
1600,87,2,708,7,3873,59,70
1601,87,2,709,4,3877,35,40
1602,87,2,710,5,3882,48,50
1603,87,2,711,4,3886,52,40
1604,87,2,712,7,3893,69,70
1605,87,2,713,3,3896,38,30
1606,87,2,714,7,3903,70,70
1607,87,2,715,8,3911,75,80
1608,87,2,716,6,3917,74,60
1609,87,2,717,2,3919,21,20
1610,87,2,718,9,3928,98,90
1611,87,2,719,3,3931,0,30
1612,87,2,720,9,3940,124,90
1613,87,2,721,9,3949,95,90
1614,87,2,722,3,3952,28,30
1615,87,2,723,8,3960,68,80
1616,87,2,724,6,3966,0,60
1617,87,2,725,6,3972,114,60
1618,87,2,726,5,3977,56,50
1619,87,2,727,6,3983,0,60
1620,87,2,728,8,3991,142,80
1621,87,2,729,8,3999,82,80
1622,87,2,730,7,4006,0,70
1623,87,2,731,3,4009,97,30
1624,87,2,732,4,4013,48,40
1625,87,2,733,5,4018,47,50
1626,87,2,734,7,4025,73,70
1627,87,2,735,8,4033,75,80
1628,87,2,736,6,4039,58,60
1629,87,2,737,7,4046,72,70
1630,87,2,738,2,4048,0,20
1631,87,2,739,5,4053,53,50
1632,87,2,740,8,4061,70,80
1633,87,2,741,7,4068,61,70
1634,87,2,742,4,4072,40,40
1635,87,2,743,9,4081,99,90
1636,87,2,744,2,4083,24,20
1637,87,2,745,3,4086,27,30
1638,87,2,746,7,4093,62,70
1639,87,2,747,5,4098,47,50
1640,87,2,748,3,4101,25,30
1641,87,2,749,8,4109,0,80
1642,87,2,750,3,4112,0,30
1643,87,2,751,5,4117,145,50
1644,87,2,752,9,4126,100,90
1645,87,2,753,5,4131,58,50
1646,87,2,754,3,4134,37,30
1647,87,2,755,7,4141,54,70
1648,87,2,756,7,4148,75,70
1649,87,2,757,3,4151,30,30
1650,87,2,758,6,4157,63,60
1651,87,2,759,6,4163,62,60
1652,87,2,760,7,4170,0,70
1653,87,2,761,2,4172,88,20
1654,87,2,762,6,4178,0,60
1655,87,2,763,2,4180,85,20
1656,87,2,764,2,4182,32,20
1657,87,2,765,6,4188,52,60
1658,87,2,766,2,4190,25,20
1659,87,2,767,5,4195,43,50
1660,87,2,768,7,4202,76,70
1661,87,2,769,4,4206,30,40
1662,87,2,770,4,4210,43,40
1663,87,2,771,7,4217,72,70
1664,87,2,772,7,4224,71,70
1665,87,2,773,6,4230,0,60
1666,87,2,774,4,4234,106,40
1667,87,2,775,3,4237,0,30
1668,87,2,776,2,4239,57,20
1669,87,2,777,3,4242,0,30
1670,87,2,778,8,4250,106,80
1671,87,2,779,4,4254,42,40
1672,87,2,780,6,4260,63,60
1673,87,2,781,8,4268,0,80
1674,87,2,782,9,4277,148,90
1675,87,2,783,6,4283,49,60
1676,87,2,784,6,4289,59,60
1677,87,2,785,7,4296,58,70
1678,87,2,786,6,4302,61,60
1679,87,2,787,4,4306,41,40
1680,87,2,788,2,4308,0,20
1681,87,2,789,8,4316,89,80
1682,87,2,790,5,4321,0,50
1683,87,2,791,3,4324,79,30
1684,87,2,792,2,4326,12,20
1685,87,2,793,3,4329,24,30
1686,87,2,794,2,4331,0,20
1687,87,2,795,6,4337,86,60
1688,87,2,796,7,4344,68,70
1689,87,2,797,9,4353,0,90
1690,87,2,798,2,4355,97,20
1691,87,2,799,7,4362,0,70
1692,87,2,800,9,4371,0,90
1693,87,2,801,3,4374,181,30
1694,87,2,802,4,4378,0,40
1695,87,2,803,6,4384,115,60
1696,87,2,804,8,4392,84,80
1697,87,2,805,5,4397,51,50
1698,87,2,806,4,4401,25,40
1699,87,2,807,2,4403,0,20
1700,87,2,808,8,4411,103,80
1701,87,2,809,7,4418,62,70
1702,87,2,810,8,4426,75,80
1703,87,2,811,7,4433,77,70
1704,87,2,812,3,4436,28,30
1705,87,2,813,4,4440,45,40
1706,87,2,814,5,4445,40,50
1707,87,2,815,3,4448,0,30
1708,87,2,816,4,4452,81,40
1709,87,2,817,5,4457,46,50
1710,87,2,818,6,4463,62,60
1711,87,2,819,9,4472,86,90
1712,87,2,820,9,4481,89,90
1713,87,2,821,7,4488,72,70
1714,87,2,822,2,4490,23,20
1715,87,2,823,6,4496,61,60
1716,87,2,824,4,4500,0,40
1717,87,2,825,7,4507,94,70
1718,87,2,826,8,4515,0,80
1719,87,2,827,5,4520,130,50
1720,87,2,828,6,4526,66,60
1721,87,2,829,6,4532,64,60
1722,87,2,830,8,4540,87,80
1723,87,2,831,6,4546,56,60
1724,87,2,832,9,4555,85,90
1725,87,2,833,4,4559,38,40
1726,87,2,834,9,4568,0,90
1727,87,2,835,8,4576,173,80
1728,87,2,836,3,4579,26,30
1729,87,2,837,8,4587,92,80
1730,87,2,838,9,4596,84,90
1731,87,2,839,6,4602,66,60
1732,87,2,840,7,4609,63,70
1733,87,2,841,4,4613,0,40
1734,87,2,842,3,4616,0,30
1735,87,2,843,8,4624,171,80
1736,87,2,844,2,4626,18,20
1737,87,2,845,3,4629,28,30
1738,87,2,846,4,4633,38,40
1739,87,2,847,3,4636,0,30
1740,87,2,848,7,4643,97,70
1741,87,2,849,8,4651,81,80
1742,87,2,850,4,4655,22,40
1743,87,2,851,3,4658,0,30
1744,87,2,852,2,4660,55,20
1745,87,2,853,8,4668,0,80
1746,87,2,854,5,4673,136,50
1747,87,2,855,2,4675,17,20
1748,87,2,856,8,4683,71,80
1749,87,2,857,8,4691,82,80
1750,87,2,858,3,4694,41,30
1751,87,2,859,3,4697,28,30
1752,87,2,860,9,4706,89,90
1753,87,2,861,7,4713,64,70
1754,87,2,862,9,4722,118,90
1755,87,2,863,3,4725,26,30
1756,87,2,864,9,4734,0,90
1757,87,2,865,9,4743,159,90
1758,87,2,866,6,4749,45,60
1759,87,2,867,4,4753,42,40
1760,87,2,868,3,4756,28,30
1761,87,2,869,9,4765,77,90
1762,87,2,870,3,4768,39,30
1763,87,2,871,4,4772,27,40
1764,87,2,872,2,4774,15,20
1765,87,2,873,9,4783,77,90
1766,87,2,874,9,4792,77,90
1767,87,2,875,3,4795,27,30
1768,87,2,876,3,4798,30,30
1769,87,2,877,8,4806,0,80
1770,87,2,878,2,4808,101,20
1771,87,2,879,7,4815,79,70
1772,87,2,880,2,4817,18,20
1773,87,2,881,4,4821,0,40
1774,87,2,882,4,4825,0,40
1775,87,2,883,6,4831,148,60
1776,87,2,884,9,4840,95,90
1777,87,2,885,8,4848,0,80
1778,87,2,886,4,4852,133,40
1779,87,2,887,4,4856,0,40
1780,87,2,888,7,4863,116,70
1781,87,2,889,8,4871,86,80
1782,87,2,890,2,4873,17,20
1783,87,2,891,6,4879,69,60
1784,87,2,892,4,4883,42,40
1785,87,2,893,5,4888,0,50
1786,87,2,894,7,4895,120,70
1787,87,2,895,2,4897,0,20
1788,87,2,896,3,4900,53,30
1789,87,2,897,7,4907,74,70
1790,87,2,898,9,4916,73,90
1791,87,2,899,8,4924,73,80
1792,87,2,900,9,4933,0,90
1793,87,2,901,5,4938,155,50
1794,87,2,902,4,4942,44,40
1795,87,2,903,8,4950,78,80
1796,87,2,904,2,4952,0,20
1797,87,2,905,5,4957,67,50
1798,87,2,906,5,4962,57,50
1799,87,2,907,8,4970,0,80
1800,87,2,908,5,4975,130,50
1801,87,2,909,7,4982,74,70
1802,87,2,910,5,4987,56,50
1803,87,2,911,4,4991,40,40
1804,87,2,912,4,4995,0,40
1805,87,3,1,2,2,14,20
1806,87,3,2,5,7,50,50
1807,87,3,3,2,9,23,20
1808,87,3,4,2,11,25,20
1809,87,3,5,7,18,73,70
1810,87,3,6,3,21,32,30
1811,87,3,7,3,24,33,30
1812,87,3,8,3,27,39,30
1813,87,3,9,8,35,61,80
1814,87,3,10,8,43,73,80
1815,87,3,11,4,47,0,40
1816,87,3,12,5,52,105,50
1817,87,3,13,3,55,25,30
1818,87,3,14,5,60,69,50
1819,87,3,15,4,64,45,40
1820,87,3,16,6,70,0,60
1821,87,3,17,5,75,97,50
1822,87,3,18,9,84,0,90
1823,87,3,19,5,89,158,50
1824,87,3,20,7,96,0,70
1825,87,3,21,2,98,0,20
1826,87,3,22,3,101,0,30
1827,87,3,23,6,107,187,60
1828,87,3,24,9,116,0,90
1829,87,3,25,4,120,132,40
1830,87,3,26,9,129,103,90
1831,87,3,27,2,131,31,20
1832,87,3,28,7,138,61,70
1833,87,3,29,8,146,0,80
1834,87,3,30,9,155,164,90
1835,87,3,31,8,163,75,80
1836,87,3,32,7,170,71,70
1837,87,3,33,2,172,0,20
1838,87,3,34,2,174,46,20
1839,87,3,35,2,176,16,20
1840,87,3,36,2,178,28,20
1841,87,3,37,9,187,0,90
1842,87,3,38,4,191,114,40
1843,87,3,39,6,197,46,60
1844,87,3,40,6,203,0,60
1845,87,3,41,3,206,81,30
1846,87,3,42,9,215,90,90
1847,87,3,43,3,218,26,30
1848,87,3,44,8,226,0,80
1849,87,3,45,7,233,149,70
1850,87,3,46,2,235,0,20
1851,87,3,47,2,237,0,20
1852,87,3,48,6,243,0,60
1853,87,3,49,5,248,0,50
1854,87,3,50,2,250,153,20
1855,87,3,51,8,258,0,80
1856,87,3,52,4,262,144,40
1857,87,3,53,6,268,0,60
1858,87,3,54,6,274,133,60
1859,87,3,55,6,280,54,60
1860,87,3,56,9,289,94,90
1861,87,3,57,5,294,50,50
1862,87,3,58,6,300,64,60
1863,87,3,59,9,309,0,90
1864,87,3,60,6,315,0,60
1865,87,3,61,6,321,0,60
1866,87,3,62,3,324,216,30
1867,87,3,63,4,328,43,40
1868,87,3,64,5,333,45,50
1869,87,3,65,3,336,23,30
1870,87,3,66,8,344,0,80
1871,87,3,67,8,352,177,80
1872,87,3,68,2,354,0,20
1873,87,3,69,7,361,92,70
1874,87,3,70,3,364,35,30
1875,87,3,71,3,367,21,30
1876,87,3,72,7,374,86,70
1877,87,3,73,4,378,42,40
1878,87,3,74,7,385,77,70
1879,87,3,75,4,389,30,40
1880,87,3,76,6,395,75,60
1881,87,3,77,7,402,84,70
1882,87,3,78,4,406,0,40
1883,87,3,79,6,412,0,60
1884,87,3,80,8,420,202,80
1885,87,3,81,3,423,0,30
1886,87,3,82,3,426,0,30
1887,87,3,83,7,433,136,70
1888,87,3,84,3,436,34,30
1889,87,3,85,5,441,61,50
1890,87,3,86,5,446,49,50
1891,87,3,87,4,450,47,40
1892,87,3,88,2,452,20,20
1893,87,3,89,7,459,0,70
1894,87,3,90,5,464,119,50
1895,87,3,91,4,468,39,40
1896,87,3,92,2,470,21,20
1897,87,3,93,5,475,43,50
1898,87,3,94,2,477,17,20
1899,87,3,95,9,486,93,90
1900,87,3,96,7,493,68,70
1901,87,3,97,6,499,63,60
1902,87,3,98,2,501,0,20
1903,87,3,99,2,503,33,20
1904,87,3,100,3,506,32,30
1905,87,3,101,3,509,29,30
1906,87,3,102,3,512,0,30
1907,87,3,103,7,519,105,70
1908,87,3,104,6,525,56,60
1909,87,3,105,5,530,53,50
1910,87,3,106,6,536,77,60
1911,87,3,107,9,545,0,90
1912,87,3,108,4,549,127,40
1913,87,3,109,9,558,84,90
1914,87,3,110,5,563,57,50
1915,87,3,111,4,567,0,40
1916,87,3,112,7,574,114,70
1917,87,3,113,9,583,105,90
1918,87,3,114,6,589,64,60
1919,87,3,115,2,591,28,20
1920,87,3,116,4,595,46,40
1921,87,3,117,3,598,0,30
1922,87,3,118,2,600,49,20
1923,87,3,119,4,604,52,40
1924,87,3,120,3,607,28,30
1925,87,3,121,5,612,0,50
1926,87,3,122,9,621,133,90
1927,87,3,123,8,629,73,80
1928,87,3,124,9,638,68,90
1929,87,3,125,4,642,45,40
1930,87,3,126,6,648,61,60
1931,87,3,127,8,656,74,80
1932,87,3,128,5,661,50,50
1933,87,3,129,4,665,0,40
1934,87,3,130,4,669,78,40
1935,87,3,131,4,673,0,40
1936,87,3,132,6,679,95,60
1937,87,3,133,3,682,0,30
1938,87,3,134,3,685,0,30
1939,87,3,135,2,687,0,20
1940,87,3,136,7,694,0,70
1941,87,3,137,7,701,210,70
1942,87,3,138,6,707,54,60
1943,87,3,139,8,715,86,80
1944,87,3,140,8,723,69,80
1945,87,3,141,3,726,34,30
1946,87,3,142,4,730,28,40
1947,87,3,143,4,734,0,40
1948,87,3,144,2,736,0,20
1949,87,3,145,9,745,0,90
1950,87,3,146,4,749,171,40
1951,87,3,147,9,758,0,90
1952,87,3,148,8,766,146,80
1953,87,3,149,7,773,75,70
1954,87,3,150,2,775,33,20
1955,87,3,151,2,777,25,20
1956,87,3,152,3,780,34,30
1957,87,3,153,7,787,60,70
1958,87,3,154,5,792,39,50
1959,87,3,155,2,794,20,20
1960,87,3,156,6,800,0,60
1961,87,3,157,6,806,0,60
1962,87,3,158,6,812,153,60
1963,87,3,159,6,818,0,60
1964,87,3,160,7,825,0,70
1965,87,3,161,9,834,204,90
1966,87,3,162,8,842,0,80
1967,87,3,163,2,844,98,20
1968,87,3,164,6,850,59,60
1969,87,3,165,9,859,0,90
1970,87,3,166,9,868,174,90
1971,87,3,167,5,873,53,50
1972,87,3,168,6,879,57,60
1973,87,3,169,5,884,45,50
1974,87,3,170,6,890,65,60
1975,87,3,171,6,896,0,60
1976,87,3,172,6,902,0,60
1977,87,3,173,9,911,0,90
1978,87,3,174,3,914,244,30
1979,87,3,175,7,921,0,70
1980,87,3,176,2,923,87,20
1981,87,3,177,4,927,32,40
1982,87,3,178,4,931,34,40
1983,87,3,179,2,933,0,20
1984,87,3,180,9,942,0,90
1985,87,3,181,7,949,189,70
1986,87,3,182,8,957,0,80
1987,87,3,183,9,966,184,90
1988,87,3,184,3,969,32,30
1989,87,3,185,4,973,38,40
1990,87,3,186,4,977,44,40
1991,87,3,187,6,983,0,60
1992,87,3,188,7,990,145,70
1993,87,3,189,9,999,76,90
1994,87,3,190,6,1005,0,60
1995,87,3,191,7,1012,142,70
1996,87,3,192,5,1017,50,50
1997,87,3,193,2,1019,21,20
1998,87,3,194,4,1023,44,40
1999,87,3,195,5,1028,48,50
2000,87,3,196,6,1034,53,60
2001,87,3,197,2,1036,0,20
2002,87,3,198,3,1039,44,30
2003,87,3,199,3,1042,30,30
2004,87,3,200,5,1047,0,50
2005,87,3,201,7,1054,141,70
2006,87,3,202,9,1063,84,90
2007,87,3,203,3,1066,0,30
2008,87,3,204,3,1069,58,30
2009,87,3,205,9,1078,89,90
2010,87,3,206,5,1083,67,50
2011,87,3,207,8,1091,77,80
2012,87,3,208,8,1099,0,80
2013,87,3,209,9,1108,165,90
2014,87,3,210,8,1116,72,80
2015,87,3,211,2,1118,0,20
2016,87,3,212,5,1123,72,50
2017,87,3,213,2,1125,0,20
2018,87,3,214,6,1131,72,60
2019,87,3,215,5,1136,0,50
2020,87,3,216,7,1143,0,70
2021,87,3,217,8,1151,195,80
2022,87,3,218,9,1160,80,90
2023,87,3,219,9,1169,0,90
2024,87,3,220,5,1174,125,50
2025,87,3,221,7,1181,66,70
2026,87,3,222,7,1188,72,70
2027,87,3,223,7,1195,73,70
2028,87,3,224,7,1202,84,70
2029,87,3,225,3,1205,27,30
2030,87,3,226,7,1212,72,70
2031,87,3,227,2,1214,0,20
2032,87,3,228,5,1219,0,50
2033,87,3,229,8,1227,0,80
2034,87,3,230,8,1235,212,80
2035,87,3,231,7,1242,60,70
2036,87,3,232,5,1247,0,50
2037,87,3,233,3,1250,0,30
2038,87,3,234,7,1257,0,70
2039,87,3,235,6,1263,0,60
2040,87,3,236,6,1269,249,60
2041,87,3,237,4,1273,0,40
2042,87,3,238,6,1279,103,60
2043,87,3,239,9,1288,93,90
2044,87,3,240,5,1293,52,50
2045,87,3,241,3,1296,24,30
2046,87,3,242,4,1300,36,40
2047,87,3,243,4,1304,32,40
2048,87,3,244,3,1307,37,30
2049,87,3,245,6,1313,59,60
2050,87,3,246,7,1320,0,70
2051,87,3,247,6,1326,0,60
2052,87,3,248,5,1331,0,50
2053,87,3,249,2,1333,198,20
2054,87,3,250,5,1338,54,50
2055,87,3,251,2,1340,19,20
2056,87,3,252,6,1346,54,60
2057,87,3,253,7,1353,0,70
2058,87,3,254,9,1362,172,90
2059,87,3,255,8,1370,62,80
2060,87,3,256,4,1374,42,40
2061,87,3,257,9,1383,94,90
2062,87,3,258,6,1389,0,60
2063,87,3,259,9,1398,156,90
2064,87,3,260,6,1404,63,60
2065,87,3,261,4,1408,44,40
2066,87,3,262,7,1415,0,70
2067,87,3,263,6,1421,136,60
2068,87,3,264,5,1426,40,50
2069,87,3,265,6,1432,62,60
2070,87,3,266,3,1435,32,30
2071,87,3,267,8,1443,87,80
2072,87,3,268,4,1447,55,40
2073,87,3,269,6,1453,59,60
2074,87,3,270,4,1457,38,40
2075,87,3,271,5,1462,0,50
2076,87,3,272,8,1470,0,80
2077,87,3,273,9,1479,221,90
2078,87,3,274,7,1486,71,70
2079,87,3,275,7,1493,63,70
2080,87,3,276,9,1502,97,90
2081,87,3,277,3,1505,33,30
2082,87,3,278,9,1514,83,90
2083,87,3,279,2,1516,23,20
2084,87,3,280,5,1521,53,50
2085,87,3,281,5,1526,61,50
2086,87,3,282,4,1530,43,40
2087,87,3,283,3,1533,21,30
2088,87,3,284,9,1542,98,90
2089,87,3,285,7,1549,86,70
2090,87,3,286,7,1556,70,70
2091,87,3,287,7,1563,73,70
2092,87,3,288,6,1569,58,60
2093,87,3,289,2,1571,0,20
2094,87,3,290,4,1575,56,40
2095,87,3,291,7,1582,74,70
2096,87,3,292,4,1586,42,40
2097,87,3,293,2,1588,22,20
2098,87,3,294,9,1597,95,90
2099,87,3,295,8,1605,82,80
2100,87,3,296,8,1613,0,80
2101,87,3,297,9,1622,0,90
2102,87,3,298,4,1626,222,40
2103,87,3,299,9,1635,0,90
2104,87,3,300,5,1640,132,50
2105,87,3,301,4,1644,0,40
2106,87,3,302,8,1652,138,80
2107,87,3,303,5,1657,50,50
2108,87,3,304,6,1663,60,60
2109,87,3,305,2,1665,28,20
2110,87,3,306,3,1668,0,30
2111,87,3,307,6,1674,89,60
2112,87,3,308,7,1681,0,70
2113,87,3,309,5,1686,124,50
2114,87,3,310,3,1689,28,30
2115,87,3,311,6,1695,64,60
2116,87,3,312,6,1701,55,60
2117,87,3,313,2,1703,22,20
2118,87,3,314,5,1708,45,50
2119,87,3,315,8,1716,66,80
2120,87,3,316,5,1721,49,50
2121,87,3,317,7,1728,69,70
2122,87,3,318,8,1736,81,80
2123,87,3,319,4,1740,0,40
2124,87,3,320,5,1745,0,50
2125,87,3,321,2,1747,0,20
2126,87,3,322,9,1756,201,90
2127,87,3,323,6,1762,69,60
2128,87,3,324,4,1766,37,40
2129,87,3,325,8,1774,0,80
2130,87,3,326,7,1781,164,70
2131,87,3,327,2,1783,19,20
2132,87,3,328,7,1790,70,70
2133,87,3,329,7,1797,72,70
2134,87,3,330,2,1799,0,20
2135,87,3,331,6,1805,83,60
2136,87,3,332,9,1814,95,90
2137,87,3,333,9,1823,87,90
2138,87,3,334,5,1828,58,50
2139,87,3,335,8,1836,87,80
2140,87,3,336,2,1838,29,20
2141,87,3,337,5,1843,43,50
2142,87,3,338,7,1850,75,70
2143,87,3,339,3,1853,31,30
2144,87,3,340,5,1858,44,50
2145,87,3,341,3,1861,23,30
2146,87,3,342,3,1864,0,30
2147,87,3,343,5,1869,64,50
2148,87,3,344,9,1878,91,90
2149,87,3,345,4,1882,34,40
2150,87,3,346,2,1884,0,20
2151,87,3,347,9,1893,98,90
2152,87,3,348,5,1898,52,50
2153,87,3,349,8,1906,0,80
2154,87,3,350,9,1915,162,90
2155,87,3,351,7,1922,66,70
2156,87,3,352,4,1926,34,40
2157,87,3,353,4,1930,30,40
2158,87,3,354,7,1937,77,70
2159,87,3,355,9,1946,118,90
2160,87,3,356,7,1953,73,70
2161,87,3,357,4,1957,40,40
2162,87,3,358,6,1963,61,60
2163,87,3,359,3,1966,33,30
2164,87,3,360,2,1968,15,20
2165,87,3,361,9,1977,100,90
2166,87,3,362,6,1983,53,60
2167,87,3,363,4,1987,0,40
2168,87,3,364,8,1995,129,80
2169,87,3,365,3,1998,26,30
2170,87,3,366,4,2002,46,40
2171,87,3,367,9,2011,0,90
2172,87,3,368,2,2013,0,20
2173,87,3,369,3,2016,0,30
2174,87,3,370,9,2025,211,90
2175,87,3,371,3,2028,0,30
2176,87,3,372,8,2036,106,80
2177,87,3,373,2,2038,24,20
2178,87,3,374,8,2046,0,80
2179,87,3,375,2,2048,99,20
2180,87,3,376,6,2054,77,60
2181,87,3,377,2,2056,26,20
2182,87,3,378,6,2062,61,60
2183,87,3,379,6,2068,59,60
2184,87,3,380,3,2071,32,30
2185,87,3,381,9,2080,90,90
2186,87,3,382,6,2086,0,60
2187,87,3,383,4,2090,0,40
2188,87,3,384,6,2096,162,60
2189,87,3,385,8,2104,85,80
2190,87,3,386,5,2109,39,50
2191,87,3,387,2,2111,21,20
2192,87,3,388,6,2117,59,60
2193,87,3,389,8,2125,0,80
2194,87,3,390,5,2130,123,50
2195,87,3,391,7,2137,83,70
2196,87,3,392,5,2142,54,50
2197,87,3,393,8,2150,81,80
2198,87,3,394,9,2159,98,90
2199,87,3,395,7,2166,85,70
2200,87,3,396,7,2173,0,70
2201,87,3,397,7,2180,0,70
2202,87,3,398,6,2186,221,60
2203,87,3,399,3,2189,27,30
2204,87,3,400,6,2195,58,60
2205,87,3,401,4,2199,0,40
2206,87,3,402,8,2207,124,80
2207,87,3,403,5,2212,45,50
2208,87,3,404,4,2216,40,40
2209,87,3,405,3,2219,30,30
2210,87,3,406,7,2226,67,70
2211,87,3,407,3,2229,0,30
2212,87,3,408,6,2235,89,60
2213,87,3,409,9,2244,85,90
2214,87,3,410,9,2253,99,90
2215,87,3,411,3,2256,41,30
2216,87,3,412,7,2263,82,70
2217,87,3,413,4,2267,0,40
2218,87,3,414,4,2271,75,40
2219,87,3,415,3,2274,39,30
2220,87,3,416,7,2281,82,70
2221,87,3,417,5,2286,0,50
2222,87,3,418,5,2291,101,50
2223,87,3,419,3,2294,34,30
2224,87,3,420,4,2298,39,40
2225,87,3,421,9,2307,96,90
2226,87,3,422,3,2310,40,30
2227,87,3,423,7,2317,75,70
2228,87,3,424,3,2320,29,30
2229,87,3,425,5,2325,69,50
2230,87,3,426,3,2328,26,30
2231,87,3,427,8,2336,77,80
2232,87,3,428,9,2345,80,90
2233,87,3,429,7,2352,63,70
2234,87,3,430,2,2354,14,20
2235,87,3,431,3,2357,36,30
2236,87,3,432,9,2366,103,90
2237,87,3,433,5,2371,50,50
2238,87,3,434,4,2375,37,40
2239,87,3,435,8,2383,81,80
2240,87,3,436,8,2391,97,80
2241,87,3,437,9,2400,90,90
2242,87,3,438,3,2403,27,30
2243,87,3,439,5,2408,54,50
2244,87,3,440,9,2417,0,90
2245,87,3,441,2,2419,94,20
2246,87,3,442,9,2428,86,90
2247,87,3,443,6,2434,53,60
2248,87,3,444,8,2442,62,80
2249,87,3,445,2,2444,18,20
2250,87,3,446,5,2449,37,50
2251,87,3,447,9,2458,82,90
2252,87,3,448,2,2460,20,20
2253,87,3,449,6,2466,55,60
2254,87,3,450,9,2475,86,90
2255,87,3,451,8,2483,74,80
2256,87,3,452,3,2486,19,30
2257,87,3,453,5,2491,52,50
2258,87,3,454,4,2495,41,40
2259,87,3,455,5,2500,53,50
2260,87,3,456,2,2502,0,20
2261,87,3,457,8,2510,108,80
2262,87,3,458,4,2514,0,40
2263,87,3,459,3,2517,74,30
2264,87,3,460,5,2522,0,50
2265,87,3,461,7,2529,119,70
2266,87,3,462,9,2538,104,90
2267,87,3,463,4,2542,36,40
2268,87,3,464,5,2547,0,50
2269,87,3,465,6,2553,98,60
2270,87,3,466,7,2560,0,70
2271,87,3,467,6,2566,124,60
2272,87,3,468,4,2570,27,40
2273,87,3,469,8,2578,79,80
2274,87,3,470,9,2587,79,90
2275,87,3,471,4,2591,44,40
2276,87,3,472,2,2593,19,20
2277,87,3,473,6,2599,65,60
2278,87,3,474,5,2604,53,50
2279,87,3,475,7,2611,67,70
2280,87,3,476,4,2615,51,40
2281,87,3,477,2,2617,0,20
2282,87,3,478,3,2620,57,30
2283,87,3,479,8,2628,0,80
2284,87,3,480,8,2636,168,80
2285,87,3,481,5,2641,64,50
2286,87,3,482,6,2647,61,60
2287,87,3,483,4,2651,0,40
2288,87,3,484,5,2656,88,50
2289,87,3,485,7,2663,67,70
2290,87,3,486,6,2669,62,60
2291,87,3,487,6,2675,62,60
2292,87,3,488,4,2679,39,40
2293,87,3,489,6,2685,68,60
2294,87,3,490,2,2687,19,20
2295,87,3,491,5,2692,47,50
2296,87,3,492,8,2700,81,80
2297,87,3,493,9,2709,96,90
2298,87,3,494,8,2717,78,80
2299,87,3,495,7,2724,69,70
2300,87,3,496,7,2731,60,70
2301,87,3,497,2,2733,24,20
2302,87,3,498,3,2736,24,30
2303,87,3,499,9,2745,85,90
2304,87,3,500,9,2754,0,90
2305,87,3,501,6,2760,151,60
2306,87,3,502,7,2767,73,70
2307,87,3,503,9,2776,0,90
2308,87,3,504,2,2778,0,20
2309,87,3,505,6,2784,173,60
2310,87,3,506,9,2793,92,90
2311,87,3,507,3,2796,18,30
2312,87,3,508,6,2802,0,60
2313,87,3,509,8,2810,0,80
2314,87,3,510,3,2813,182,30
2315,87,3,511,8,2821,85,80
2316,87,3,512,9,2830,80,90
2317,87,3,513,2,2832,12,20
2318,87,3,514,7,2839,0,70
2319,87,3,515,3,2842,0,30
2320,87,3,516,6,2848,164,60
2321,87,3,517,8,2856,89,80
2322,87,3,518,6,2862,64,60
2323,87,3,519,2,2864,22,20
2324,87,3,520,2,2866,13,20
2325,87,3,521,2,2868,10,20
2326,87,3,522,9,2877,79,90
2327,87,3,523,8,2885,80,80
2328,87,3,524,5,2890,48,50
2329,87,3,525,8,2898,77,80
2330,87,3,526,3,2901,33,30
2331,87,3,527,4,2905,43,40
2332,87,3,528,4,2909,40,40
2333,87,3,529,8,2917,91,80
2334,87,3,530,3,2920,39,30
2335,87,3,531,5,2925,0,50
2336,87,3,532,5,2930,102,50
2337,87,3,533,7,2937,57,70
2338,87,3,534,3,2940,30,30
2339,87,3,535,5,2945,40,50
2340,87,3,536,3,2948,33,30
2341,87,3,537,3,2951,27,30
2342,87,3,538,7,2958,0,70
2343,87,3,539,8,2966,0,80
2344,87,3,540,3,2969,173,30
2345,87,3,541,4,2973,43,40
2346,87,3,542,3,2976,32,30
2347,87,3,543,6,2982,49,60
2348,87,3,544,6,2988,56,60
2349,87,3,545,4,2992,0,40
2350,87,3,546,8,3000,0,80
2351,87,3,547,9,3009,212,90
2352,87,3,548,9,3018,88,90
2353,87,3,549,5,3023,56,50
2354,87,3,550,3,3026,21,30
2355,87,3,551,4,3030,39,40
2356,87,3,552,9,3039,80,90
2357,87,3,553,7,3046,60,70
2358,87,3,554,3,3049,39,30
2359,87,3,555,4,3053,35,40
2360,87,3,556,2,3055,18,20
2361,87,3,557,4,3059,37,40
2362,87,3,558,2,3061,0,20
2363,87,3,559,4,3065,66,40
2364,87,3,560,2,3067,19,20
2365,87,3,561,5,3072,0,50
2366,87,3,562,4,3076,90,40
2367,87,3,563,8,3084,104,80
2368,87,3,564,8,3092,77,80
2369,87,3,565,8,3100,90,80
2370,87,3,566,6,3106,45,60
2371,87,3,567,5,3111,0,50
2372,87,3,568,7,3118,119,70
2373,87,3,569,7,3125,0,70
2374,87,3,570,7,3132,0,70
2375,87,3,571,9,3141,236,90
2376,87,3,572,7,3148,56,70
2377,87,3,573,5,3153,50,50
2378,87,3,574,8,3161,76,80
2379,87,3,575,2,3163,22,20
2380,87,3,576,4,3167,0,40
2381,87,3,577,3,3170,78,30
2382,87,3,578,7,3177,60,70
2383,87,3,579,5,3182,44,50
2384,87,3,580,2,3184,22,20
2385,87,3,581,4,3188,30,40
2386,87,3,582,6,3194,51,60
2387,87,3,583,4,3198,41,40
2388,87,3,584,8,3206,65,80
2389,87,3,585,9,3215,0,90
2390,87,3,586,3,3218,0,30
2391,87,3,587,5,3223,158,50
2392,87,3,588,7,3230,65,70
2393,87,3,589,8,3238,0,80
2394,87,3,590,7,3245,150,70
2395,87,3,591,5,3250,50,50
2396,87,3,592,9,3259,92,90
2397,87,3,593,3,3262,0,30
2398,87,3,594,4,3266,62,40
2399,87,3,595,8,3274,0,80
2400,87,3,596,5,3279,124,50
2401,87,3,597,2,3281,20,20
2402,87,3,598,5,3286,47,50
2403,87,3,599,6,3292,0,60
2404,87,3,600,2,3294,79,20
2405,87,3,601,8,3302,86,80
2406,87,3,602,6,3308,0,60
2407,87,3,603,7,3315,137,70
2408,87,3,604,2,3317,16,20
2409,87,3,605,2,3319,24,20
2410,87,3,606,9,3328,98,90
2411,87,3,607,9,3337,105,90
2412,87,3,608,6,3343,61,60
2413,87,3,609,5,3348,42,50
2414,87,3,610,9,3357,0,90
2415,87,3,611,5,3362,138,50
2416,87,3,612,7,3369,63,70
2417,87,3,613,7,3376,0,70
2418,87,3,614,2,3378,96,20
2419,87,3,615,3,3381,0,30
2420,87,3,616,2,3383,0,20
2421,87,3,617,3,3386,81,30
2422,87,3,618,8,3394,83,80
2423,87,3,619,4,3398,49,40
2424,87,3,620,2,3400,13,20
2425,87,3,621,9,3409,78,90
2426,87,3,622,6,3415,0,60
2427,87,3,623,2,3417,63,20
2428,87,3,624,2,3419,11,20
2429,87,3,625,4,3423,0,40
2430,87,3,626,2,3425,64,20
2431,87,3,627,9,3434,87,90
2432,87,3,628,8,3442,0,80
2433,87,3,629,7,3449,155,70
2434,87,3,630,2,3451,0,20
2435,87,3,631,5,3456,68,50
2436,87,3,632,4,3460,42,40
2437,87,3,633,5,3465,52,50
2438,87,3,634,2,3467,26,20
2439,87,3,635,6,3473,0,60
2440,87,3,636,2,3475,0,20
2441,87,3,637,8,3483,166,80
2442,87,3,638,3,3486,17,30
2443,87,3,639,7,3493,65,70
2444,87,3,640,6,3499,69,60
2445,87,3,641,6,3505,0,60
2446,87,3,642,2,3507,89,20
2447,87,3,643,3,3510,25,30
2448,87,3,644,4,3514,43,40
2449,87,3,645,9,3523,0,90
2450,87,3,646,4,3527,122,40
2451,87,3,647,7,3534,75,70
2452,87,3,648,8,3542,92,80
2453,87,3,649,8,3550,0,80
2454,87,3,650,9,3559,159,90
2455,87,3,651,7,3566,78,70
2456,87,3,652,6,3572,46,60
2457,87,3,653,6,3578,78,60
2458,87,3,654,5,3583,55,50
2459,87,3,655,4,3587,46,40
2460,87,3,656,6,3593,59,60
2461,87,3,657,4,3597,0,40
2462,87,3,658,8,3605,132,80
2463,87,3,659,3,3608,22,30
2464,87,3,660,8,3616,74,80
2465,87,3,661,4,3620,41,40
2466,87,3,662,5,3625,52,50
2467,87,3,663,2,3627,26,20
2468,87,3,664,2,3629,22,20
2469,87,3,665,6,3635,56,60
2470,87,3,666,7,3642,65,70
2471,87,3,667,3,3645,26,30
2472,87,3,668,8,3653,0,80
2473,87,3,669,7,3660,155,70
2474,87,3,670,4,3664,34,40
2475,87,3,671,5,3669,0,50
2476,87,3,672,4,3673,0,40
2477,87,3,673,3,3676,121,30
2478,87,3,674,5,3681,47,50
2479,87,3,675,6,3687,59,60
2480,87,3,676,5,3692,47,50
2481,87,3,677,4,3696,30,40
2482,87,3,678,6,3702,0,60
2483,87,3,679,2,3704,70,20
2484,87,3,680,3,3707,34,30
2485,87,3,681,4,3711,40,40
2486,87,3,682,9,3720,83,90
2487,87,3,683,3,3723,30,30
2488,87,3,684,9,3732,84,90
2489,87,3,685,2,3734,27,20
2490,87,3,686,5,3739,45,50
2491,87,3,687,6,3745,55,60
2492,87,3,688,8,3753,77,80
2493,87,3,689,8,3761,66,80
2494,87,3,690,6,3767,67,60
2495,87,3,691,4,3771,50,40
2496,87,3,692,7,3778,86,70
2497,87,3,693,9,3787,0,90
2498,87,3,694,5,3792,134,50
2499,87,3,695,5,3797,50,50
2500,87,3,696,7,3804,61,70
2501,87,3,697,3,3807,0,30
2502,87,3,698,3,3810,57,30
2503,87,3,699,6,3816,59,60
2504,87,3,700,6,3822,58,60
2505,87,3,701,4,3826,44,40
2506,87,3,702,7,3833,81,70
2507,87,3,703,4,3837,43,40
2508,87,3,704,5,3842,42,50
2509,87,3,705,2,3844,0,20
2510,87,3,706,3,3847,52,30
2511,87,3,707,9,3856,96,90
2512,87,3,708,6,3862,65,60
2513,87,3,709,6,3868,0,60
2514,87,3,710,4,3872,112,40
2515,87,3,711,6,3878,0,60
2516,87,3,712,9,3887,0,90
2517,87,3,713,5,3892,219,50
2518,87,3,714,7,3899,86,70
2519,87,3,715,7,3906,67,70
2520,87,3,716,8,3914,84,80
2521,87,3,717,6,3920,64,60
2522,87,3,718,4,3924,0,40
2523,87,3,719,6,3930,109,60
2524,87,3,720,6,3936,49,60
2525,87,3,721,5,3941,42,50
2526,87,3,722,2,3943,0,20
2527,87,3,723,6,3949,86,60
2528,87,3,724,8,3957,0,80
2529,87,3,725,6,3963,124,60
2530,87,3,726,3,3966,25,30
2531,87,3,727,8,3974,62,80
2532,87,3,728,7,3981,0,70
2533,87,3,729,3,3984,82,30
2534,87,3,730,6,3990,60,60
2535,87,3,731,5,3995,44,50
2536,87,3,732,2,3997,24,20
2537,87,3,733,6,4003,66,60
2538,87,3,734,6,4009,0,60
2539,87,3,735,2,4011,84,20
2540,87,3,736,4,4015,37,40
2541,87,3,737,2,4017,0,20
2542,87,3,738,3,4020,67,30
2543,87,3,739,2,4022,30,20
2544,87,3,740,3,4025,28,30
2545,87,3,741,4,4029,39,40
2546,87,3,742,4,4033,36,40
2547,87,3,743,4,4037,36,40
2548,87,3,744,8,4045,85,80
2549,87,3,745,5,4050,37,50
2550,87,3,746,6,4056,64,60
2551,87,3,747,8,4064,0,80
2552,87,3,748,9,4073,0,90
2553,87,3,749,7,4080,230,70
2554,87,3,750,2,4082,0,20
2555,87,3,751,3,4085,36,30
2556,87,3,752,5,4090,57,50
2557,87,3,753,7,4097,68,70
2558,87,3,754,4,4101,45,40
2559,87,3,755,7,4108,79,70
2560,87,3,756,8,4116,0,80
2561,87,3,757,8,4124,152,80
2562,87,3,758,6,4130,58,60
2563,87,3,759,5,4135,44,50
2564,87,3,760,6,4141,60,60
2565,87,3,761,2,4143,0,20
2566,87,3,762,7,4150,82,70
2567,87,3,763,6,4156,48,60
2568,87,3,764,9,4165,109,90
2569,87,3,765,2,4167,28,20
2570,87,3,766,7,4174,73,70
2571,87,3,767,4,4178,20,40
2572,87,3,768,6,4184,75,60
2573,87,3,769,8,4192,0,80
2574,87,3,770,3,4195,116,30
2575,87,3,771,4,4199,29,40
2576,87,3,772,5,4204,54,50
2577,87,3,773,5,4209,43,50
2578,87,3,774,4,4213,0,40
2579,87,3,775,7,4220,116,70
2580,87,3,776,6,4226,0,60
2581,87,3,777,7,4233,133,70
2582,87,3,778,2,4235,21,20
2583,87,3,779,7,4242,66,70
2584,87,3,780,8,4250,87,80
2585,87,3,781,7,4257,64,70
2586,87,3,782,6,4263,44,60
2587,87,3,783,4,4267,0,40
2588,87,3,784,5,4272,0,50
2589,87,3,785,2,4274,105,20
2590,87,3,786,3,4277,24,30
2591,87,3,787,6,4283,50,60
2592,87,3,788,3,4286,26,30
2593,87,3,789,5,4291,59,50
2594,87,3,790,4,4295,41,40
2595,87,3,791,4,4299,0,40
2596,87,3,792,6,4305,71,60
2597,87,3,793,4,4309,39,40
2598,87,3,794,4,4313,0,40
2599,87,3,795,7,4320,108,70
2600,87,3,796,3,4323,31,30
2601,87,3,797,2,4325,18,20
2602,87,3,798,3,4328,0,30
2603,87,3,799,8,4336,0,80
2604,87,3,800,8,4344,214,80
2605,87,3,801,9,4353,94,90
2606,87,3,802,2,4355,20,20
2607,87,3,803,3,4358,34,30
2608,87,3,804,8,4366,0,80
2609,87,3,805,8,4374,158,80
2610,87,3,806,6,4380,54,60
2611,87,3,807,3,4383,30,30
2612,87,3,808,4,4387,28,40
2613,87,3,809,2,4389,0,20
2614,87,3,810,5,4394,61,50
2615,87,3,811,6,4400,69,60
2616,87,3,812,8,4408,70,80
2617,87,3,813,4,4412,37,40
2618,87,3,814,9,4421,0,90
2619,87,3,815,3,4424,0,30
2620,87,3,816,8,4432,0,80
2621,87,3,817,4,4436,211,40
2622,87,3,818,4,4440,51,40
2623,87,3,819,2,4442,20,20
2624,87,3,820,8,4450,0,80
2625,87,3,821,7,4457,0,70
2626,87,3,822,8,4465,0,80
2627,87,3,823,5,4470,0,50
2628,87,3,824,7,4477,355,70
2629,87,3,825,3,4480,40,30
2630,87,3,826,7,4487,68,70
2631,87,3,827,7,4494,56,70
2632,87,3,828,6,4500,0,60
2633,87,3,829,7,4507,139,70
2634,87,3,830,7,4514,68,70
2635,87,3,831,4,4518,34,40
2636,87,3,832,9,4527,108,90
2637,87,3,833,3,4530,24,30
2638,87,3,834,6,4536,62,60
2639,87,3,835,7,4543,0,70
2640,87,3,836,2,4545,97,20
2641,87,3,837,2,4547,29,20
2642,87,3,838,6,4553,70,60
2643,87,3,839,4,4557,33,40
2644,87,3,840,7,4564,0,70
2645,87,3,841,9,4573,151,90
2646,87,3,842,7,4580,0,70
2647,87,3,843,9,4589,170,90
2648,87,3,844,9,4598,81,90
2649,87,3,845,8,4606,0,80
2650,87,3,846,7,4613,141,70
2651,87,3,847,6,4619,0,60
2652,87,3,848,5,4624,100,50
2653,87,3,849,2,4626,0,20
2654,87,3,850,8,4634,99,80
2655,87,3,851,7,4641,67,70
2656,87,3,852,6,4647,0,60
2657,87,3,853,5,4652,107,50
2658,87,3,854,6,4658,63,60
2659,87,3,855,8,4666,75,80
2660,87,3,856,9,4675,109,90
2661,87,3,857,8,4683,89,80
2662,87,3,858,8,4691,76,80
2663,87,3,859,4,4695,29,40
2664,87,3,860,7,4702,55,70
2665,87,3,861,4,4706,47,40
2666,87,3,862,4,4710,45,40
2667,87,3,863,8,4718,70,80
2668,87,3,864,5,4723,53,50
2669,87,3,865,4,4727,43,40
2670,87,3,866,5,4732,60,50
2671,87,3,867,3,4735,34,30
2672,87,3,868,5,4740,42,50
2673,87,3,869,7,4747,69,70
2674,87,3,870,4,4751,0,40
2675,87,3,871,3,4754,66,30
2676,87,3,872,2,4756,13,20
2677,87,3,873,6,4762,56,60
2678,87,3,874,6,4768,51,60
2679,87,3,875,5,4773,66,50
2680,87,3,876,7,4780,71,70
2681,87,3,877,4,4784,45,40
2682,87,3,878,9,4793,0,90
2683,87,3,879,4,4797,0,40
2684,87,3,880,3,4800,0,30
2685,87,3,881,7,4807,223,70
2686,87,3,882,6,4813,72,60
2687,87,3,883,6,4819,62,60
2688,87,3,884,6,4825,60,60
2689,87,3,885,2,4827,14,20
2690,87,3,886,8,4835,69,80
2691,87,3,887,4,4839,44,40
2692,87,3,888,6,4845,56,60
2693,87,3,889,6,4851,0,60
2694,87,3,890,5,4856,104,50
2695,87,3,891,3,4859,23,30
2696,87,3,892,6,4865,0,60
2697,87,3,893,4,4869,85,40
2698,87,3,894,7,4876,0,70
2699,87,3,895,6,4882,138,60
2700,87,3,896,9,4891,0,90
2701,87,3,897,6,4897,135,60
2702,87,3,898,7,4904,64,70
2703,87,3,899,4,4908,35,40
2704,87,3,900,2,4910,24,20
2705,87,3,901,5,4915,51,50
2706,87,3,902,2,4917,20,20
2707,87,3,903,6,4923,58,60
2708,87,3,904,8,4931,0,80
2709,87,3,905,7,4938,142,70
2710,87,3,906,6,4944,47,60
2711,87,3,907,9,4953,0,90
2712,87,3,908,9,4962,175,90
2713,87,3,909,3,4965,0,30
2714,87,3,910,5,4970,98,50
2715,87,3,911,2,4972,22,20
2716,87,3,912,5,4977,49,50
2717,87,3,913,6,4983,58,60
2718,87,3,914,6,4989,65,60
2719,87,3,915,2,4991,27,20
2720,87,3,916,6,4997,0,60
