,Scenario,Trial,Inspection,Interval,Time,Defects,Rate
0,169,1,1,8,8,92,80
1,169,1,2,6,14,0,60
2,169,1,3,6,20,0,60
3,169,1,4,7,27,209,70
4,169,1,5,2,29,17,20
5,169,1,6,4,33,0,40
6,169,1,7,3,36,68,30
7,169,1,8,5,41,0,50
8,169,1,9,9,50,128,90
9,169,1,10,5,55,47,50
10,169,1,11,3,58,44,30
11,169,1,12,4,62,32,40
12,169,1,13,7,69,71,70
13,169,1,14,9,78,0,90
14,169,1,15,4,82,0,40
15,169,1,16,7,89,0,70
16,169,1,17,4,93,244,40
17,169,1,18,8,101,88,80
18,169,1,19,3,104,0,30
19,169,1,20,3,107,52,30
20,169,1,21,8,115,71,80
21,169,1,22,2,117,0,20
22,169,1,23,9,126,120,90
23,169,1,24,2,128,14,20
24,169,1,25,6,134,0,60
25,169,1,26,3,137,83,30
26,169,1,27,3,140,25,30
27,169,1,28,2,142,19,20
28,169,1,29,9,151,0,90
29,169,1,30,8,159,164,80
30,169,1,31,7,166,0,70
31,169,1,32,7,173,0,70
32,169,1,33,4,177,0,40
33,169,1,34,2,179,0,20
34,169,1,35,8,187,268,80
35,169,1,36,3,190,0,30
36,169,1,37,5,195,0,50
37,169,1,38,2,197,102,20
38,169,1,39,7,204,72,70
39,169,1,40,8,212,0,80
40,169,1,41,4,216,107,40
41,169,1,42,9,225,92,90
42,169,1,43,2,227,0,20
43,169,1,44,9,236,0,90
44,169,1,45,9,245,200,90
45,169,1,46,6,251,54,60
46,169,1,47,7,258,69,70
47,169,1,48,7,265,83,70
48,169,1,49,4,269,0,40
49,169,1,50,5,274,0,50
50,169,1,51,2,276,93,20
51,169,1,52,9,285,0,90
52,169,1,53,2,287,0,20
53,169,1,54,7,294,0,70
54,169,1,55,3,297,212,30
55,169,1,56,7,304,0,70
56,169,1,57,9,313,0,90
57,169,1,58,3,316,204,30
58,169,1,59,2,318,23,20
59,169,1,60,9,327,81,90
60,169,1,61,8,335,0,80
61,169,1,62,7,342,0,70
62,169,1,63,2,344,0,20
63,169,1,64,4,348,0,40
64,169,1,65,4,352,285,40
65,169,1,66,3,355,0,30
66,169,1,67,3,358,0,30
67,169,1,68,9,367,0,90
68,169,1,69,7,374,0,70
69,169,1,70,5,379,284,50
70,169,1,71,3,382,33,30
71,169,1,72,6,388,63,60
72,169,1,73,5,393,46,50
73,169,1,74,4,397,0,40
74,169,1,75,6,403,91,60
75,169,1,76,2,405,21,20
76,169,1,77,2,407,18,20
77,169,1,78,9,416,83,90
78,169,1,79,5,421,0,50
79,169,1,80,7,428,0,70
80,169,1,81,5,433,159,50
81,169,1,82,6,439,76,60
82,169,1,83,3,442,0,30
83,169,1,84,5,447,90,50
84,169,1,85,2,449,0,20
85,169,1,86,2,451,0,20
86,169,1,87,3,454,76,30
87,169,1,88,6,460,68,60
88,169,1,89,3,463,30,30
89,169,1,90,3,466,25,30
90,169,1,91,2,468,0,20
91,169,1,92,4,472,66,40
92,169,1,93,2,474,0,20
93,169,1,94,6,480,0,60
94,169,1,95,8,488,0,80
95,169,1,96,6,494,0,60
96,169,1,97,8,502,0,80
97,169,1,98,2,504,354,20
98,169,1,99,3,507,0,30
99,169,1,100,5,512,0,50
100,169,1,101,8,520,0,80
101,169,1,102,6,526,0,60
102,169,1,103,6,532,0,60
103,169,1,104,2,534,324,20
104,169,1,105,3,537,43,30
105,169,1,106,2,539,17,20
106,169,1,107,9,548,0,90
107,169,1,108,3,551,0,30
108,169,1,109,6,557,0,60
109,169,1,110,7,564,0,70
110,169,1,111,7,571,344,70
111,169,1,112,5,576,61,50
112,169,1,113,5,581,40,50
113,169,1,114,3,584,0,30
114,169,1,115,2,586,0,20
115,169,1,116,6,592,0,60
116,169,1,117,2,594,0,20
117,169,1,118,5,599,175,50
118,169,1,119,9,608,90,90
119,169,1,120,9,617,0,90
120,169,1,121,5,622,107,50
121,169,1,122,6,628,0,60
122,169,1,123,4,632,0,40
123,169,1,124,2,634,123,20
124,169,1,125,8,642,93,80
125,169,1,126,2,644,25,20
126,169,1,127,3,647,33,30
127,169,1,128,9,656,0,90
128,169,1,129,4,660,126,40
129,169,1,130,9,669,0,90
130,169,1,131,9,678,0,90
131,169,1,132,9,687,260,90
132,169,1,133,6,693,60,60
133,169,1,134,2,695,19,20
134,169,1,135,6,701,54,60
135,169,1,136,4,705,0,40
136,169,1,137,8,713,126,80
137,169,1,138,4,717,0,40
138,169,1,139,9,726,130,90
139,169,1,140,5,731,52,50
140,169,1,141,7,738,85,70
141,169,1,142,6,744,0,60
142,169,1,143,8,752,139,80
143,169,1,144,8,760,80,80
144,169,1,145,4,764,0,40
145,169,1,146,6,770,0,60
146,169,1,147,8,778,181,80
147,169,1,148,2,780,0,20
148,169,1,149,5,785,84,50
149,169,1,150,3,788,0,30
150,169,1,151,9,797,138,90
151,169,1,152,6,803,50,60
152,169,1,153,5,808,55,50
153,169,1,154,5,813,51,50
154,169,1,155,8,821,0,80
155,169,1,156,4,825,121,40
156,169,1,157,9,834,79,90
157,169,1,158,8,842,84,80
158,169,1,159,8,850,84,80
159,169,1,160,2,852,19,20
160,169,1,161,7,859,0,70
161,169,1,162,7,866,0,70
162,169,1,163,7,873,182,70
163,169,1,164,2,875,15,20
164,169,1,165,9,884,0,90
165,169,1,166,4,888,0,40
166,169,1,167,2,890,147,20
167,169,1,168,8,898,78,80
168,169,1,169,9,907,0,90
169,169,1,170,3,910,0,30
170,169,1,171,8,918,0,80
171,169,1,172,5,923,0,50
172,169,1,173,3,926,280,30
173,169,1,174,6,932,0,60
174,169,1,175,9,941,148,90
175,169,1,176,7,948,81,70
176,169,1,177,5,953,0,50
177,169,1,178,4,957,88,40
178,169,1,179,7,964,66,70
179,169,1,180,2,966,22,20
180,169,1,181,3,969,27,30
181,169,1,182,4,973,0,40
182,169,1,183,7,980,0,70
183,169,1,184,3,983,133,30
184,169,1,185,3,986,0,30
185,169,1,186,8,994,119,80
186,169,1,187,7,1001,0,70
187,169,1,188,2,1003,84,20
188,169,1,189,3,1006,0,30
189,169,1,190,8,1014,0,80
190,169,1,191,8,1022,0,80
191,169,1,192,3,1025,0,30
192,169,1,193,8,1033,0,80
193,169,1,194,3,1036,336,30
194,169,1,195,8,1044,73,80
195,169,1,196,5,1049,49,50
196,169,1,197,5,1054,60,50
197,169,1,198,3,1057,30,30
198,169,1,199,4,1061,34,40
199,169,1,200,5,1066,57,50
200,169,1,201,7,1073,0,70
201,169,1,202,6,1079,108,60
202,169,1,203,4,1083,37,40
203,169,1,204,3,1086,0,30
204,169,1,205,8,1094,0,80
205,169,1,206,7,1101,191,70
206,169,1,207,6,1107,64,60
207,169,1,208,7,1114,0,70
208,169,1,209,6,1120,0,60
209,169,1,210,7,1127,189,70
210,169,1,211,7,1134,0,70
211,169,1,212,9,1143,185,90
212,169,1,213,6,1149,50,60
213,169,1,214,9,1158,0,90
214,169,1,215,5,1163,141,50
215,169,1,216,5,1168,46,50
216,169,1,217,6,1174,59,60
217,169,1,218,4,1178,42,40
218,169,1,219,7,1185,71,70
219,169,1,220,2,1187,0,20
220,169,1,221,3,1190,52,30
221,169,1,222,3,1193,0,30
222,169,1,223,4,1197,61,40
223,169,1,224,7,1204,0,70
224,169,1,225,8,1212,0,80
225,169,1,226,9,1221,0,90
226,169,1,227,7,1228,311,70
227,169,1,228,5,1233,0,50
228,169,1,229,7,1240,0,70
229,169,1,230,2,1242,160,20
230,169,1,231,5,1247,72,50
231,169,1,232,9,1256,85,90
232,169,1,233,9,1265,86,90
233,169,1,234,3,1268,29,30
234,169,1,235,8,1276,0,80
235,169,1,236,8,1284,0,80
236,169,1,237,7,1291,218,70
237,169,1,238,5,1296,0,50
238,169,1,239,5,1301,0,50
239,169,1,240,9,1310,0,90
240,169,1,241,2,1312,204,20
241,169,1,242,7,1319,0,70
242,169,1,243,8,1327,0,80
243,169,1,244,9,1336,248,90
244,169,1,245,2,1338,29,20
245,169,1,246,6,1344,66,60
246,169,1,247,6,1350,0,60
247,169,1,248,8,1358,133,80
248,169,1,249,2,1360,0,20
249,169,1,250,5,1365,0,50
250,169,1,251,4,1369,0,40
251,169,1,252,8,1377,193,80
252,169,1,253,4,1381,46,40
253,169,1,254,8,1389,0,80
254,169,1,255,6,1395,0,60
255,169,1,256,4,1399,173,40
256,169,1,257,9,1408,88,90
257,169,1,258,6,1414,0,60
258,169,1,259,5,1419,0,50
259,169,1,260,7,1426,188,70
260,169,1,261,6,1432,0,60
261,169,1,262,7,1439,0,70
262,169,1,263,5,1444,0,50
263,169,1,264,9,1453,0,90
264,169,1,265,5,1458,313,50
265,169,1,266,4,1462,0,40
266,169,1,267,6,1468,96,60
267,169,1,268,8,1476,0,80
268,169,1,269,6,1482,140,60
269,169,1,270,3,1485,0,30
270,169,1,271,4,1489,58,40
271,169,1,272,5,1494,51,50
272,169,1,273,3,1497,0,30
273,169,1,274,3,1500,53,30
274,169,1,275,4,1504,38,40
275,169,1,276,4,1508,0,40
276,169,1,277,9,1517,134,90
277,169,1,278,2,1519,0,20
278,169,1,279,6,1525,0,60
279,169,1,280,6,1531,143,60
280,169,1,281,4,1535,44,40
281,169,1,282,4,1539,47,40
282,169,1,283,3,1542,0,30
283,169,1,284,4,1546,82,40
284,169,1,285,5,1551,0,50
285,169,1,286,4,1555,0,40
286,169,1,287,7,1562,0,70
287,169,1,288,6,1568,233,60
288,169,1,289,4,1572,39,40
289,169,1,290,9,1581,97,90
290,169,1,291,9,1590,0,90
291,169,1,292,8,1598,0,80
292,169,1,293,5,1603,0,50
293,169,1,294,9,1612,0,90
294,169,1,295,3,1615,0,30
295,169,1,296,9,1624,471,90
296,169,1,297,4,1628,0,40
297,169,1,298,6,1634,103,60
298,169,1,299,6,1640,0,60
299,169,1,300,6,1646,0,60
300,169,1,301,8,1654,189,80
301,169,1,302,2,1656,0,20
302,169,1,303,2,1658,37,20
303,169,1,304,6,1664,0,60
304,169,1,305,6,1670,128,60
305,169,1,306,3,1673,0,30
306,169,1,307,3,1676,0,30
307,169,1,308,9,1685,130,90
308,169,1,309,4,1689,41,40
309,169,1,310,5,1694,60,50
310,169,1,311,2,1696,0,20
311,169,1,312,7,1703,86,70
312,169,1,313,9,1712,0,90
313,169,1,314,5,1717,127,50
314,169,1,315,4,1721,53,40
315,169,1,316,3,1724,0,30
316,169,1,317,2,1726,55,20
317,169,1,318,4,1730,0,40
318,169,1,319,2,1732,64,20
319,169,1,320,5,1737,53,50
320,169,1,321,7,1744,0,70
321,169,1,322,8,1752,127,80
322,169,1,323,6,1758,73,60
323,169,1,324,9,1767,0,90
324,169,1,325,5,1772,0,50
325,169,1,326,7,1779,186,70
326,169,1,327,4,1783,0,40
327,169,1,328,9,1792,125,90
328,169,1,329,7,1799,82,70
329,169,1,330,3,1802,0,30
330,169,1,331,4,1806,0,40
331,169,1,332,9,1815,173,90
332,169,1,333,9,1824,0,90
333,169,1,334,9,1833,0,90
334,169,1,335,2,1835,223,20
335,169,1,336,3,1838,29,30
336,169,1,337,2,1840,0,20
337,169,1,338,2,1842,0,20
338,169,1,339,3,1845,75,30
339,169,1,340,5,1850,47,50
340,169,1,341,4,1854,44,40
341,169,1,342,9,1863,0,90
342,169,1,343,3,1866,111,30
343,169,1,344,4,1870,35,40
344,169,1,345,4,1874,0,40
345,169,1,346,4,1878,86,40
346,169,1,347,3,1881,0,30
347,169,1,348,3,1884,63,30
348,169,1,349,4,1888,38,40
349,169,1,350,8,1896,0,80
350,169,1,351,9,1905,0,90
351,169,1,352,8,1913,238,80
352,169,1,353,7,1920,72,70
353,169,1,354,2,1922,0,20
354,169,1,355,8,1930,94,80
355,169,1,356,9,1939,83,90
356,169,1,357,3,1942,0,30
357,169,1,358,3,1945,57,30
358,169,1,359,4,1949,41,40
359,169,1,360,6,1955,46,60
360,169,1,361,5,1960,0,50
361,169,1,362,5,1965,99,50
362,169,1,363,8,1973,0,80
363,169,1,364,9,1982,159,90
364,169,1,365,5,1987,0,50
365,169,1,366,4,1991,88,40
366,169,1,367,9,2000,82,90
367,169,1,368,5,2005,46,50
368,169,1,369,2,2007,0,20
369,169,1,370,7,2014,0,70
370,169,1,371,7,2021,0,70
371,169,1,372,6,2027,0,60
372,169,1,373,9,2036,310,90
373,169,1,374,3,2039,25,30
374,169,1,375,9,2048,0,90
375,169,1,376,9,2057,0,90
376,169,1,377,4,2061,0,40
377,169,1,378,9,2070,0,90
378,169,1,379,2,2072,321,20
379,169,1,380,4,2076,30,40
380,169,1,381,6,2082,0,60
381,169,1,382,2,2084,0,20
382,169,1,383,7,2091,156,70
383,169,1,384,2,2093,16,20
384,169,1,385,6,2099,56,60
385,169,1,386,3,2102,0,30
386,169,1,387,7,2109,97,70
387,169,1,388,7,2116,0,70
388,169,1,389,4,2120,131,40
389,169,1,390,3,2123,0,30
390,169,1,391,6,2129,107,60
391,169,1,392,5,2134,0,50
392,169,1,393,2,2136,0,20
393,169,1,394,8,2144,0,80
394,169,1,395,2,2146,171,20
395,169,1,396,8,2154,79,80
396,169,1,397,7,2161,58,70
397,169,1,398,7,2168,74,70
398,169,1,399,3,2171,34,30
399,169,1,400,5,2176,51,50
400,169,1,401,7,2183,0,70
401,169,1,402,6,2189,118,60
402,169,1,403,5,2194,0,50
403,169,1,404,9,2203,148,90
404,169,1,405,2,2205,0,20
405,169,1,406,8,2213,0,80
406,169,1,407,6,2219,159,60
407,169,1,408,7,2226,0,70
408,169,1,409,6,2232,125,60
409,169,1,410,9,2241,93,90
410,169,1,411,6,2247,0,60
411,169,1,412,4,2251,0,40
412,169,1,413,2,2253,0,20
413,169,1,414,5,2258,0,50
414,169,1,415,3,2261,196,30
415,169,1,416,7,2268,0,70
416,169,1,417,5,2273,110,50
417,169,1,418,8,2281,0,80
418,169,1,419,8,2289,0,80
419,169,1,420,3,2292,0,30
420,169,1,421,3,2295,230,30
421,169,1,422,6,2301,62,60
422,169,1,423,3,2304,29,30
423,169,1,424,3,2307,0,30
424,169,1,425,9,2316,127,90
425,169,1,426,3,2319,0,30
426,169,1,427,6,2325,70,60
427,169,1,428,8,2333,82,80
428,169,1,429,3,2336,0,30
429,169,1,430,4,2340,65,40
430,169,1,431,2,2342,17,20
431,169,1,432,4,2346,36,40
432,169,1,433,2,2348,19,20
433,169,1,434,3,2351,28,30
434,169,1,435,3,2354,35,30
435,169,1,436,3,2357,0,30
436,169,1,437,8,2365,0,80
437,169,1,438,9,2374,178,90
438,169,1,439,9,2383,0,90
439,169,1,440,5,2388,0,50
440,169,1,441,4,2392,156,40
441,169,1,442,7,2399,0,70
442,169,1,443,4,2403,110,40
443,169,1,444,4,2407,53,40
444,169,1,445,2,2409,25,20
445,169,1,446,3,2412,26,30
446,169,1,447,2,2414,0,20
447,169,1,448,9,2423,108,90
448,169,1,449,5,2428,0,50
449,169,1,450,5,2433,97,50
450,169,1,451,8,2441,0,80
451,169,1,452,4,2445,0,40
452,169,1,453,2,2447,152,20
453,169,1,454,3,2450,33,30
454,169,1,455,7,2457,82,70
455,169,1,456,3,2460,26,30
456,169,1,457,5,2465,0,50
457,169,1,458,5,2470,0,50
458,169,1,459,3,2473,115,30
459,169,1,460,6,2479,67,60
460,169,1,461,6,2485,55,60
461,169,1,462,8,2493,69,80
462,169,1,463,6,2499,0,60
463,169,1,464,8,2507,141,80
464,169,1,465,3,2510,32,30
465,169,1,466,3,2513,37,30
466,169,1,467,6,2519,0,60
467,169,1,468,3,2522,102,30
468,169,1,469,7,2529,0,70
469,169,1,470,2,2531,109,20
470,169,1,471,9,2540,93,90
471,169,1,472,3,2543,33,30
472,169,1,473,6,2549,50,60
473,169,1,474,7,2556,73,70
474,169,1,475,6,2562,0,60
475,169,1,476,5,2567,0,50
476,169,1,477,9,2576,0,90
477,169,1,478,3,2579,225,30
478,169,1,479,6,2585,71,60
479,169,1,480,5,2590,0,50
480,169,1,481,5,2595,0,50
481,169,1,482,6,2601,142,60
482,169,1,483,9,2610,81,90
483,169,1,484,8,2618,74,80
484,169,1,485,6,2624,0,60
485,169,1,486,5,2629,0,50
486,169,1,487,8,2637,200,80
487,169,1,488,4,2641,0,40
488,169,1,489,9,2650,116,90
489,169,1,490,9,2659,86,90
490,169,1,491,6,2665,61,60
491,169,1,492,8,2673,0,80
492,169,1,493,8,2681,0,80
493,169,1,494,6,2687,217,60
494,169,1,495,8,2695,80,80
495,169,1,496,7,2702,71,70
496,169,1,497,2,2704,0,20
497,169,1,498,2,2706,31,20
498,169,1,499,6,2712,0,60
499,169,1,500,3,2715,91,30
500,169,1,501,2,2717,0,20
501,169,1,502,6,2723,81,60
502,169,1,503,6,2729,0,60
503,169,1,504,8,2737,0,80
504,169,1,505,7,2744,196,70
505,169,1,506,7,2751,67,70
506,169,1,507,3,2754,36,30
507,169,1,508,8,2762,0,80
508,169,1,509,5,2767,125,50
509,169,1,510,6,2773,62,60
510,169,1,511,7,2780,0,70
511,169,1,512,4,2784,0,40
512,169,1,513,8,2792,186,80
513,169,1,514,7,2799,71,70
514,169,1,515,8,2807,71,80
515,169,1,516,4,2811,0,40
516,169,1,517,9,2820,0,90
517,169,1,518,8,2828,229,80
518,169,1,519,4,2832,42,40
519,169,1,520,8,2840,0,80
520,169,1,521,4,2844,114,40
521,169,1,522,4,2848,0,40
522,169,1,523,9,2857,121,90
523,169,1,524,3,2860,28,30
524,169,1,525,2,2862,31,20
525,169,1,526,8,2870,0,80
526,169,1,527,8,2878,0,80
527,169,1,528,5,2883,0,50
528,169,1,529,7,2890,277,70
529,169,1,530,9,2899,99,90
530,169,1,531,4,2903,34,40
531,169,1,532,4,2907,52,40
532,169,1,533,2,2909,20,20
533,169,1,534,7,2916,64,70
534,169,1,535,8,2924,0,80
535,169,1,536,2,2926,0,20
536,169,1,537,3,2929,0,30
537,169,1,538,2,2931,172,20
538,169,1,539,7,2938,0,70
539,169,1,540,4,2942,0,40
540,169,1,541,9,2951,0,90
541,169,1,542,4,2955,0,40
542,169,1,543,8,2963,0,80
543,169,1,544,7,2970,372,70
544,169,1,545,9,2979,0,90
545,169,1,546,6,2985,138,60
546,169,1,547,4,2989,0,40
547,169,1,548,5,2994,93,50
548,169,1,549,2,2996,13,20
549,169,1,550,7,3003,64,70
550,169,1,551,9,3012,115,90
551,169,1,552,5,3017,0,50
552,169,1,553,7,3024,0,70
553,169,1,554,5,3029,182,50
554,169,1,555,8,3037,0,80
555,169,1,556,9,3046,167,90
556,169,1,557,3,3049,0,30
557,169,1,558,5,3054,85,50
558,169,1,559,6,3060,0,60
559,169,1,560,4,3064,93,40
560,169,1,561,9,3073,98,90
561,169,1,562,2,3075,23,20
562,169,1,563,9,3084,83,90
563,169,1,564,8,3092,71,80
564,169,1,565,7,3099,64,70
565,169,1,566,7,3106,0,70
566,169,1,567,5,3111,121,50
567,169,1,568,4,3115,35,40
568,169,1,569,3,3118,0,30
569,169,1,570,4,3122,64,40
570,169,1,571,3,3125,0,30
571,169,1,572,2,3127,0,20
572,169,1,573,5,3132,95,50
573,169,1,574,2,3134,0,20
574,169,1,575,9,3143,0,90
575,169,1,576,4,3147,0,40
576,169,1,577,5,3152,233,50
577,169,1,578,4,3156,45,40
578,169,1,579,3,3159,0,30
579,169,1,580,8,3167,127,80
580,169,1,581,6,3173,0,60
581,169,1,582,4,3177,0,40
582,169,1,583,6,3183,0,60
583,169,1,584,6,3189,0,60
584,169,1,585,5,3194,0,50
585,169,1,586,9,3203,387,90
586,169,1,587,9,3212,87,90
587,169,1,588,5,3217,0,50
588,169,1,589,6,3223,0,60
589,169,1,590,6,3229,0,60
590,169,1,591,5,3234,204,50
591,169,1,592,8,3242,0,80
592,169,1,593,2,3244,99,20
593,169,1,594,2,3246,17,20
594,169,1,595,8,3254,0,80
595,169,1,596,3,3257,0,30
596,169,1,597,4,3261,0,40
597,169,1,598,4,3265,214,40
598,169,1,599,5,3270,0,50
599,169,1,600,9,3279,117,90
600,169,1,601,5,3284,47,50
601,169,1,602,6,3290,0,60
602,169,1,603,7,3297,108,70
603,169,1,604,5,3302,0,50
604,169,1,605,6,3308,113,60
605,169,1,606,8,3316,72,80
606,169,1,607,4,3320,41,40
607,169,1,608,3,3323,0,30
608,169,1,609,8,3331,120,80
609,169,1,610,3,3334,0,30
610,169,1,611,3,3337,56,30
611,169,1,612,2,3339,0,20
612,169,1,613,2,3341,0,20
613,169,1,614,6,3347,0,60
614,169,1,615,9,3356,0,90
615,169,1,616,3,3359,0,30
616,169,1,617,3,3362,246,30
617,169,1,618,5,3367,54,50
618,169,1,619,3,3370,27,30
619,169,1,620,6,3376,0,60
620,169,1,621,9,3385,143,90
621,169,1,622,4,3389,39,40
622,169,1,623,3,3392,0,30
623,169,1,624,2,3394,59,20
624,169,1,625,5,3399,43,50
625,169,1,626,9,3408,90,90
626,169,1,627,8,3416,0,80
627,169,1,628,2,3418,0,20
628,169,1,629,7,3425,154,70
629,169,1,630,9,3434,92,90
630,169,1,631,9,3443,80,90
631,169,1,632,3,3446,18,30
632,169,1,633,8,3454,95,80
633,169,1,634,2,3456,19,20
634,169,1,635,3,3459,0,30
635,169,1,636,6,3465,85,60
636,169,1,637,7,3472,75,70
637,169,1,638,2,3474,22,20
638,169,1,639,8,3482,76,80
639,169,1,640,8,3490,87,80
640,169,1,641,9,3499,87,90
641,169,1,642,9,3508,97,90
642,169,1,643,7,3515,63,70
643,169,1,644,5,3520,0,50
644,169,1,645,4,3524,0,40
645,169,1,646,9,3533,192,90
646,169,1,647,9,3542,105,90
647,169,1,648,3,3545,25,30
648,169,1,649,2,3547,0,20
649,169,1,650,2,3549,0,20
650,169,1,651,9,3558,128,90
651,169,1,652,9,3567,0,90
652,169,1,653,9,3576,0,90
653,169,1,654,3,3579,0,30
654,169,1,655,2,3581,219,20
655,169,1,656,4,3585,0,40
656,169,1,657,8,3593,115,80
657,169,1,658,5,3598,42,50
658,169,1,659,4,3602,0,40
659,169,1,660,5,3607,0,50
660,169,1,661,3,3610,0,30
661,169,1,662,6,3616,0,60
662,169,1,663,8,3624,259,80
663,169,1,664,5,3629,0,50
664,169,1,665,5,3634,0,50
665,169,1,666,5,3639,0,50
666,169,1,667,2,3641,0,20
667,169,1,668,4,3645,0,40
668,169,1,669,4,3649,0,40
669,169,1,670,9,3658,0,90
670,169,1,671,8,3666,413,80
671,169,1,672,7,3673,76,70
672,169,1,673,3,3676,33,30
673,169,1,674,7,3683,0,70
674,169,1,675,7,3690,149,70
675,169,1,676,3,3693,31,30
676,169,1,677,4,3697,0,40
677,169,1,678,8,3705,0,80
678,169,1,679,2,3707,0,20
679,169,1,680,5,3712,187,50
680,169,1,681,4,3716,39,40
681,169,1,682,4,3720,37,40
682,169,1,683,8,3728,96,80
683,169,1,684,4,3732,39,40
684,169,1,685,4,3736,31,40
685,169,1,686,9,3745,100,90
686,169,1,687,5,3750,0,50
687,169,1,688,5,3755,92,50
688,169,1,689,4,3759,45,40
689,169,1,690,2,3761,0,20
690,169,1,691,3,3764,0,30
691,169,1,692,4,3768,99,40
692,169,1,693,4,3772,0,40
693,169,1,694,5,3777,0,50
694,169,1,695,7,3784,0,70
695,169,1,696,7,3791,203,70
696,169,1,697,7,3798,0,70
697,169,1,698,2,3800,95,20
698,169,1,699,4,3804,46,40
699,169,1,700,9,3813,0,90
700,169,1,701,9,3822,0,90
701,169,1,702,6,3828,229,60
702,169,1,703,5,3833,0,50
703,169,1,704,8,3841,145,80
704,169,1,705,4,3845,48,40
705,169,1,706,6,3851,0,60
706,169,1,707,6,3857,0,60
707,169,1,708,2,3859,0,20
708,169,1,709,4,3863,194,40
709,169,1,710,2,3865,0,20
710,169,1,711,8,3873,0,80
711,169,1,712,2,3875,118,20
712,169,1,713,9,3884,0,90
713,169,1,714,9,3893,0,90
714,169,1,715,3,3896,234,30
715,169,1,716,9,3905,0,90
716,169,1,717,3,3908,0,30
717,169,1,718,8,3916,0,80
718,169,1,719,8,3924,0,80
719,169,1,720,7,3931,321,70
720,169,1,721,8,3939,79,80
721,169,1,722,6,3945,61,60
722,169,1,723,9,3954,0,90
723,169,1,724,3,3957,0,30
724,169,1,725,6,3963,188,60
725,169,1,726,4,3967,32,40
726,169,1,727,3,3970,0,30
727,169,1,728,9,3979,0,90
728,169,1,729,2,3981,0,20
729,169,1,730,6,3987,0,60
730,169,1,731,8,3995,278,80
731,169,1,732,2,3997,29,20
732,169,1,733,5,4002,42,50
733,169,1,734,6,4008,0,60
734,169,1,735,2,4010,75,20
735,169,1,736,9,4019,0,90
736,169,1,737,5,4024,0,50
737,169,1,738,2,4026,0,20
738,169,1,739,3,4029,0,30
739,169,1,740,9,4038,251,90
740,169,1,741,7,4045,86,70
741,169,1,742,6,4051,0,60
742,169,1,743,2,4053,77,20
743,169,1,744,4,4057,43,40
744,169,1,745,5,4062,0,50
745,169,1,746,8,4070,0,80
746,169,1,747,6,4076,193,60
747,169,1,748,4,4080,52,40
748,169,1,749,4,4084,54,40
749,169,1,750,3,4087,31,30
750,169,1,751,2,4089,0,20
751,169,1,752,6,4095,68,60
752,169,1,753,5,4100,55,50
753,169,1,754,4,4104,41,40
754,169,1,755,9,4113,0,90
755,169,1,756,2,4115,0,20
756,169,1,757,4,4119,137,40
757,169,1,758,6,4125,61,60
758,169,1,759,3,4128,0,30
759,169,1,760,2,4130,0,20
760,169,1,761,5,4135,107,50
761,169,1,762,7,4142,0,70
762,169,1,763,6,4148,0,60
763,169,1,764,9,4157,0,90
764,169,1,765,5,4162,274,50
765,169,1,766,3,4165,0,30
766,169,1,767,8,4173,93,80
767,169,1,768,7,4180,75,70
768,169,1,769,6,4186,66,60
769,169,1,770,5,4191,52,50
770,169,1,771,3,4194,31,30
771,169,1,772,7,4201,76,70
772,169,1,773,7,4208,57,70
773,169,1,774,8,4216,81,80
774,169,1,775,7,4223,0,70
775,169,1,776,3,4226,0,30
776,169,1,777,7,4233,0,70
777,169,1,778,3,4236,0,30
778,169,1,779,7,4243,0,70
779,169,1,780,3,4246,298,30
780,169,1,781,4,4250,0,40
781,169,1,782,6,4256,95,60
782,169,1,783,4,4260,34,40
783,169,1,784,6,4266,0,60
784,169,1,785,5,4271,111,50
785,169,1,786,9,4280,0,90
786,169,1,787,7,4287,155,70
787,169,1,788,3,4290,0,30
788,169,1,789,6,4296,89,60
789,169,1,790,9,4305,0,90
790,169,1,791,9,4314,0,90
791,169,1,792,9,4323,0,90
792,169,1,793,9,4332,0,90
793,169,1,794,2,4334,378,20
794,169,1,795,6,4340,54,60
795,169,1,796,6,4346,0,60
796,169,1,797,4,4350,74,40
797,169,1,798,5,4355,44,50
798,169,1,799,7,4362,70,70
799,169,1,800,7,4369,0,70
800,169,1,801,4,4373,0,40
801,169,1,802,6,4379,0,60
802,169,1,803,3,4382,0,30
803,169,1,804,9,4391,0,90
804,169,1,805,4,4395,291,40
805,169,1,806,3,4398,0,30
806,169,1,807,2,4400,45,20
807,169,1,808,5,4405,0,50
808,169,1,809,3,4408,0,30
809,169,1,810,7,4415,132,70
810,169,1,811,8,4423,79,80
811,169,1,812,6,4429,55,60
812,169,1,813,4,4433,0,40
813,169,1,814,3,4436,75,30
814,169,1,815,4,4440,0,40
815,169,1,816,4,4444,91,40
816,169,1,817,4,4448,52,40
817,169,1,818,7,4455,0,70
818,169,1,819,8,4463,0,80
819,169,1,820,2,4465,163,20
820,169,1,821,5,4470,61,50
821,169,1,822,9,4479,107,90
822,169,1,823,9,4488,98,90
823,169,1,824,8,4496,74,80
824,169,1,825,2,4498,0,20
825,169,1,826,9,4507,0,90
826,169,1,827,5,4512,0,50
827,169,1,828,5,4517,0,50
828,169,1,829,3,4520,247,30
829,169,1,830,6,4526,68,60
830,169,1,831,4,4530,35,40
831,169,1,832,9,4539,90,90
832,169,1,833,8,4547,0,80
833,169,1,834,6,4553,136,60
834,169,1,835,5,4558,44,50
835,169,1,836,8,4566,0,80
836,169,1,837,2,4568,120,20
837,169,1,838,5,4573,62,50
838,169,1,839,9,4582,0,90
839,169,1,840,2,4584,95,20
840,169,1,841,8,4592,82,80
841,169,1,842,8,4600,0,80
842,169,1,843,5,4605,141,50
843,169,1,844,9,4614,83,90
844,169,1,845,5,4619,0,50
845,169,1,846,8,4627,121,80
846,169,1,847,2,4629,0,20
847,169,1,848,3,4632,0,30
848,169,1,849,8,4640,143,80
849,169,1,850,2,4642,0,20
850,169,1,851,5,4647,0,50
851,169,1,852,9,4656,0,90
852,169,1,853,3,4659,202,30
853,169,1,854,7,4666,58,70
854,169,1,855,7,4673,78,70
855,169,1,856,8,4681,82,80
856,169,1,857,5,4686,0,50
857,169,1,858,9,4695,139,90
858,169,1,859,5,4700,58,50
859,169,1,860,2,4702,0,20
860,169,1,861,2,4704,42,20
861,169,1,862,3,4707,0,30
862,169,1,863,5,4712,86,50
863,169,1,864,3,4715,25,30
864,169,1,865,8,4723,101,80
865,169,1,866,6,4729,0,60
866,169,1,867,4,4733,109,40
867,169,1,868,7,4740,0,70
868,169,1,869,4,4744,102,40
869,169,1,870,4,4748,0,40
870,169,1,871,2,4750,63,20
871,169,1,872,3,4753,0,30
872,169,1,873,2,4755,0,20
873,169,1,874,4,4759,101,40
874,169,1,875,8,4767,0,80
875,169,1,876,8,4775,0,80
876,169,1,877,8,4783,0,80
877,169,1,878,7,4790,0,70
878,169,1,879,2,4792,0,20
879,169,1,880,5,4797,384,50
880,169,1,881,6,4803,0,60
881,169,1,882,2,4805,69,20
882,169,1,883,4,4809,0,40
883,169,1,884,6,4815,97,60
884,169,1,885,2,4817,15,20
885,169,1,886,6,4823,64,60
886,169,1,887,3,4826,0,30
887,169,1,888,8,4834,0,80
888,169,1,889,8,4842,0,80
889,169,1,890,3,4845,0,30
890,169,1,891,7,4852,0,70
891,169,1,892,7,4859,407,70
892,169,1,893,9,4868,101,90
893,169,1,894,9,4877,85,90
894,169,1,895,5,4882,55,50
895,169,1,896,7,4889,0,70
896,169,1,897,2,4891,92,20
897,169,1,898,7,4898,75,70
898,169,1,899,2,4900,0,20
899,169,1,900,7,4907,0,70
900,169,1,901,3,4910,116,30
901,169,1,902,9,4919,97,90
902,169,1,903,7,4926,0,70
903,169,1,904,8,4934,144,80
904,169,1,905,9,4943,76,90
905,169,1,906,2,4945,17,20
906,169,1,907,6,4951,0,60
907,169,1,908,8,4959,108,80
908,169,1,909,9,4968,77,90
909,169,1,910,4,4972,36,40
910,169,1,911,9,4981,0,90
911,169,1,912,7,4988,0,70
912,169,1,913,7,4995,0,70
913,169,1,914,4,4999,0,40
914,169,2,1,2,2,0,20
915,169,2,2,6,8,0,60
916,169,2,3,8,16,158,80
917,169,2,4,9,25,99,90
918,169,2,5,8,33,85,80
919,169,2,6,8,41,67,80
920,169,2,7,6,47,53,60
921,169,2,8,9,56,0,90
922,169,2,9,7,63,171,70
923,169,2,10,5,68,43,50
924,169,2,11,3,71,24,30
925,169,2,12,2,73,0,20
926,169,2,13,4,77,0,40
927,169,2,14,5,82,110,50
928,169,2,15,4,86,0,40
929,169,2,16,6,92,109,60
930,169,2,17,9,101,98,90
931,169,2,18,6,107,77,60
932,169,2,19,2,109,26,20
933,169,2,20,6,115,0,60
934,169,2,21,2,117,87,20
935,169,2,22,6,123,55,60
936,169,2,23,5,128,0,50
937,169,2,24,5,133,111,50
938,169,2,25,9,142,0,90
939,169,2,26,6,148,144,60
940,169,2,27,5,153,0,50
941,169,2,28,6,159,0,60
942,169,2,29,6,165,0,60
943,169,2,30,6,171,244,60
944,169,2,31,2,173,22,20
945,169,2,32,6,179,71,60
946,169,2,33,9,188,93,90
947,169,2,34,6,194,0,60
948,169,2,35,6,200,101,60
949,169,2,36,2,202,27,20
950,169,2,37,4,206,0,40
951,169,2,38,4,210,89,40
952,169,2,39,2,212,0,20
953,169,2,40,8,220,85,80
954,169,2,41,7,227,0,70
955,169,2,42,2,229,101,20
956,169,2,43,6,235,56,60
957,169,2,44,2,237,0,20
958,169,2,45,2,239,41,20
959,169,2,46,4,243,46,40
960,169,2,47,4,247,41,40
961,169,2,48,9,256,94,90
962,169,2,49,3,259,19,30
963,169,2,50,8,267,0,80
964,169,2,51,6,273,0,60
965,169,2,52,4,277,162,40
966,169,2,53,6,283,62,60
967,169,2,54,6,289,0,60
968,169,2,55,8,297,0,80
969,169,2,56,3,300,164,30
970,169,2,57,6,306,0,60
971,169,2,58,2,308,0,20
972,169,2,59,7,315,0,70
973,169,2,60,8,323,0,80
974,169,2,61,3,326,272,30
975,169,2,62,3,329,0,30
976,169,2,63,7,336,92,70
977,169,2,64,7,343,78,70
978,169,2,65,4,347,0,40
979,169,2,66,2,349,61,20
980,169,2,67,2,351,16,20
981,169,2,68,9,360,0,90
982,169,2,69,5,365,0,50
983,169,2,70,5,370,0,50
984,169,2,71,5,375,0,50
985,169,2,72,9,384,0,90
986,169,2,73,6,390,385,60
987,169,2,74,5,395,0,50
988,169,2,75,5,400,101,50
989,169,2,76,8,408,79,80
990,169,2,77,7,415,67,70
991,169,2,78,9,424,90,90
992,169,2,79,3,427,0,30
993,169,2,80,6,433,0,60
994,169,2,81,9,442,0,90
995,169,2,82,7,449,0,70
996,169,2,83,9,458,0,90
997,169,2,84,5,463,376,50
998,169,2,85,7,470,0,70
999,169,2,86,8,478,0,80
1000,169,2,87,8,486,0,80
1001,169,2,88,4,490,0,40
1002,169,2,89,7,497,0,70
1003,169,2,90,6,503,418,60
1004,169,2,91,8,511,0,80
1005,169,2,92,7,518,139,70
1006,169,2,93,9,527,0,90
1007,169,2,94,8,535,167,80
1008,169,2,95,2,537,0,20
1009,169,2,96,4,541,0,40
1010,169,2,97,5,546,0,50
1011,169,2,98,5,551,179,50
1012,169,2,99,5,556,56,50
1013,169,2,100,8,564,75,80
1014,169,2,101,4,568,37,40
1015,169,2,102,5,573,0,50
1016,169,2,103,4,577,77,40
1017,169,2,104,3,580,31,30
1018,169,2,105,3,583,0,30
1019,169,2,106,9,592,115,90
1020,169,2,107,3,595,0,30
1021,169,2,108,9,604,144,90
1022,169,2,109,4,608,0,40
1023,169,2,110,2,610,0,20
1024,169,2,111,4,614,0,40
1025,169,2,112,2,616,0,20
1026,169,2,113,8,624,208,80
1027,169,2,114,5,629,55,50
1028,169,2,115,9,638,98,90
1029,169,2,116,2,640,25,20
1030,169,2,117,7,647,66,70
1031,169,2,118,2,649,24,20
1032,169,2,119,8,657,65,80
1033,169,2,120,6,663,0,60
1034,169,2,121,8,671,165,80
1035,169,2,122,6,677,0,60
1036,169,2,123,2,679,0,20
1037,169,2,124,5,684,0,50
1038,169,2,125,9,693,0,90
1039,169,2,126,7,700,0,70
1040,169,2,127,8,708,374,80
1041,169,2,128,5,713,54,50
1042,169,2,129,2,715,0,20
1043,169,2,130,3,718,55,30
1044,169,2,131,5,723,59,50
1045,169,2,132,2,725,24,20
1046,169,2,133,7,732,71,70
1047,169,2,134,3,735,0,30
1048,169,2,135,6,741,95,60
1049,169,2,136,3,744,0,30
1050,169,2,137,6,750,0,60
1051,169,2,138,2,752,0,20
1052,169,2,139,6,758,0,60
1053,169,2,140,8,766,0,80
1054,169,2,141,8,774,314,80
1055,169,2,142,8,782,76,80
1056,169,2,143,8,790,109,80
1057,169,2,144,9,799,0,90
1058,169,2,145,7,806,0,70
1059,169,2,146,5,811,236,50
1060,169,2,147,2,813,18,20
1061,169,2,148,3,816,44,30
1062,169,2,149,2,818,0,20
1063,169,2,150,6,824,103,60
1064,169,2,151,3,827,0,30
1065,169,2,152,8,835,110,80
1066,169,2,153,2,837,0,20
1067,169,2,154,7,844,85,70
1068,169,2,155,9,853,0,90
1069,169,2,156,7,860,188,70
1070,169,2,157,3,863,39,30
1071,169,2,158,9,872,0,90
1072,169,2,159,8,880,0,80
1073,169,2,160,7,887,234,70
1074,169,2,161,4,891,42,40
1075,169,2,162,4,895,0,40
1076,169,2,163,6,901,101,60
1077,169,2,164,4,905,37,40
1078,169,2,165,9,914,0,90
1079,169,2,166,2,916,98,20
1080,169,2,167,8,924,0,80
1081,169,2,168,2,926,0,20
1082,169,2,169,5,931,0,50
1083,169,2,170,9,940,0,90
1084,169,2,171,2,942,240,20
1085,169,2,172,2,944,18,20
1086,169,2,173,3,947,0,30
1087,169,2,174,8,955,0,80
1088,169,2,175,2,957,0,20
1089,169,2,176,6,963,0,60
1090,169,2,177,9,972,0,90
1091,169,2,178,3,975,301,30
1092,169,2,179,6,981,0,60
1093,169,2,180,4,985,0,40
1094,169,2,181,9,994,0,90
1095,169,2,182,4,998,0,40
1096,169,2,183,4,1002,286,40
1097,169,2,184,8,1010,0,80
1098,169,2,185,4,1014,110,40
1099,169,2,186,4,1018,30,40
1100,169,2,187,3,1021,33,30
1101,169,2,188,8,1029,88,80
1102,169,2,189,2,1031,0,20
1103,169,2,190,7,1038,94,70
1104,169,2,191,3,1041,0,30
1105,169,2,192,2,1043,0,20
1106,169,2,193,3,1046,87,30
1107,169,2,194,4,1050,41,40
1108,169,2,195,9,1059,90,90
1109,169,2,196,9,1068,0,90
1110,169,2,197,7,1075,0,70
1111,169,2,198,7,1082,233,70
1112,169,2,199,8,1090,76,80
1113,169,2,200,7,1097,0,70
1114,169,2,201,5,1102,131,50
1115,169,2,202,4,1106,0,40
1116,169,2,203,6,1112,103,60
1117,169,2,204,6,1118,0,60
1118,169,2,205,7,1125,118,70
1119,169,2,206,8,1133,85,80
1120,169,2,207,8,1141,77,80
1121,169,2,208,8,1149,82,80
1122,169,2,209,6,1155,58,60
1123,169,2,210,3,1158,0,30
1124,169,2,211,9,1167,144,90
1125,169,2,212,2,1169,0,20
1126,169,2,213,4,1173,62,40
1127,169,2,214,8,1181,60,80
1128,169,2,215,8,1189,0,80
1129,169,2,216,7,1196,157,70
1130,169,2,217,3,1199,29,30
1131,169,2,218,4,1203,0,40
1132,169,2,219,5,1208,0,50
1133,169,2,220,6,1214,0,60
1134,169,2,221,4,1218,189,40
1135,169,2,222,8,1226,0,80
1136,169,2,223,5,1231,137,50
1137,169,2,224,4,1235,53,40
1138,169,2,225,9,1244,86,90
1139,169,2,226,7,1251,78,70
1140,169,2,227,9,1260,0,90
1141,169,2,228,5,1265,0,50
1142,169,2,229,5,1270,0,50
1143,169,2,230,7,1277,0,70
1144,169,2,231,9,1286,0,90
1145,169,2,232,6,1292,410,60
1146,169,2,233,7,1299,0,70
1147,169,2,234,3,1302,95,30
1148,169,2,235,8,1310,72,80
1149,169,2,236,2,1312,0,20
1150,169,2,237,7,1319,99,70
1151,169,2,238,7,1326,0,70
1152,169,2,239,7,1333,158,70
1153,169,2,240,9,1342,95,90
1154,169,2,241,2,1344,0,20
1155,169,2,242,7,1351,100,70
1156,169,2,243,4,1355,0,40
1157,169,2,244,2,1357,0,20
1158,169,2,245,7,1364,0,70
1159,169,2,246,8,1372,0,80
1160,169,2,247,7,1379,310,70
1161,169,2,248,2,1381,0,20
1162,169,2,249,3,1384,0,30
1163,169,2,250,2,1386,62,20
1164,169,2,251,2,1388,15,20
1165,169,2,252,5,1393,0,50
1166,169,2,253,6,1399,123,60
1167,169,2,254,5,1404,37,50
1168,169,2,255,3,1407,0,30
1169,169,2,256,5,1412,93,50
1170,169,2,257,9,1421,0,90
1171,169,2,258,7,1428,0,70
1172,169,2,259,7,1435,0,70
1173,169,2,260,9,1444,336,90
1174,169,2,261,2,1446,0,20
1175,169,2,262,2,1448,0,20
1176,169,2,263,2,1450,0,20
1177,169,2,264,5,1455,0,50
1178,169,2,265,5,1460,145,50
1179,169,2,266,3,1463,39,30
1180,169,2,267,9,1472,72,90
1181,169,2,268,6,1478,0,60
1182,169,2,269,5,1483,0,50
1183,169,2,270,4,1487,0,40
1184,169,2,271,3,1490,195,30
1185,169,2,272,4,1494,0,40
1186,169,2,273,4,1498,80,40
1187,169,2,274,5,1503,42,50
1188,169,2,275,9,1512,90,90
1189,169,2,276,9,1521,0,90
1190,169,2,277,3,1524,0,30
1191,169,2,278,9,1533,188,90
1192,169,2,279,7,1540,0,70
1193,169,2,280,8,1548,0,80
1194,169,2,281,9,1557,0,90
1195,169,2,282,3,1560,0,30
1196,169,2,283,2,1562,0,20
1197,169,2,284,2,1564,298,20
1198,169,2,285,2,1566,14,20
1199,169,2,286,8,1574,0,80
1200,169,2,287,2,1576,0,20
1201,169,2,288,3,1579,134,30
1202,169,2,289,2,1581,23,20
1203,169,2,290,5,1586,0,50
1204,169,2,291,7,1593,0,70
1205,169,2,292,5,1598,153,50
1206,169,2,293,7,1605,58,70
1207,169,2,294,8,1613,0,80
1208,169,2,295,5,1618,129,50
1209,169,2,296,6,1624,0,60
1210,169,2,297,9,1633,155,90
1211,169,2,298,2,1635,0,20
1212,169,2,299,8,1643,0,80
1213,169,2,300,9,1652,182,90
1214,169,2,301,6,1658,62,60
1215,169,2,302,5,1663,42,50
1216,169,2,303,3,1666,27,30
1217,169,2,304,5,1671,0,50
1218,169,2,305,8,1679,127,80
1219,169,2,306,3,1682,0,30
1220,169,2,307,3,1685,53,30
1221,169,2,308,2,1687,19,20
1222,169,2,309,9,1696,0,90
1223,169,2,310,4,1700,0,40
1224,169,2,311,5,1705,191,50
1225,169,2,312,7,1712,0,70
1226,169,2,313,5,1717,109,50
1227,169,2,314,2,1719,17,20
1228,169,2,315,8,1727,0,80
1229,169,2,316,7,1734,154,70
1230,169,2,317,7,1741,0,70
1231,169,2,318,6,1747,137,60
1232,169,2,319,5,1752,0,50
1233,169,2,320,3,1755,89,30
1234,169,2,321,2,1757,0,20
1235,169,2,322,8,1765,98,80
1236,169,2,323,8,1773,87,80
1237,169,2,324,9,1782,0,90
1238,169,2,325,8,1790,0,80
1239,169,2,326,5,1795,253,50
1240,169,2,327,3,1798,0,30
1241,169,2,328,8,1806,0,80
1242,169,2,329,9,1815,210,90
1243,169,2,330,9,1824,85,90
1244,169,2,331,8,1832,76,80
1245,169,2,332,3,1835,0,30
1246,169,2,333,5,1840,90,50
1247,169,2,334,3,1843,25,30
1248,169,2,335,3,1846,0,30
1249,169,2,336,6,1852,92,60
1250,169,2,337,9,1861,94,90
1251,169,2,338,3,1864,25,30
1252,169,2,339,4,1868,0,40
1253,169,2,340,6,1874,0,60
1254,169,2,341,8,1882,186,80
1255,169,2,342,9,1891,0,90
1256,169,2,343,4,1895,0,40
1257,169,2,344,7,1902,0,70
1258,169,2,345,8,1910,276,80
1259,169,2,346,2,1912,19,20
1260,169,2,347,5,1917,0,50
1261,169,2,348,6,1923,114,60
1262,169,2,349,7,1930,65,70
1263,169,2,350,8,1938,60,80
1264,169,2,351,4,1942,34,40
1265,169,2,352,4,1946,42,40
1266,169,2,353,5,1951,0,50
1267,169,2,354,2,1953,0,20
1268,169,2,355,5,1958,0,50
1269,169,2,356,2,1960,0,20
1270,169,2,357,8,1968,0,80
1271,169,2,358,9,1977,0,90
1272,169,2,359,2,1979,0,20
1273,169,2,360,3,1982,0,30
1274,169,2,361,6,1988,413,60
1275,169,2,362,8,1996,67,80
1276,169,2,363,7,2003,66,70
1277,169,2,364,8,2011,0,80
1278,169,2,365,7,2018,171,70
1279,169,2,366,4,2022,39,40
1280,169,2,367,8,2030,80,80
1281,169,2,368,5,2035,0,50
1282,169,2,369,5,2040,102,50
1283,169,2,370,8,2048,74,80
1284,169,2,371,3,2051,16,30
1285,169,2,372,7,2058,72,70
1286,169,2,373,9,2067,0,90
1287,169,2,374,8,2075,185,80
1288,169,2,375,3,2078,33,30
1289,169,2,376,2,2080,27,20
1290,169,2,377,4,2084,48,40
1291,169,2,378,7,2091,0,70
1292,169,2,379,6,2097,0,60
1293,169,2,380,6,2103,187,60
1294,169,2,381,5,2108,0,50
1295,169,2,382,3,2111,73,30
1296,169,2,383,2,2113,23,20
1297,169,2,384,4,2117,0,40
1298,169,2,385,8,2125,106,80
1299,169,2,386,9,2134,0,90
1300,169,2,387,3,2137,119,30
1301,169,2,388,9,2146,0,90
1302,169,2,389,5,2151,0,50
1303,169,2,390,9,2160,0,90
1304,169,2,391,3,2163,254,30
1305,169,2,392,6,2169,61,60
1306,169,2,393,4,2173,49,40
1307,169,2,394,5,2178,40,50
1308,169,2,395,8,2186,0,80
1309,169,2,396,9,2195,169,90
1310,169,2,397,7,2202,71,70
1311,169,2,398,2,2204,16,20
1312,169,2,399,8,2212,74,80
1313,169,2,400,6,2218,54,60
1314,169,2,401,5,2223,49,50
1315,169,2,402,3,2226,29,30
1316,169,2,403,2,2228,0,20
1317,169,2,404,9,2237,0,90
1318,169,2,405,6,2243,162,60
1319,169,2,406,9,2252,97,90
1320,169,2,407,8,2260,0,80
1321,169,2,408,5,2265,0,50
1322,169,2,409,8,2273,0,80
1323,169,2,410,8,2281,282,80
1324,169,2,411,5,2286,0,50
1325,169,2,412,6,2292,109,60
1326,169,2,413,7,2299,0,70
1327,169,2,414,7,2306,138,70
1328,169,2,415,2,2308,22,20
1329,169,2,416,7,2315,0,70
1330,169,2,417,7,2322,0,70
1331,169,2,418,4,2326,165,40
1332,169,2,419,5,2331,0,50
1333,169,2,420,3,2334,0,30
1334,169,2,421,3,2337,0,30
1335,169,2,422,7,2344,0,70
1336,169,2,423,3,2347,214,30
1337,169,2,424,9,2356,98,90
1338,169,2,425,3,2359,0,30
1339,169,2,426,9,2368,0,90
1340,169,2,427,6,2374,165,60
1341,169,2,428,2,2376,13,20
1342,169,2,429,4,2380,0,40
1343,169,2,430,4,2384,0,40
1344,169,2,431,5,2389,0,50
1345,169,2,432,2,2391,0,20
1346,169,2,433,2,2393,0,20
1347,169,2,434,9,2402,0,90
1348,169,2,435,7,2409,338,70
1349,169,2,436,3,2412,0,30
1350,169,2,437,9,2421,0,90
1351,169,2,438,3,2424,0,30
1352,169,2,439,5,2429,197,50
1353,169,2,440,8,2437,60,80
1354,169,2,441,8,2445,0,80
1355,169,2,442,6,2451,0,60
1356,169,2,443,6,2457,0,60
1357,169,2,444,8,2465,296,80
1358,169,2,445,5,2470,0,50
1359,169,2,446,6,2476,129,60
1360,169,2,447,9,2485,0,90
1361,169,2,448,3,2488,0,30
1362,169,2,449,4,2492,0,40
1363,169,2,450,8,2500,255,80
1364,169,2,451,4,2504,0,40
1365,169,2,452,6,2510,103,60
1366,169,2,453,7,2517,76,70
1367,169,2,454,9,2526,0,90
1368,169,2,455,3,2529,0,30
1369,169,2,456,6,2535,0,60
1370,169,2,457,6,2541,0,60
1371,169,2,458,5,2546,0,50
1372,169,2,459,3,2549,312,30
1373,169,2,460,6,2555,63,60
1374,169,2,461,7,2562,73,70
1375,169,2,462,7,2569,59,70
1376,169,2,463,9,2578,88,90
1377,169,2,464,2,2580,0,20
1378,169,2,465,9,2589,0,90
1379,169,2,466,6,2595,177,60
1380,169,2,467,4,2599,0,40
1381,169,2,468,3,2602,0,30
1382,169,2,469,5,2607,124,50
1383,169,2,470,5,2612,51,50
1384,169,2,471,4,2616,39,40
1385,169,2,472,6,2622,0,60
1386,169,2,473,4,2626,94,40
1387,169,2,474,6,2632,0,60
1388,169,2,475,5,2637,126,50
1389,169,2,476,9,2646,0,90
1390,169,2,477,6,2652,0,60
1391,169,2,478,7,2659,0,70
1392,169,2,479,5,2664,252,50
1393,169,2,480,2,2666,24,20
1394,169,2,481,6,2672,0,60
1395,169,2,482,9,2681,134,90
1396,169,2,483,2,2683,0,20
1397,169,2,484,2,2685,0,20
1398,169,2,485,4,2689,71,40
1399,169,2,486,6,2695,0,60
1400,169,2,487,8,2703,128,80
1401,169,2,488,9,2712,84,90
1402,169,2,489,5,2717,44,50
1403,169,2,490,2,2719,0,20
1404,169,2,491,2,2721,46,20
1405,169,2,492,5,2726,56,50
1406,169,2,493,2,2728,24,20
1407,169,2,494,8,2736,73,80
1408,169,2,495,4,2740,0,40
1409,169,2,496,5,2745,0,50
1410,169,2,497,7,2752,170,70
1411,169,2,498,2,2754,22,20
1412,169,2,499,3,2757,0,30
1413,169,2,500,7,2764,100,70
1414,169,2,501,8,2772,0,80
1415,169,2,502,7,2779,144,70
1416,169,2,503,3,2782,23,30
1417,169,2,504,2,2784,0,20
1418,169,2,505,2,2786,43,20
1419,169,2,506,9,2795,0,90
1420,169,2,507,2,2797,115,20
1421,169,2,508,6,2803,50,60
1422,169,2,509,2,2805,21,20
1423,169,2,510,6,2811,50,60
1424,169,2,511,4,2815,45,40
1425,169,2,512,2,2817,0,20
1426,169,2,513,9,2826,103,90
1427,169,2,514,3,2829,0,30
1428,169,2,515,9,2838,0,90
1429,169,2,516,7,2845,196,70
1430,169,2,517,9,2854,100,90
1431,169,2,518,2,2856,0,20
1432,169,2,519,6,2862,75,60
1433,169,2,520,4,2866,0,40
1434,169,2,521,5,2871,93,50
1435,169,2,522,4,2875,36,40
1436,169,2,523,6,2881,0,60
1437,169,2,524,8,2889,145,80
1438,169,2,525,5,2894,0,50
1439,169,2,526,2,2896,75,20
1440,169,2,527,4,2900,0,40
1441,169,2,528,9,2909,128,90
1442,169,2,529,9,2918,82,90
1443,169,2,530,9,2927,0,90
1444,169,2,531,3,2930,126,30
1445,169,2,532,5,2935,45,50
1446,169,2,533,5,2940,0,50
1447,169,2,534,6,2946,119,60
1448,169,2,535,5,2951,0,50
1449,169,2,536,6,2957,128,60
1450,169,2,537,7,2964,72,70
1451,169,2,538,8,2972,71,80
1452,169,2,539,8,2980,0,80
1453,169,2,540,8,2988,168,80
1454,169,2,541,8,2996,0,80
1455,169,2,542,4,3000,0,40
1456,169,2,543,3,3003,163,30
1457,169,2,544,3,3006,29,30
1458,169,2,545,3,3009,35,30
1459,169,2,546,3,3012,0,30
1460,169,2,547,2,3014,49,20
1461,169,2,548,3,3017,0,30
1462,169,2,549,4,3021,0,40
1463,169,2,550,9,3030,137,90
1464,169,2,551,3,3033,30,30
1465,169,2,552,7,3040,0,70
1466,169,2,553,6,3046,128,60
1467,169,2,554,2,3048,23,20
1468,169,2,555,9,3057,0,90
1469,169,2,556,5,3062,150,50
1470,169,2,557,5,3067,62,50
1471,169,2,558,4,3071,0,40
1472,169,2,559,9,3080,124,90
1473,169,2,560,3,3083,0,30
1474,169,2,561,3,3086,0,30
1475,169,2,562,3,3089,0,30
1476,169,2,563,5,3094,0,50
1477,169,2,564,2,3096,148,20
1478,169,2,565,6,3102,60,60
1479,169,2,566,5,3107,0,50
1480,169,2,567,7,3114,130,70
1481,169,2,568,5,3119,0,50
1482,169,2,569,9,3128,150,90
1483,169,2,570,7,3135,63,70
1484,169,2,571,2,3137,27,20
1485,169,2,572,6,3143,0,60
1486,169,2,573,3,3146,0,30
1487,169,2,574,2,3148,0,20
1488,169,2,575,6,3154,161,60
1489,169,2,576,3,3157,0,30
1490,169,2,577,3,3160,72,30
1491,169,2,578,2,3162,0,20
1492,169,2,579,9,3171,0,90
1493,169,2,580,6,3177,164,60
1494,169,2,581,8,3185,85,80
1495,169,2,582,4,3189,45,40
1496,169,2,583,7,3196,55,70
1497,169,2,584,8,3204,0,80
1498,169,2,585,9,3213,154,90
1499,169,2,586,5,3218,0,50
1500,169,2,587,3,3221,71,30
1501,169,2,588,9,3230,85,90
1502,169,2,589,8,3238,72,80
1503,169,2,590,3,3241,30,30
1504,169,2,591,4,3245,45,40
1505,169,2,592,9,3254,91,90
1506,169,2,593,9,3263,0,90
1507,169,2,594,5,3268,132,50
1508,169,2,595,5,3273,0,50
1509,169,2,596,5,3278,96,50
1510,169,2,597,4,3282,37,40
1511,169,2,598,4,3286,36,40
1512,169,2,599,3,3289,0,30
1513,169,2,600,8,3297,107,80
1514,169,2,601,3,3300,38,30
1515,169,2,602,3,3303,36,30
1516,169,2,603,4,3307,30,40
1517,169,2,604,5,3312,62,50
1518,169,2,605,4,3316,0,40
1519,169,2,606,3,3319,0,30
1520,169,2,607,5,3324,0,50
1521,169,2,608,5,3329,0,50
1522,169,2,609,9,3338,0,90
1523,169,2,610,3,3341,328,30
1524,169,2,611,8,3349,63,80
1525,169,2,612,2,3351,21,20
1526,169,2,613,6,3357,69,60
1527,169,2,614,3,3360,0,30
1528,169,2,615,8,3368,111,80
1529,169,2,616,3,3371,0,30
1530,169,2,617,2,3373,0,20
1531,169,2,618,4,3377,0,40
1532,169,2,619,6,3383,0,60
1533,169,2,620,5,3388,209,50
1534,169,2,621,5,3393,52,50
1535,169,2,622,6,3399,0,60
1536,169,2,623,2,3401,68,20
1537,169,2,624,7,3408,0,70
1538,169,2,625,4,3412,105,40
1539,169,2,626,3,3415,0,30
1540,169,2,627,5,3420,72,50
1541,169,2,628,6,3426,64,60
1542,169,2,629,7,3433,0,70
1543,169,2,630,2,3435,85,20
1544,169,2,631,3,3438,0,30
1545,169,2,632,4,3442,0,40
1546,169,2,633,8,3450,0,80
1547,169,2,634,5,3455,0,50
1548,169,2,635,6,3461,0,60
1549,169,2,636,6,3467,0,60
1550,169,2,637,3,3470,0,30
1551,169,2,638,4,3474,0,40
1552,169,2,639,7,3481,472,70
1553,169,2,640,8,3489,0,80
1554,169,2,641,8,3497,0,80
1555,169,2,642,5,3502,0,50
1556,169,2,643,4,3506,0,40
1557,169,2,644,2,3508,0,20
1558,169,2,645,5,3513,298,50
1559,169,2,646,6,3519,0,60
1560,169,2,647,7,3526,0,70
1561,169,2,648,7,3533,215,70
1562,169,2,649,4,3537,46,40
1563,169,2,650,9,3546,106,90
1564,169,2,651,7,3553,59,70
1565,169,2,652,7,3560,0,70
1566,169,2,653,4,3564,0,40
1567,169,2,654,8,3572,200,80
1568,169,2,655,9,3581,0,90
1569,169,2,656,8,3589,168,80
1570,169,2,657,5,3594,0,50
1571,169,2,658,6,3600,115,60
1572,169,2,659,3,3603,32,30
1573,169,2,660,8,3611,69,80
1574,169,2,661,6,3617,56,60
1575,169,2,662,9,3626,89,90
1576,169,2,663,6,3632,60,60
1577,169,2,664,7,3639,0,70
1578,169,2,665,5,3644,147,50
1579,169,2,666,8,3652,75,80
1580,169,2,667,7,3659,75,70
1581,169,2,668,6,3665,0,60
1582,169,2,669,9,3674,148,90
1583,169,2,670,4,3678,0,40
1584,169,2,671,9,3687,0,90
1585,169,2,672,2,3689,138,20
1586,169,2,673,3,3692,23,30
1587,169,2,674,6,3698,0,60
1588,169,2,675,8,3706,0,80
1589,169,2,676,5,3711,224,50
1590,169,2,677,8,3719,0,80
1591,169,2,678,4,3723,106,40
1592,169,2,679,4,3727,0,40
1593,169,2,680,6,3733,0,60
1594,169,2,681,7,3740,0,70
1595,169,2,682,8,3748,269,80
1596,169,2,683,7,3755,78,70
1597,169,2,684,7,3762,68,70
1598,169,2,685,6,3768,0,60
1599,169,2,686,7,3775,125,70
1600,169,2,687,5,3780,48,50
1601,169,2,688,2,3782,15,20
1602,169,2,689,8,3790,0,80
1603,169,2,690,8,3798,164,80
1604,169,2,691,8,3806,78,80
1605,169,2,692,8,3814,0,80
1606,169,2,693,7,3821,161,70
1607,169,2,694,2,3823,0,20
1608,169,2,695,5,3828,0,50
1609,169,2,696,9,3837,0,90
1610,169,2,697,7,3844,235,70
1611,169,2,698,7,3851,0,70
1612,169,2,699,2,3853,79,20
1613,169,2,700,4,3857,38,40
1614,169,2,701,3,3860,0,30
1615,169,2,702,4,3864,80,40
1616,169,2,703,8,3872,86,80
1617,169,2,704,6,3878,51,60
1618,169,2,705,8,3886,0,80
1619,169,2,706,6,3892,0,60
1620,169,2,707,2,3894,154,20
1621,169,2,708,4,3898,0,40
1622,169,2,709,3,3901,0,30
1623,169,2,710,5,3906,0,50
1624,169,2,711,6,3912,0,60
1625,169,2,712,4,3916,223,40
1626,169,2,713,5,3921,50,50
1627,169,2,714,6,3927,64,60
1628,169,2,715,4,3931,33,40
1629,169,2,716,4,3935,33,40
1630,169,2,717,9,3944,84,90
1631,169,2,718,6,3950,44,60
1632,169,2,719,7,3957,61,70
1633,169,2,720,5,3962,0,50
1634,169,2,721,6,3968,102,60
1635,169,2,722,3,3971,0,30
1636,169,2,723,4,3975,0,40
1637,169,2,724,9,3984,0,90
1638,169,2,725,8,3992,263,80
1639,169,2,726,7,3999,0,70
1640,169,2,727,8,4007,167,80
1641,169,2,728,6,4013,0,60
1642,169,2,729,8,4021,143,80
1643,169,2,730,3,4024,32,30
1644,169,2,731,8,4032,93,80
1645,169,2,732,4,4036,0,40
1646,169,2,733,2,4038,50,20
1647,169,2,734,5,4043,46,50
1648,169,2,735,3,4046,38,30
1649,169,2,736,4,4050,33,40
1650,169,2,737,5,4055,57,50
1651,169,2,738,6,4061,0,60
1652,169,2,739,3,4064,0,30
1653,169,2,740,3,4067,0,30
1654,169,2,741,8,4075,198,80
1655,169,2,742,4,4079,0,40
1656,169,2,743,6,4085,0,60
1657,169,2,744,7,4092,0,70
1658,169,2,745,6,4098,0,60
1659,169,2,746,3,4101,0,30
1660,169,2,747,2,4103,306,20
1661,169,2,748,3,4106,0,30
1662,169,2,749,4,4110,0,40
1663,169,2,750,2,4112,0,20
1664,169,2,751,6,4118,0,60
1665,169,2,752,8,4126,0,80
1666,169,2,753,6,4132,0,60
1667,169,2,754,9,4141,0,90
1668,169,2,755,2,4143,0,20
1669,169,2,756,7,4150,0,70
1670,169,2,757,7,4157,539,70
1671,169,2,758,5,4162,0,50
1672,169,2,759,3,4165,0,30
1673,169,2,760,5,4170,143,50
1674,169,2,761,8,4178,68,80
1675,169,2,762,3,4181,0,30
1676,169,2,763,9,4190,0,90
1677,169,2,764,8,4198,184,80
1678,169,2,765,4,4202,41,40
1679,169,2,766,9,4211,0,90
1680,169,2,767,2,4213,112,20
1681,169,2,768,4,4217,0,40
1682,169,2,769,3,4220,71,30
1683,169,2,770,9,4229,95,90
1684,169,2,771,8,4237,87,80
1685,169,2,772,5,4242,56,50
1686,169,2,773,9,4251,81,90
1687,169,2,774,5,4256,0,50
1688,169,2,775,9,4265,137,90
1689,169,2,776,8,4273,0,80
1690,169,2,777,8,4281,0,80
1691,169,2,778,7,4288,228,70
1692,169,2,779,9,4297,104,90
1693,169,2,780,7,4304,0,70
1694,169,2,781,5,4309,114,50
1695,169,2,782,8,4317,88,80
1696,169,2,783,5,4322,60,50
1697,169,2,784,3,4325,0,30
1698,169,2,785,9,4334,0,90
1699,169,2,786,2,4336,0,20
1700,169,2,787,6,4342,0,60
1701,169,2,788,6,4348,269,60
1702,169,2,789,8,4356,0,80
1703,169,2,790,6,4362,0,60
1704,169,2,791,6,4368,174,60
1705,169,2,792,6,4374,52,60
1706,169,2,793,5,4379,67,50
1707,169,2,794,7,4386,82,70
1708,169,2,795,2,4388,0,20
1709,169,2,796,9,4397,0,90
1710,169,2,797,6,4403,174,60
1711,169,2,798,4,4407,40,40
1712,169,2,799,6,4413,56,60
1713,169,2,800,7,4420,0,70
1714,169,2,801,5,4425,0,50
1715,169,2,802,6,4431,0,60
1716,169,2,803,5,4436,0,50
1717,169,2,804,5,4441,302,50
1718,169,2,805,2,4443,21,20
1719,169,2,806,4,4447,41,40
1720,169,2,807,2,4449,0,20
1721,169,2,808,9,4458,106,90
1722,169,2,809,4,4462,0,40
1723,169,2,810,5,4467,96,50
1724,169,2,811,4,4471,40,40
1725,169,2,812,7,4478,71,70
1726,169,2,813,6,4484,59,60
1727,169,2,814,3,4487,0,30
1728,169,2,815,5,4492,0,50
1729,169,2,816,4,4496,0,40
1730,169,2,817,5,4501,178,50
1731,169,2,818,3,4504,0,30
1732,169,2,819,6,4510,0,60
1733,169,2,820,9,4519,0,90
1734,169,2,821,4,4523,0,40
1735,169,2,822,9,4532,286,90
1736,169,2,823,8,4540,0,80
1737,169,2,824,6,4546,0,60
1738,169,2,825,3,4549,0,30
1739,169,2,826,4,4553,174,40
1740,169,2,827,3,4556,0,30
1741,169,2,828,4,4560,0,40
1742,169,2,829,7,4567,0,70
1743,169,2,830,9,4576,230,90
1744,169,2,831,6,4582,0,60
1745,169,2,832,6,4588,0,60
1746,169,2,833,3,4591,152,30
1747,169,2,834,6,4597,59,60
1748,169,2,835,3,4600,0,30
1749,169,2,836,7,4607,106,70
1750,169,2,837,3,4610,31,30
1751,169,2,838,8,4618,71,80
1752,169,2,839,8,4626,61,80
1753,169,2,840,9,4635,0,90
1754,169,2,841,7,4642,145,70
1755,169,2,842,8,4650,0,80
1756,169,2,843,2,4652,109,20
1757,169,2,844,9,4661,85,90
1758,169,2,845,6,4667,0,60
1759,169,2,846,5,4672,0,50
1760,169,2,847,7,4679,176,70
1761,169,2,848,9,4688,92,90
1762,169,2,849,3,4691,36,30
1763,169,2,850,6,4697,57,60
1764,169,2,851,6,4703,0,60
1765,169,2,852,5,4708,105,50
1766,169,2,853,3,4711,31,30
1767,169,2,854,5,4716,61,50
1768,169,2,855,7,4723,60,70
1769,169,2,856,4,4727,0,40
1770,169,2,857,8,4735,119,80
1771,169,2,858,6,4741,59,60
1772,169,2,859,6,4747,61,60
1773,169,2,860,7,4754,73,70
1774,169,2,861,7,4761,67,70
1775,169,2,862,7,4768,70,70
1776,169,2,863,4,4772,0,40
1777,169,2,864,7,4779,0,70
1778,169,2,865,2,4781,0,20
1779,169,2,866,4,4785,0,40
1780,169,2,867,4,4789,205,40
1781,169,2,868,9,4798,87,90
1782,169,2,869,5,4803,51,50
1783,169,2,870,4,4807,0,40
1784,169,2,871,2,4809,58,20
1785,169,2,872,5,4814,0,50
1786,169,2,873,2,4816,0,20
1787,169,2,874,2,4818,76,20
1788,169,2,875,2,4820,26,20
1789,169,2,876,6,4826,0,60
1790,169,2,877,3,4829,111,30
1791,169,2,878,3,4832,26,30
1792,169,2,879,8,4840,77,80
1793,169,2,880,2,4842,0,20
1794,169,2,881,2,4844,45,20
1795,169,2,882,7,4851,74,70
1796,169,2,883,5,4856,0,50
1797,169,2,884,3,4859,0,30
1798,169,2,885,9,4868,162,90
1799,169,2,886,6,4874,61,60
1800,169,2,887,3,4877,32,30
1801,169,2,888,4,4881,0,40
1802,169,2,889,8,4889,137,80
1803,169,2,890,5,4894,0,50
1804,169,2,891,4,4898,0,40
1805,169,2,892,5,4903,151,50
1806,169,2,893,5,4908,0,50
1807,169,2,894,5,4913,104,50
1808,169,2,895,9,4922,79,90
1809,169,2,896,8,4930,84,80
1810,169,2,897,4,4934,0,40
1811,169,2,898,8,4942,115,80
1812,169,2,899,6,4948,56,60
1813,169,2,900,6,4954,65,60
1814,169,2,901,6,4960,0,60
1815,169,2,902,4,4964,83,40
1816,169,2,903,4,4968,37,40
1817,169,2,904,5,4973,53,50
1818,169,2,905,9,4982,0,90
1819,169,2,906,4,4986,110,40
1820,169,2,907,8,4994,81,80
1821,169,3,1,8,8,75,80
1822,169,3,2,8,16,76,80
1823,169,3,3,6,22,0,60
1824,169,3,4,5,27,123,50
1825,169,3,5,4,31,45,40
1826,169,3,6,6,37,47,60
1827,169,3,7,3,40,31,30
1828,169,3,8,5,45,47,50
1829,169,3,9,8,53,0,80
1830,169,3,10,4,57,122,40
1831,169,3,11,7,64,74,70
1832,169,3,12,9,73,82,90
1833,169,3,13,4,77,0,40
1834,169,3,14,6,83,102,60
1835,169,3,15,7,90,0,70
1836,169,3,16,3,93,102,30
1837,169,3,17,9,102,95,90
1838,169,3,18,2,104,0,20
1839,169,3,19,9,113,0,90
1840,169,3,20,3,116,141,30
1841,169,3,21,3,119,28,30
1842,169,3,22,4,123,37,40
1843,169,3,23,7,130,0,70
1844,169,3,24,8,138,161,80
1845,169,3,25,6,144,0,60
1846,169,3,26,6,150,121,60
1847,169,3,27,3,153,28,30
1848,169,3,28,2,155,0,20
1849,169,3,29,9,164,118,90
1850,169,3,30,3,167,0,30
1851,169,3,31,8,175,118,80
1852,169,3,32,6,181,61,60
1853,169,3,33,5,186,47,50
1854,169,3,34,3,189,0,30
1855,169,3,35,5,194,93,50
1856,169,3,36,3,197,32,30
1857,169,3,37,3,200,30,30
1858,169,3,38,6,206,0,60
1859,169,3,39,4,210,0,40
1860,169,3,40,4,214,126,40
1861,169,3,41,2,216,15,20
1862,169,3,42,5,221,51,50
1863,169,3,43,7,228,0,70
1864,169,3,44,2,230,108,20
1865,169,3,45,6,236,0,60
1866,169,3,46,5,241,0,50
1867,169,3,47,7,248,0,70
1868,169,3,48,2,250,212,20
1869,169,3,49,2,252,19,20
1870,169,3,50,6,258,0,60
1871,169,3,51,7,265,131,70
1872,169,3,52,5,270,49,50
1873,169,3,53,7,277,67,70
1874,169,3,54,7,284,0,70
1875,169,3,55,4,288,108,40
1876,169,3,56,9,297,79,90
1877,169,3,57,8,305,69,80
1878,169,3,58,9,314,95,90
1879,169,3,59,2,316,0,20
1880,169,3,60,3,319,0,30
1881,169,3,61,5,324,106,50
1882,169,3,62,4,328,0,40
1883,169,3,63,4,332,0,40
1884,169,3,64,2,334,92,20
1885,169,3,65,7,341,0,70
1886,169,3,66,4,345,0,40
1887,169,3,67,9,354,0,90
1888,169,3,68,5,359,0,50
1889,169,3,69,8,367,359,80
1890,169,3,70,4,371,37,40
1891,169,3,71,8,379,0,80
1892,169,3,72,4,383,0,40
1893,169,3,73,8,391,0,80
1894,169,3,74,4,395,245,40
1895,169,3,75,4,399,0,40
1896,169,3,76,2,401,0,20
1897,169,3,77,5,406,99,50
1898,169,3,78,3,409,39,30
1899,169,3,79,9,418,82,90
1900,169,3,80,8,426,0,80
1901,169,3,81,7,433,0,70
1902,169,3,82,6,439,212,60
1903,169,3,83,7,446,73,70
1904,169,3,84,4,450,44,40
1905,169,3,85,3,453,27,30
1906,169,3,86,7,460,75,70
1907,169,3,87,2,462,0,20
1908,169,3,88,3,465,0,30
1909,169,3,89,9,474,145,90
1910,169,3,90,6,480,54,60
1911,169,3,91,7,487,92,70
1912,169,3,92,7,494,75,70
1913,169,3,93,5,499,45,50
1914,169,3,94,9,508,0,90
1915,169,3,95,2,510,120,20
1916,169,3,96,6,516,67,60
1917,169,3,97,3,519,28,30
1918,169,3,98,5,524,0,50
1919,169,3,99,3,527,72,30
1920,169,3,100,5,532,49,50
1921,169,3,101,9,541,0,90
1922,169,3,102,4,545,0,40
1923,169,3,103,4,549,188,40
1924,169,3,104,3,552,0,30
1925,169,3,105,4,556,79,40
1926,169,3,106,2,558,23,20
1927,169,3,107,9,567,0,90
1928,169,3,108,3,570,128,30
1929,169,3,109,8,578,75,80
1930,169,3,110,5,583,0,50
1931,169,3,111,3,586,0,30
1932,169,3,112,7,593,152,70
1933,169,3,113,9,602,0,90
1934,169,3,114,6,608,152,60
1935,169,3,115,4,612,0,40
1936,169,3,116,4,616,0,40
1937,169,3,117,8,624,0,80
1938,169,3,118,3,627,194,30
1939,169,3,119,9,636,0,90
1940,169,3,120,9,645,0,90
1941,169,3,121,7,652,264,70
1942,169,3,122,7,659,69,70
1943,169,3,123,9,668,102,90
1944,169,3,124,6,674,0,60
1945,169,3,125,3,677,0,30
1946,169,3,126,2,679,0,20
1947,169,3,127,6,685,0,60
1948,169,3,128,4,689,0,40
1949,169,3,129,8,697,258,80
1950,169,3,130,8,705,80,80
1951,169,3,131,3,708,48,30
1952,169,3,132,8,716,0,80
1953,169,3,133,4,720,0,40
1954,169,3,134,8,728,211,80
1955,169,3,135,9,737,89,90
1956,169,3,136,2,739,0,20
1957,169,3,137,4,743,0,40
1958,169,3,138,7,750,125,70
1959,169,3,139,8,758,0,80
1960,169,3,140,8,766,0,80
1961,169,3,141,9,775,245,90
1962,169,3,142,7,782,0,70
1963,169,3,143,5,787,127,50
1964,169,3,144,2,789,18,20
1965,169,3,145,8,797,83,80
1966,169,3,146,4,801,47,40
1967,169,3,147,2,803,19,20
1968,169,3,148,5,808,45,50
1969,169,3,149,3,811,20,30
1970,169,3,150,4,815,0,40
1971,169,3,151,7,822,111,70
1972,169,3,152,2,824,0,20
1973,169,3,153,4,828,0,40
1974,169,3,154,7,835,0,70
1975,169,3,155,4,839,0,40
1976,169,3,156,7,846,225,70
1977,169,3,157,2,848,23,20
1978,169,3,158,8,856,0,80
1979,169,3,159,7,863,0,70
1980,169,3,160,9,872,253,90
1981,169,3,161,4,876,38,40
1982,169,3,162,2,878,0,20
1983,169,3,163,2,880,0,20
1984,169,3,164,4,884,71,40
1985,169,3,165,5,889,68,50
1986,169,3,166,7,896,75,70
1987,169,3,167,6,902,54,60
1988,169,3,168,5,907,51,50
1989,169,3,169,3,910,27,30
1990,169,3,170,7,917,70,70
1991,169,3,171,8,925,79,80
1992,169,3,172,9,934,93,90
1993,169,3,173,7,941,76,70
1994,169,3,174,5,946,38,50
1995,169,3,175,7,953,67,70
1996,169,3,176,8,961,0,80
1997,169,3,177,9,970,158,90
1998,169,3,178,5,975,0,50
1999,169,3,179,2,977,0,20
2000,169,3,180,9,986,0,90
2001,169,3,181,7,993,0,70
2002,169,3,182,3,996,281,30
2003,169,3,183,8,1004,0,80
2004,169,3,184,9,1013,158,90
2005,169,3,185,6,1019,50,60
2006,169,3,186,8,1027,0,80
2007,169,3,187,2,1029,115,20
2008,169,3,188,3,1032,0,30
2009,169,3,189,5,1037,0,50
2010,169,3,190,6,1043,138,60
2011,169,3,191,7,1050,68,70
2012,169,3,192,9,1059,0,90
2013,169,3,193,6,1065,0,60
2014,169,3,194,7,1072,0,70
2015,169,3,195,7,1079,297,70
2016,169,3,196,8,1087,72,80
2017,169,3,197,6,1093,53,60
2018,169,3,198,4,1097,0,40
2019,169,3,199,7,1104,110,70
2020,169,3,200,8,1112,0,80
2021,169,3,201,4,1116,111,40
2022,169,3,202,8,1124,80,80
2023,169,3,203,8,1132,73,80
2024,169,3,204,5,1137,54,50
2025,169,3,205,2,1139,10,20
2026,169,3,206,5,1144,0,50
2027,169,3,207,9,1153,0,90
2028,169,3,208,4,1157,185,40
2029,169,3,209,4,1161,42,40
2030,169,3,210,5,1166,61,50
2031,169,3,211,4,1170,42,40
2032,169,3,212,8,1178,89,80
2033,169,3,213,8,1186,85,80
2034,169,3,214,2,1188,0,20
2035,169,3,215,8,1196,103,80
2036,169,3,216,3,1199,26,30
2037,169,3,217,6,1205,69,60
2038,169,3,218,3,1208,27,30
2039,169,3,219,4,1212,0,40
2040,169,3,220,6,1218,93,60
2041,169,3,221,4,1222,41,40
2042,169,3,222,2,1224,0,20
2043,169,3,223,4,1228,0,40
2044,169,3,224,5,1233,116,50
2045,169,3,225,7,1240,67,70
2046,169,3,226,6,1246,40,60
2047,169,3,227,4,1250,0,40
2048,169,3,228,4,1254,84,40
2049,169,3,229,6,1260,0,60
2050,169,3,230,9,1269,0,90
2051,169,3,231,5,1274,187,50
2052,169,3,232,8,1282,0,80
2053,169,3,233,2,1284,92,20
2054,169,3,234,4,1288,0,40
2055,169,3,235,3,1291,81,30
2056,169,3,236,4,1295,35,40
2057,169,3,237,5,1300,54,50
2058,169,3,238,8,1308,0,80
2059,169,3,239,5,1313,133,50
2060,169,3,240,9,1322,72,90
2061,169,3,241,8,1330,0,80
2062,169,3,242,3,1333,115,30
2063,169,3,243,6,1339,0,60
2064,169,3,244,6,1345,0,60
2065,169,3,245,6,1351,160,60
2066,169,3,246,7,1358,64,70
2067,169,3,247,5,1363,0,50
2068,169,3,248,2,1365,79,20
2069,169,3,249,5,1370,51,50
2070,169,3,250,8,1378,0,80
2071,169,3,251,9,1387,173,90
2072,169,3,252,8,1395,78,80
2073,169,3,253,6,1401,73,60
2074,169,3,254,3,1404,0,30
2075,169,3,255,8,1412,98,80
2076,169,3,256,3,1415,0,30
2077,169,3,257,4,1419,56,40
2078,169,3,258,6,1425,0,60
2079,169,3,259,5,1430,115,50
2080,169,3,260,3,1433,29,30
2081,169,3,261,8,1441,82,80
2082,169,3,262,6,1447,0,60
2083,169,3,263,5,1452,105,50
2084,169,3,264,5,1457,0,50
2085,169,3,265,2,1459,66,20
2086,169,3,266,7,1466,76,70
2087,169,3,267,7,1473,67,70
2088,169,3,268,6,1479,0,60
2089,169,3,269,4,1483,0,40
2090,169,3,270,8,1491,0,80
2091,169,3,271,7,1498,0,70
2092,169,3,272,9,1507,328,90
2093,169,3,273,4,1511,38,40
2094,169,3,274,9,1520,96,90
2095,169,3,275,2,1522,15,20
2096,169,3,276,7,1529,0,70
2097,169,3,277,3,1532,113,30
2098,169,3,278,4,1536,40,40
2099,169,3,279,3,1539,42,30
2100,169,3,280,8,1547,76,80
2101,169,3,281,9,1556,0,90
2102,169,3,282,2,1558,105,20
2103,169,3,283,3,1561,0,30
2104,169,3,284,3,1564,64,30
2105,169,3,285,4,1568,0,40
2106,169,3,286,9,1577,0,90
2107,169,3,287,4,1581,157,40
2108,169,3,288,8,1589,0,80
2109,169,3,289,6,1595,137,60
2110,169,3,290,5,1600,0,50
2111,169,3,291,6,1606,112,60
2112,169,3,292,5,1611,51,50
2113,169,3,293,8,1619,0,80
2114,169,3,294,9,1628,181,90
2115,169,3,295,5,1633,56,50
2116,169,3,296,9,1642,0,90
2117,169,3,297,7,1649,0,70
2118,169,3,298,8,1657,231,80
2119,169,3,299,6,1663,68,60
2120,169,3,300,3,1666,0,30
2121,169,3,301,9,1675,140,90
2122,169,3,302,8,1683,73,80
2123,169,3,303,5,1688,56,50
2124,169,3,304,3,1691,0,30
2125,169,3,305,8,1699,0,80
2126,169,3,306,4,1703,157,40
2127,169,3,307,4,1707,38,40
2128,169,3,308,9,1716,0,90
2129,169,3,309,6,1722,0,60
2130,169,3,310,3,1725,176,30
2131,169,3,311,6,1731,0,60
2132,169,3,312,2,1733,84,20
2133,169,3,313,5,1738,43,50
2134,169,3,314,6,1744,0,60
2135,169,3,315,7,1751,0,70
2136,169,3,316,8,1759,0,80
2137,169,3,317,7,1766,269,70
2138,169,3,318,5,1771,48,50
2139,169,3,319,7,1778,0,70
2140,169,3,320,3,1781,0,30
2141,169,3,321,7,1788,159,70
2142,169,3,322,3,1791,0,30
2143,169,3,323,6,1797,79,60
2144,169,3,324,6,1803,0,60
2145,169,3,325,5,1808,106,50
2146,169,3,326,8,1816,0,80
2147,169,3,327,8,1824,0,80
2148,169,3,328,5,1829,222,50
2149,169,3,329,5,1834,39,50
2150,169,3,330,2,1836,0,20
2151,169,3,331,5,1841,0,50
2152,169,3,332,8,1849,151,80
2153,169,3,333,3,1852,35,30
2154,169,3,334,8,1860,0,80
2155,169,3,335,5,1865,0,50
2156,169,3,336,7,1872,0,70
2157,169,3,337,4,1876,0,40
2158,169,3,338,5,1881,310,50
2159,169,3,339,9,1890,90,90
2160,169,3,340,3,1893,37,30
2161,169,3,341,5,1898,0,50
2162,169,3,342,3,1901,0,30
2163,169,3,343,9,1910,180,90
2164,169,3,344,6,1916,58,60
2165,169,3,345,8,1924,72,80
2166,169,3,346,5,1929,51,50
2167,169,3,347,4,1933,45,40
2168,169,3,348,5,1938,52,50
2169,169,3,349,4,1942,33,40
2170,169,3,350,3,1945,29,30
2171,169,3,351,7,1952,66,70
2172,169,3,352,9,1961,103,90
2173,169,3,353,4,1965,0,40
2174,169,3,354,7,1972,0,70
2175,169,3,355,4,1976,0,40
2176,169,3,356,2,1978,0,20
2177,169,3,357,8,1986,0,80
2178,169,3,358,8,1994,0,80
2179,169,3,359,3,1997,342,30
2180,169,3,360,3,2000,0,30
2181,169,3,361,8,2008,118,80
2182,169,3,362,8,2016,74,80
2183,169,3,363,5,2021,41,50
2184,169,3,364,4,2025,38,40
2185,169,3,365,5,2030,0,50
2186,169,3,366,9,2039,0,90
2187,169,3,367,9,2048,230,90
2188,169,3,368,2,2050,0,20
2189,169,3,369,9,2059,0,90
2190,169,3,370,5,2064,163,50
2191,169,3,371,5,2069,42,50
2192,169,3,372,5,2074,58,50
2193,169,3,373,8,2082,0,80
2194,169,3,374,4,2086,102,40
2195,169,3,375,8,2094,65,80
2196,169,3,376,3,2097,0,30
2197,169,3,377,7,2104,0,70
2198,169,3,378,4,2108,0,40
2199,169,3,379,5,2113,182,50
2200,169,3,380,9,2122,84,90
2201,169,3,381,2,2124,0,20
2202,169,3,382,8,2132,94,80
2203,169,3,383,9,2141,0,90
2204,169,3,384,6,2147,0,60
2205,169,3,385,2,2149,0,20
2206,169,3,386,6,2155,0,60
2207,169,3,387,7,2162,326,70
2208,169,3,388,8,2170,0,80
2209,169,3,389,3,2173,109,30
2210,169,3,390,7,2180,88,70
2211,169,3,391,5,2185,57,50
2212,169,3,392,9,2194,93,90
2213,169,3,393,6,2200,57,60
2214,169,3,394,9,2209,85,90
2215,169,3,395,3,2212,0,30
2216,169,3,396,6,2218,0,60
2217,169,3,397,4,2222,117,40
2218,169,3,398,6,2228,0,60
2219,169,3,399,6,2234,0,60
2220,169,3,400,5,2239,0,50
2221,169,3,401,9,2248,0,90
2222,169,3,402,2,2250,295,20
2223,169,3,403,2,2252,0,20
2224,169,3,404,9,2261,87,90
2225,169,3,405,9,2270,92,90
2226,169,3,406,4,2274,43,40
2227,169,3,407,7,2281,54,70
2228,169,3,408,7,2288,86,70
2229,169,3,409,5,2293,42,50
2230,169,3,410,5,2298,43,50
2231,169,3,411,9,2307,109,90
2232,169,3,412,6,2313,61,60
2233,169,3,413,3,2316,27,30
2234,169,3,414,9,2325,94,90
2235,169,3,415,2,2327,24,20
2236,169,3,416,2,2329,14,20
2237,169,3,417,3,2332,27,30
2238,169,3,418,2,2334,0,20
2239,169,3,419,5,2339,0,50
2240,169,3,420,8,2347,0,80
2241,169,3,421,5,2352,196,50
2242,169,3,422,6,2358,56,60
2243,169,3,423,7,2365,0,70
2244,169,3,424,2,2367,98,20
2245,169,3,425,8,2375,101,80
2246,169,3,426,8,2383,82,80
2247,169,3,427,4,2387,46,40
2248,169,3,428,5,2392,0,50
2249,169,3,429,7,2399,0,70
2250,169,3,430,5,2404,0,50
2251,169,3,431,8,2412,0,80
2252,169,3,432,3,2415,0,30
2253,169,3,433,6,2421,329,60
2254,169,3,434,7,2428,0,70
2255,169,3,435,3,2431,95,30
2256,169,3,436,7,2438,0,70
2257,169,3,437,4,2442,122,40
2258,169,3,438,2,2444,28,20
2259,169,3,439,6,2450,58,60
2260,169,3,440,5,2455,0,50
2261,169,3,441,3,2458,0,30
2262,169,3,442,2,2460,97,20
2263,169,3,443,2,2462,0,20
2264,169,3,444,9,2471,94,90
2265,169,3,445,2,2473,23,20
2266,169,3,446,2,2475,0,20
2267,169,3,447,4,2479,45,40
2268,169,3,448,3,2482,26,30
2269,169,3,449,3,2485,23,30
2270,169,3,450,7,2492,0,70
2271,169,3,451,7,2499,0,70
2272,169,3,452,4,2503,0,40
2273,169,3,453,7,2510,0,70
2274,169,3,454,2,2512,263,20
2275,169,3,455,4,2516,45,40
2276,169,3,456,7,2523,0,70
2277,169,3,457,3,2526,0,30
2278,169,3,458,2,2528,0,20
2279,169,3,459,4,2532,0,40
2280,169,3,460,2,2534,0,20
2281,169,3,461,4,2538,0,40
2282,169,3,462,4,2542,0,40
2283,169,3,463,8,2550,0,80
2284,169,3,464,3,2553,348,30
2285,169,3,465,6,2559,57,60
2286,169,3,466,5,2564,60,50
2287,169,3,467,8,2572,0,80
2288,169,3,468,8,2580,0,80
2289,169,3,469,2,2582,183,20
2290,169,3,470,8,2590,0,80
2291,169,3,471,3,2593,107,30
2292,169,3,472,9,2602,87,90
2293,169,3,473,7,2609,60,70
2294,169,3,474,8,2617,0,80
2295,169,3,475,3,2620,0,30
2296,169,3,476,2,2622,0,20
2297,169,3,477,4,2626,144,40
2298,169,3,478,5,2631,0,50
2299,169,3,479,9,2640,0,90
2300,169,3,480,7,2647,0,70
2301,169,3,481,7,2654,0,70
2302,169,3,482,2,2656,290,20
2303,169,3,483,4,2660,47,40
2304,169,3,484,9,2669,88,90
2305,169,3,485,8,2677,0,80
2306,169,3,486,9,2686,169,90
2307,169,3,487,5,2691,48,50
2308,169,3,488,2,2693,0,20
2309,169,3,489,3,2696,44,30
2310,169,3,490,5,2701,0,50
2311,169,3,491,6,2707,0,60
2312,169,3,492,8,2715,0,80
2313,169,3,493,8,2723,0,80
2314,169,3,494,8,2731,0,80
2315,169,3,495,3,2734,380,30
2316,169,3,496,8,2742,83,80
2317,169,3,497,6,2748,61,60
2318,169,3,498,4,2752,43,40
2319,169,3,499,7,2759,0,70
2320,169,3,500,7,2766,134,70
2321,169,3,501,4,2770,0,40
2322,169,3,502,2,2772,0,20
2323,169,3,503,6,2778,0,60
2324,169,3,504,5,2783,0,50
2325,169,3,505,2,2785,182,20
2326,169,3,506,4,2789,44,40
2327,169,3,507,7,2796,0,70
2328,169,3,508,5,2801,108,50
2329,169,3,509,3,2804,0,30
2330,169,3,510,4,2808,81,40
2331,169,3,511,7,2815,76,70
2332,169,3,512,4,2819,33,40
2333,169,3,513,9,2828,79,90
2334,169,3,514,9,2837,93,90
2335,169,3,515,7,2844,70,70
2336,169,3,516,8,2852,0,80
2337,169,3,517,7,2859,164,70
2338,169,3,518,5,2864,0,50
2339,169,3,519,4,2868,0,40
2340,169,3,520,6,2874,145,60
2341,169,3,521,9,2883,0,90
2342,169,3,522,4,2887,0,40
2343,169,3,523,8,2895,244,80
2344,169,3,524,9,2904,0,90
2345,169,3,525,2,2906,0,20
2346,169,3,526,4,2910,151,40
2347,169,3,527,3,2913,0,30
2348,169,3,528,8,2921,112,80
2349,169,3,529,3,2924,30,30
2350,169,3,530,2,2926,20,20
2351,169,3,531,2,2928,14,20
2352,169,3,532,5,2933,44,50
2353,169,3,533,7,2940,82,70
2354,169,3,534,2,2942,0,20
2355,169,3,535,3,2945,0,30
2356,169,3,536,3,2948,96,30
2357,169,3,537,9,2957,0,90
2358,169,3,538,6,2963,172,60
2359,169,3,539,9,2972,0,90
2360,169,3,540,8,2980,167,80
2361,169,3,541,4,2984,37,40
2362,169,3,542,2,2986,15,20
2363,169,3,543,6,2992,57,60
2364,169,3,544,5,2997,0,50
2365,169,3,545,9,3006,0,90
2366,169,3,546,9,3015,216,90
2367,169,3,547,3,3018,29,30
2368,169,3,548,5,3023,47,50
2369,169,3,549,6,3029,63,60
2370,169,3,550,8,3037,71,80
2371,169,3,551,9,3046,87,90
2372,169,3,552,7,3053,0,70
2373,169,3,553,5,3058,131,50
2374,169,3,554,8,3066,0,80
2375,169,3,555,5,3071,133,50
2376,169,3,556,2,3073,20,20
2377,169,3,557,6,3079,56,60
2378,169,3,558,9,3088,79,90
2379,169,3,559,5,3093,56,50
2380,169,3,560,8,3101,95,80
2381,169,3,561,7,3108,0,70
2382,169,3,562,3,3111,0,30
2383,169,3,563,5,3116,0,50
2384,169,3,564,2,3118,173,20
2385,169,3,565,3,3121,27,30
2386,169,3,566,9,3130,0,90
2387,169,3,567,2,3132,103,20
2388,169,3,568,9,3141,0,90
2389,169,3,569,8,3149,0,80
2390,169,3,570,4,3153,0,40
2391,169,3,571,5,3158,0,50
2392,169,3,572,6,3164,0,60
2393,169,3,573,4,3168,0,40
2394,169,3,574,9,3177,455,90
2395,169,3,575,8,3185,0,80
2396,169,3,576,2,3187,92,20
2397,169,3,577,5,3192,46,50
2398,169,3,578,4,3196,0,40
2399,169,3,579,5,3201,94,50
2400,169,3,580,3,3204,28,30
2401,169,3,581,6,3210,0,60
2402,169,3,582,8,3218,135,80
2403,169,3,583,3,3221,28,30
2404,169,3,584,4,3225,0,40
2405,169,3,585,7,3232,0,70
2406,169,3,586,7,3239,183,70
2407,169,3,587,9,3248,0,90
2408,169,3,588,9,3257,154,90
2409,169,3,589,2,3259,21,20
2410,169,3,590,6,3265,0,60
2411,169,3,591,9,3274,156,90
2412,169,3,592,2,3276,0,20
2413,169,3,593,3,3279,0,30
2414,169,3,594,5,3284,84,50
2415,169,3,595,2,3286,19,20
2416,169,3,596,6,3292,0,60
2417,169,3,597,3,3295,0,30
2418,169,3,598,3,3298,0,30
2419,169,3,599,3,3301,0,30
2420,169,3,600,4,3305,0,40
2421,169,3,601,9,3314,301,90
2422,169,3,602,9,3323,90,90
2423,169,3,603,5,3328,0,50
2424,169,3,604,2,3330,0,20
2425,169,3,605,4,3334,107,40
2426,169,3,606,5,3339,0,50
2427,169,3,607,9,3348,141,90
2428,169,3,608,6,3354,0,60
2429,169,3,609,5,3359,0,50
2430,169,3,610,9,3368,207,90
2431,169,3,611,8,3376,0,80
2432,169,3,612,7,3383,0,70
2433,169,3,613,3,3386,0,30
2434,169,3,614,2,3388,0,20
2435,169,3,615,3,3391,0,30
2436,169,3,616,3,3394,0,30
2437,169,3,617,7,3401,0,70
2438,169,3,618,9,3410,380,90
2439,169,3,619,2,3412,23,20
2440,169,3,620,5,3417,0,50
2441,169,3,621,9,3426,0,90
2442,169,3,622,4,3430,0,40
2443,169,3,623,8,3438,270,80
2444,169,3,624,7,3445,0,70
2445,169,3,625,9,3454,167,90
2446,169,3,626,5,3459,55,50
2447,169,3,627,9,3468,86,90
2448,169,3,628,4,3472,50,40
2449,169,3,629,3,3475,36,30
2450,169,3,630,5,3480,47,50
2451,169,3,631,7,3487,0,70
2452,169,3,632,7,3494,0,70
2453,169,3,633,9,3503,239,90
2454,169,3,634,3,3506,35,30
2455,169,3,635,3,3509,0,30
2456,169,3,636,8,3517,98,80
2457,169,3,637,9,3526,92,90
2458,169,3,638,3,3529,36,30
2459,169,3,639,9,3538,97,90
2460,169,3,640,6,3544,0,60
2461,169,3,641,6,3550,113,60
2462,169,3,642,8,3558,0,80
2463,169,3,643,7,3565,138,70
2464,169,3,644,6,3571,72,60
2465,169,3,645,9,3580,0,90
2466,169,3,646,6,3586,141,60
2467,169,3,647,3,3589,29,30
2468,169,3,648,5,3594,45,50
2469,169,3,649,5,3599,0,50
2470,169,3,650,5,3604,95,50
2471,169,3,651,9,3613,89,90
2472,169,3,652,5,3618,0,50
2473,169,3,653,2,3620,70,20
2474,169,3,654,4,3624,0,40
2475,169,3,655,8,3632,139,80
2476,169,3,656,5,3637,53,50
2477,169,3,657,9,3646,89,90
2478,169,3,658,6,3652,0,60
2479,169,3,659,7,3659,159,70
2480,169,3,660,3,3662,0,30
2481,169,3,661,2,3664,0,20
2482,169,3,662,9,3673,0,90
2483,169,3,663,3,3676,0,30
2484,169,3,664,5,3681,0,50
2485,169,3,665,8,3689,302,80
2486,169,3,666,8,3697,0,80
2487,169,3,667,2,3699,0,20
2488,169,3,668,6,3705,0,60
2489,169,3,669,7,3712,219,70
2490,169,3,670,8,3720,82,80
2491,169,3,671,8,3728,80,80
2492,169,3,672,7,3735,77,70
2493,169,3,673,7,3742,0,70
2494,169,3,674,8,3750,138,80
2495,169,3,675,2,3752,27,20
2496,169,3,676,4,3756,0,40
2497,169,3,677,9,3765,0,90
2498,169,3,678,2,3767,132,20
2499,169,3,679,7,3774,0,70
2500,169,3,680,6,3780,132,60
2501,169,3,681,6,3786,68,60
2502,169,3,682,6,3792,65,60
2503,169,3,683,7,3799,70,70
2504,169,3,684,2,3801,20,20
2505,169,3,685,3,3804,36,30
2506,169,3,686,9,3813,0,90
2507,169,3,687,8,3821,0,80
2508,169,3,688,8,3829,258,80
2509,169,3,689,4,3833,42,40
2510,169,3,690,5,3838,0,50
2511,169,3,691,4,3842,0,40
2512,169,3,692,3,3845,0,30
2513,169,3,693,7,3852,0,70
2514,169,3,694,8,3860,0,80
2515,169,3,695,6,3866,0,60
2516,169,3,696,2,3868,0,20
2517,169,3,697,9,3877,462,90
2518,169,3,698,8,3885,84,80
2519,169,3,699,3,3888,0,30
2520,169,3,700,3,3891,60,30
2521,169,3,701,9,3900,0,90
2522,169,3,702,4,3904,132,40
2523,169,3,703,7,3911,0,70
2524,169,3,704,2,3913,0,20
2525,169,3,705,7,3920,0,70
2526,169,3,706,3,3923,0,30
2527,169,3,707,2,3925,200,20
2528,169,3,708,3,3928,0,30
2529,169,3,709,4,3932,58,40
2530,169,3,710,6,3938,55,60
2531,169,3,711,3,3941,23,30
2532,169,3,712,8,3949,0,80
2533,169,3,713,2,3951,0,20
2534,169,3,714,8,3959,161,80
2535,169,3,715,6,3965,48,60
2536,169,3,716,4,3969,0,40
2537,169,3,717,3,3972,0,30
2538,169,3,718,3,3975,0,30
2539,169,3,719,3,3978,0,30
2540,169,3,720,9,3987,0,90
2541,169,3,721,8,3995,300,80
2542,169,3,722,5,4000,55,50
2543,169,3,723,7,4007,0,70
2544,169,3,724,3,4010,0,30
2545,169,3,725,4,4014,0,40
2546,169,3,726,7,4021,232,70
2547,169,3,727,9,4030,83,90
2548,169,3,728,2,4032,0,20
2549,169,3,729,9,4041,0,90
2550,169,3,730,7,4048,178,70
2551,169,3,731,3,4051,0,30
2552,169,3,732,4,4055,67,40
2553,169,3,733,3,4058,36,30
2554,169,3,734,2,4060,21,20
2555,169,3,735,6,4066,0,60
2556,169,3,736,2,4068,85,20
2557,169,3,737,3,4071,0,30
2558,169,3,738,9,4080,127,90
2559,169,3,739,4,4084,0,40
2560,169,3,740,3,4087,0,30
2561,169,3,741,2,4089,0,20
2562,169,3,742,7,4096,0,70
2563,169,3,743,2,4098,182,20
2564,169,3,744,3,4101,33,30
2565,169,3,745,5,4106,0,50
2566,169,3,746,6,4112,108,60
2567,169,3,747,9,4121,0,90
2568,169,3,748,2,4123,0,20
2569,169,3,749,9,4132,181,90
2570,169,3,750,5,4137,0,50
2571,169,3,751,9,4146,120,90
2572,169,3,752,6,4152,0,60
2573,169,3,753,8,4160,149,80
2574,169,3,754,5,4165,65,50
2575,169,3,755,4,4169,0,40
2576,169,3,756,8,4177,115,80
2577,169,3,757,4,4181,41,40
2578,169,3,758,5,4186,40,50
2579,169,3,759,8,4194,0,80
2580,169,3,760,6,4200,151,60
2581,169,3,761,8,4208,80,80
2582,169,3,762,6,4214,57,60
2583,169,3,763,7,4221,0,70
2584,169,3,764,6,4227,0,60
2585,169,3,765,8,4235,214,80
2586,169,3,766,7,4242,66,70
2587,169,3,767,9,4251,82,90
2588,169,3,768,9,4260,78,90
2589,169,3,769,6,4266,64,60
2590,169,3,770,8,4274,0,80
2591,169,3,771,7,4281,0,70
2592,169,3,772,9,4290,238,90
2593,169,3,773,7,4297,0,70
2594,169,3,774,3,4300,109,30
2595,169,3,775,3,4303,30,30
2596,169,3,776,5,4308,0,50
2597,169,3,777,7,4315,0,70
2598,169,3,778,2,4317,147,20
2599,169,3,779,4,4321,34,40
2600,169,3,780,6,4327,0,60
2601,169,3,781,7,4334,142,70
2602,169,3,782,6,4340,51,60
2603,169,3,783,6,4346,0,60
2604,169,3,784,3,4349,0,30
2605,169,3,785,9,4358,177,90
2606,169,3,786,3,4361,0,30
2607,169,3,787,7,4368,96,70
2608,169,3,788,3,4371,30,30
2609,169,3,789,4,4375,45,40
2610,169,3,790,3,4378,0,30
2611,169,3,791,8,4386,0,80
2612,169,3,792,3,4389,0,30
2613,169,3,793,2,4391,165,20
2614,169,3,794,7,4398,72,70
2615,169,3,795,7,4405,63,70
2616,169,3,796,7,4412,0,70
2617,169,3,797,7,4419,129,70
2618,169,3,798,6,4425,0,60
2619,169,3,799,5,4430,98,50
2620,169,3,800,7,4437,0,70
2621,169,3,801,8,4445,0,80
2622,169,3,802,5,4450,177,50
2623,169,3,803,6,4456,0,60
2624,169,3,804,8,4464,157,80
2625,169,3,805,8,4472,98,80
2626,169,3,806,4,4476,0,40
2627,169,3,807,2,4478,0,20
2628,169,3,808,8,4486,132,80
2629,169,3,809,2,4488,0,20
2630,169,3,810,6,4494,0,60
2631,169,3,811,4,4498,106,40
2632,169,3,812,3,4501,0,30
2633,169,3,813,2,4503,0,20
2634,169,3,814,3,4506,0,30
2635,169,3,815,9,4515,154,90
2636,169,3,816,6,4521,68,60
2637,169,3,817,2,4523,25,20
2638,169,3,818,5,4528,40,50
2639,169,3,819,5,4533,46,50
2640,169,3,820,7,4540,0,70
2641,169,3,821,9,4549,0,90
2642,169,3,822,4,4553,205,40
2643,169,3,823,8,4561,0,80
2644,169,3,824,5,4566,0,50
2645,169,3,825,9,4575,182,90
2646,169,3,826,8,4583,0,80
2647,169,3,827,6,4589,0,60
2648,169,3,828,9,4598,0,90
2649,169,3,829,2,4600,277,20
2650,169,3,830,8,4608,72,80
2651,169,3,831,6,4614,71,60
2652,169,3,832,9,4623,81,90
2653,169,3,833,9,4632,0,90
2654,169,3,834,4,4636,135,40
2655,169,3,835,5,4641,54,50
2656,169,3,836,3,4644,26,30
2657,169,3,837,7,4651,85,70
2658,169,3,838,2,4653,24,20
2659,169,3,839,2,4655,0,20
2660,169,3,840,6,4661,92,60
2661,169,3,841,7,4668,0,70
2662,169,3,842,2,4670,0,20
2663,169,3,843,3,4673,0,30
2664,169,3,844,5,4678,180,50
2665,169,3,845,7,4685,58,70
2666,169,3,846,2,4687,0,20
2667,169,3,847,8,4695,0,80
2668,169,3,848,7,4702,0,70
2669,169,3,849,4,4706,0,40
2670,169,3,850,2,4708,0,20
2671,169,3,851,2,4710,0,20
2672,169,3,852,2,4712,0,20
2673,169,3,853,5,4717,321,50
2674,169,3,854,6,4723,64,60
2675,169,3,855,6,4729,0,60
2676,169,3,856,7,4736,136,70
2677,169,3,857,7,4743,60,70
2678,169,3,858,5,4748,0,50
2679,169,3,859,8,4756,0,80
2680,169,3,860,9,4765,203,90
2681,169,3,861,3,4768,0,30
2682,169,3,862,6,4774,92,60
2683,169,3,863,2,4776,26,20
2684,169,3,864,9,4785,87,90
2685,169,3,865,8,4793,0,80
2686,169,3,866,6,4799,137,60
2687,169,3,867,3,4802,0,30
2688,169,3,868,5,4807,0,50
2689,169,3,869,9,4816,175,90
2690,169,3,870,5,4821,50,50
2691,169,3,871,7,4828,62,70
2692,169,3,872,8,4836,0,80
2693,169,3,873,9,4845,205,90
2694,169,3,874,4,4849,46,40
2695,169,3,875,3,4852,0,30
2696,169,3,876,8,4860,117,80
2697,169,3,877,2,4862,27,20
2698,169,3,878,6,4868,48,60
2699,169,3,879,8,4876,79,80
2700,169,3,880,2,4878,0,20
2701,169,3,881,6,4884,83,60
2702,169,3,882,6,4890,59,60
2703,169,3,883,3,4893,36,30
2704,169,3,884,6,4899,0,60
2705,169,3,885,6,4905,151,60
2706,169,3,886,2,4907,0,20
2707,169,3,887,7,4914,79,70
2708,169,3,888,9,4923,93,90
2709,169,3,889,4,4927,0,40
2710,169,3,890,5,4932,0,50
2711,169,3,891,9,4941,166,90
2712,169,3,892,4,4945,37,40
2713,169,3,893,8,4953,71,80
2714,169,3,894,7,4960,72,70
2715,169,3,895,8,4968,0,80
2716,169,3,896,2,4970,0,20
2717,169,3,897,2,4972,106,20
2718,169,3,898,7,4979,70,70
2719,169,3,899,4,4983,0,40
2720,169,3,900,9,4992,119,90
2721,169,3,901,2,4994,22,20
